la_name,phase_type_grouping,primary_need,number_of_pupils,pupil_gender_boys,pupil_gender_girls
Hartlepool,State-funded AP school,Moderate Learning Difficulty,1,1,0
Hartlepool,State-funded AP school,SEN support but no specialist assessment of type of need,1,1,0
Hartlepool,State-funded AP school,"Social, Emotional and Mental Health",14,12,2
Hartlepool,State-funded primary,Autistic Spectrum Disorder,115,84,31
Hartlepool,State-funded primary,Hearing Impairment,24,11,13
Hartlepool,State-funded primary,Moderate Learning Difficulty,294,174,120
Hartlepool,State-funded primary,Multi- Sensory Impairment,18,12,6
Hartlepool,State-funded primary,Other Difficulty/Disability,57,34,23
Hartlepool,State-funded primary,Physical Disability,59,35,24
Hartlepool,State-funded primary,Profound & Multiple Learning Difficulty,4,2,2
Hartlepool,State-funded primary,SEN support but no specialist assessment of type of need,66,47,19
Hartlepool,State-funded primary,Severe Learning Difficulty,5,3,2
Hartlepool,State-funded primary,"Social, Emotional and Mental Health",201,151,50
Hartlepool,State-funded primary,Specific Learning Difficulty,124,78,46
Hartlepool,State-funded primary,"Speech, Language and Communications needs",570,410,160
Hartlepool,State-funded primary,Visual Impairment,14,6,8
Hartlepool,State-funded secondary,Autistic Spectrum Disorder,100,72,28
Hartlepool,State-funded secondary,Hearing Impairment,35,12,23
Hartlepool,State-funded secondary,Moderate Learning Difficulty,211,119,92
Hartlepool,State-funded secondary,Multi- Sensory Impairment,12,6,6
Hartlepool,State-funded secondary,Other Difficulty/Disability,19,11,8
Hartlepool,State-funded secondary,Physical Disability,35,23,12
Hartlepool,State-funded secondary,SEN support but no specialist assessment of type of need,13,8,5
Hartlepool,State-funded secondary,Severe Learning Difficulty,31,17,14
Hartlepool,State-funded secondary,"Social, Emotional and Mental Health",170,123,47
Hartlepool,State-funded secondary,Specific Learning Difficulty,241,134,107
Hartlepool,State-funded secondary,"Speech, Language and Communications needs",133,94,39
Hartlepool,State-funded secondary,Visual Impairment,8,6,2
Hartlepool,State-funded special school,Autistic Spectrum Disorder,84,60,24
Hartlepool,State-funded special school,Hearing Impairment,2,0,2
Hartlepool,State-funded special school,Moderate Learning Difficulty,80,45,35
Hartlepool,State-funded special school,Other Difficulty/Disability,2,2,0
Hartlepool,State-funded special school,Physical Disability,2,1,1
Hartlepool,State-funded special school,Profound & Multiple Learning Difficulty,19,8,11
Hartlepool,State-funded special school,Severe Learning Difficulty,73,41,32
Hartlepool,State-funded special school,"Social, Emotional and Mental Health",8,6,2
Hartlepool,State-funded special school,"Speech, Language and Communications needs",25,21,4
Middlesbrough,State-funded AP school,SEN support but no specialist assessment of type of need,3,2,1
Middlesbrough,State-funded AP school,"Social, Emotional and Mental Health",14,13,1
Middlesbrough,State-funded AP school,"Speech, Language and Communications needs",3,3,0
Middlesbrough,State-funded primary,Autistic Spectrum Disorder,132,98,34
Middlesbrough,State-funded primary,Hearing Impairment,50,26,24
Middlesbrough,State-funded primary,Moderate Learning Difficulty,615,358,257
Middlesbrough,State-funded primary,Multi- Sensory Impairment,14,9,5
Middlesbrough,State-funded primary,Other Difficulty/Disability,30,14,16
Middlesbrough,State-funded primary,Physical Disability,61,36,25
Middlesbrough,State-funded primary,Profound & Multiple Learning Difficulty,2,0,2
Middlesbrough,State-funded primary,SEN support but no specialist assessment of type of need,205,121,84
Middlesbrough,State-funded primary,Severe Learning Difficulty,42,31,11
Middlesbrough,State-funded primary,"Social, Emotional and Mental Health",409,306,103
Middlesbrough,State-funded primary,Specific Learning Difficulty,156,91,65
Middlesbrough,State-funded primary,"Speech, Language and Communications needs",645,463,182
Middlesbrough,State-funded primary,Visual Impairment,28,10,18
Middlesbrough,State-funded secondary,Autistic Spectrum Disorder,127,93,34
Middlesbrough,State-funded secondary,Hearing Impairment,52,28,24
Middlesbrough,State-funded secondary,Moderate Learning Difficulty,607,363,244
Middlesbrough,State-funded secondary,Multi- Sensory Impairment,4,3,1
Middlesbrough,State-funded secondary,Other Difficulty/Disability,42,27,15
Middlesbrough,State-funded secondary,Physical Disability,66,37,29
Middlesbrough,State-funded secondary,Profound & Multiple Learning Difficulty,1,1,0
Middlesbrough,State-funded secondary,SEN support but no specialist assessment of type of need,80,35,45
Middlesbrough,State-funded secondary,Severe Learning Difficulty,7,3,4
Middlesbrough,State-funded secondary,"Social, Emotional and Mental Health",368,234,134
Middlesbrough,State-funded secondary,Specific Learning Difficulty,315,159,156
Middlesbrough,State-funded secondary,"Speech, Language and Communications needs",108,74,34
Middlesbrough,State-funded secondary,Visual Impairment,29,16,13
Middlesbrough,State-funded special school,Autistic Spectrum Disorder,209,166,43
Middlesbrough,State-funded special school,Moderate Learning Difficulty,6,6,0
Middlesbrough,State-funded special school,Multi- Sensory Impairment,1,1,0
Middlesbrough,State-funded special school,Physical Disability,1,1,0
Middlesbrough,State-funded special school,Profound & Multiple Learning Difficulty,43,24,19
Middlesbrough,State-funded special school,Severe Learning Difficulty,229,146,83
Middlesbrough,State-funded special school,"Social, Emotional and Mental Health",155,139,16
Middlesbrough,State-funded special school,Specific Learning Difficulty,6,5,1
Middlesbrough,State-funded special school,"Speech, Language and Communications needs",8,5,3
Redcar and Cleveland,State-funded AP school,Moderate Learning Difficulty,4,2,2
Redcar and Cleveland,State-funded AP school,Other Difficulty/Disability,2,2,0
Redcar and Cleveland,State-funded AP school,SEN support but no specialist assessment of type of need,1,1,0
Redcar and Cleveland,State-funded AP school,"Social, Emotional and Mental Health",22,18,4
Redcar and Cleveland,State-funded AP school,Specific Learning Difficulty,1,1,0
Redcar and Cleveland,State-funded AP school,"Speech, Language and Communications needs",1,1,0
Redcar and Cleveland,State-funded AP school,Visual Impairment,1,0,1
Redcar and Cleveland,State-funded primary,Autistic Spectrum Disorder,120,89,31
Redcar and Cleveland,State-funded primary,Hearing Impairment,30,21,9
Redcar and Cleveland,State-funded primary,Moderate Learning Difficulty,508,306,202
Redcar and Cleveland,State-funded primary,Multi- Sensory Impairment,4,2,2
Redcar and Cleveland,State-funded primary,Other Difficulty/Disability,65,41,24
Redcar and Cleveland,State-funded primary,Physical Disability,65,34,31
Redcar and Cleveland,State-funded primary,SEN support but no specialist assessment of type of need,66,40,26
Redcar and Cleveland,State-funded primary,Severe Learning Difficulty,9,2,7
Redcar and Cleveland,State-funded primary,"Social, Emotional and Mental Health",381,278,103
Redcar and Cleveland,State-funded primary,Specific Learning Difficulty,190,117,73
Redcar and Cleveland,State-funded primary,"Speech, Language and Communications needs",571,412,159
Redcar and Cleveland,State-funded primary,Visual Impairment,9,7,2
Redcar and Cleveland,State-funded secondary,Autistic Spectrum Disorder,124,91,33
Redcar and Cleveland,State-funded secondary,Hearing Impairment,29,13,16
Redcar and Cleveland,State-funded secondary,Moderate Learning Difficulty,351,195,156
Redcar and Cleveland,State-funded secondary,Multi- Sensory Impairment,4,2,2
Redcar and Cleveland,State-funded secondary,Other Difficulty/Disability,51,30,21
Redcar and Cleveland,State-funded secondary,Physical Disability,44,29,15
Redcar and Cleveland,State-funded secondary,Profound & Multiple Learning Difficulty,1,1,0
Redcar and Cleveland,State-funded secondary,SEN support but no specialist assessment of type of need,18,9,9
Redcar and Cleveland,State-funded secondary,Severe Learning Difficulty,1,1,0
Redcar and Cleveland,State-funded secondary,"Social, Emotional and Mental Health",340,220,120
Redcar and Cleveland,State-funded secondary,Specific Learning Difficulty,409,199,210
Redcar and Cleveland,State-funded secondary,"Speech, Language and Communications needs",93,66,27
Redcar and Cleveland,State-funded secondary,Visual Impairment,14,8,6
Redcar and Cleveland,State-funded special school,Autistic Spectrum Disorder,165,127,38
Redcar and Cleveland,State-funded special school,Moderate Learning Difficulty,10,3,7
Redcar and Cleveland,State-funded special school,Multi- Sensory Impairment,1,1,0
Redcar and Cleveland,State-funded special school,Other Difficulty/Disability,2,2,0
Redcar and Cleveland,State-funded special school,Physical Disability,6,4,2
Redcar and Cleveland,State-funded special school,Profound & Multiple Learning Difficulty,41,28,13
Redcar and Cleveland,State-funded special school,Severe Learning Difficulty,91,49,42
Redcar and Cleveland,State-funded special school,"Social, Emotional and Mental Health",116,99,17
Redcar and Cleveland,State-funded special school,Specific Learning Difficulty,14,10,4
Redcar and Cleveland,State-funded special school,"Speech, Language and Communications needs",27,20,7
Redcar and Cleveland,State-funded special school,Visual Impairment,2,2,0
Stockton-on-Tees,State-funded AP school,Other Difficulty/Disability,8,5,3
Stockton-on-Tees,State-funded AP school,"Social, Emotional and Mental Health",13,9,4
Stockton-on-Tees,State-funded AP school,"Speech, Language and Communications needs",2,2,0
Stockton-on-Tees,State-funded primary,Autistic Spectrum Disorder,220,173,47
Stockton-on-Tees,State-funded primary,Hearing Impairment,46,25,21
Stockton-on-Tees,State-funded primary,Moderate Learning Difficulty,368,222,146
Stockton-on-Tees,State-funded primary,Multi- Sensory Impairment,21,15,6
Stockton-on-Tees,State-funded primary,Other Difficulty/Disability,116,69,47
Stockton-on-Tees,State-funded primary,Physical Disability,113,77,36
Stockton-on-Tees,State-funded primary,Profound & Multiple Learning Difficulty,4,4,0
Stockton-on-Tees,State-funded primary,SEN support but no specialist assessment of type of need,356,213,143
Stockton-on-Tees,State-funded primary,Severe Learning Difficulty,18,11,7
Stockton-on-Tees,State-funded primary,"Social, Emotional and Mental Health",399,278,121
Stockton-on-Tees,State-funded primary,Specific Learning Difficulty,168,97,71
Stockton-on-Tees,State-funded primary,"Speech, Language and Communications needs",942,670,272
Stockton-on-Tees,State-funded primary,Visual Impairment,29,17,12
Stockton-on-Tees,State-funded secondary,Autistic Spectrum Disorder,297,210,87
Stockton-on-Tees,State-funded secondary,Hearing Impairment,61,28,33
Stockton-on-Tees,State-funded secondary,Moderate Learning Difficulty,386,234,152
Stockton-on-Tees,State-funded secondary,Multi- Sensory Impairment,26,21,5
Stockton-on-Tees,State-funded secondary,Other Difficulty/Disability,67,43,24
Stockton-on-Tees,State-funded secondary,Physical Disability,66,40,26
Stockton-on-Tees,State-funded secondary,Profound & Multiple Learning Difficulty,2,2,0
Stockton-on-Tees,State-funded secondary,SEN support but no specialist assessment of type of need,261,141,120
Stockton-on-Tees,State-funded secondary,Severe Learning Difficulty,9,6,3
Stockton-on-Tees,State-funded secondary,"Social, Emotional and Mental Health",373,236,137
Stockton-on-Tees,State-funded secondary,Specific Learning Difficulty,266,149,117
Stockton-on-Tees,State-funded secondary,"Speech, Language and Communications needs",135,85,50
Stockton-on-Tees,State-funded secondary,Visual Impairment,24,10,14
Stockton-on-Tees,State-funded special school,Autistic Spectrum Disorder,128,109,19
Stockton-on-Tees,State-funded special school,Hearing Impairment,1,1,0
Stockton-on-Tees,State-funded special school,Moderate Learning Difficulty,131,86,45
Stockton-on-Tees,State-funded special school,Multi- Sensory Impairment,2,1,1
Stockton-on-Tees,State-funded special school,Other Difficulty/Disability,1,1,0
Stockton-on-Tees,State-funded special school,Physical Disability,21,13,8
Stockton-on-Tees,State-funded special school,Profound & Multiple Learning Difficulty,26,16,10
Stockton-on-Tees,State-funded special school,Severe Learning Difficulty,101,60,41
Stockton-on-Tees,State-funded special school,"Social, Emotional and Mental Health",112,98,14
Stockton-on-Tees,State-funded special school,Specific Learning Difficulty,16,7,9
Stockton-on-Tees,State-funded special school,"Speech, Language and Communications needs",111,89,22
Stockton-on-Tees,State-funded special school,Visual Impairment,4,1,3
Darlington,State-funded AP school,Autistic Spectrum Disorder,1,1,0
Darlington,State-funded AP school,SEN support but no specialist assessment of type of need,1,0,1
Darlington,State-funded AP school,"Social, Emotional and Mental Health",30,22,8
Darlington,State-funded AP school,Specific Learning Difficulty,1,0,1
Darlington,State-funded AP school,"Speech, Language and Communications needs",3,1,2
Darlington,State-funded nursery,Autistic Spectrum Disorder,3,3,0
Darlington,State-funded nursery,Moderate Learning Difficulty,1,0,1
Darlington,State-funded nursery,Physical Disability,7,5,2
Darlington,State-funded nursery,Profound & Multiple Learning Difficulty,2,1,1
Darlington,State-funded nursery,"Social, Emotional and Mental Health",1,1,0
Darlington,State-funded nursery,"Speech, Language and Communications needs",13,8,5
Darlington,State-funded primary,Autistic Spectrum Disorder,174,146,28
Darlington,State-funded primary,Hearing Impairment,12,5,7
Darlington,State-funded primary,Moderate Learning Difficulty,271,166,105
Darlington,State-funded primary,Multi- Sensory Impairment,7,6,1
Darlington,State-funded primary,Other Difficulty/Disability,13,7,6
Darlington,State-funded primary,Physical Disability,33,21,12
Darlington,State-funded primary,Profound & Multiple Learning Difficulty,5,3,2
Darlington,State-funded primary,SEN support but no specialist assessment of type of need,47,28,19
Darlington,State-funded primary,Severe Learning Difficulty,3,2,1
Darlington,State-funded primary,"Social, Emotional and Mental Health",280,190,90
Darlington,State-funded primary,Specific Learning Difficulty,144,72,72
Darlington,State-funded primary,"Speech, Language and Communications needs",469,341,128
Darlington,State-funded primary,Visual Impairment,8,4,4
Darlington,State-funded secondary,Autistic Spectrum Disorder,171,130,41
Darlington,State-funded secondary,Hearing Impairment,26,15,11
Darlington,State-funded secondary,Moderate Learning Difficulty,249,150,99
Darlington,State-funded secondary,Multi- Sensory Impairment,3,2,1
Darlington,State-funded secondary,Other Difficulty/Disability,30,16,14
Darlington,State-funded secondary,Physical Disability,22,16,6
Darlington,State-funded secondary,SEN support but no specialist assessment of type of need,105,60,45
Darlington,State-funded secondary,Severe Learning Difficulty,1,1,0
Darlington,State-funded secondary,"Social, Emotional and Mental Health",236,172,64
Darlington,State-funded secondary,Specific Learning Difficulty,129,72,57
Darlington,State-funded secondary,"Speech, Language and Communications needs",105,79,26
Darlington,State-funded secondary,Visual Impairment,14,8,6
Darlington,State-funded special school,Autistic Spectrum Disorder,148,122,26
Darlington,State-funded special school,Moderate Learning Difficulty,61,41,20
Darlington,State-funded special school,Other Difficulty/Disability,1,1,0
Darlington,State-funded special school,Physical Disability,10,5,5
Darlington,State-funded special school,Profound & Multiple Learning Difficulty,21,10,11
Darlington,State-funded special school,Severe Learning Difficulty,15,10,5
Darlington,State-funded special school,"Social, Emotional and Mental Health",42,40,2
Darlington,State-funded special school,Specific Learning Difficulty,7,5,2
Darlington,State-funded special school,"Speech, Language and Communications needs",32,25,7
Darlington,State-funded special school,Visual Impairment,2,1,1
County Durham,State-funded AP school,Autistic Spectrum Disorder,3,3,0
County Durham,State-funded AP school,Moderate Learning Difficulty,2,2,0
County Durham,State-funded AP school,"Social, Emotional and Mental Health",86,49,37
County Durham,State-funded AP school,"Speech, Language and Communications needs",1,0,1
County Durham,State-funded nursery,Autistic Spectrum Disorder,24,18,6
County Durham,State-funded nursery,Hearing Impairment,1,0,1
County Durham,State-funded nursery,Moderate Learning Difficulty,6,3,3
County Durham,State-funded nursery,Other Difficulty/Disability,2,2,0
County Durham,State-funded nursery,Physical Disability,3,2,1
County Durham,State-funded nursery,Profound & Multiple Learning Difficulty,5,3,2
County Durham,State-funded nursery,SEN support but no specialist assessment of type of need,5,4,1
County Durham,State-funded nursery,Severe Learning Difficulty,1,0,1
County Durham,State-funded nursery,"Social, Emotional and Mental Health",11,8,3
County Durham,State-funded nursery,"Speech, Language and Communications needs",32,27,5
County Durham,State-funded nursery,Visual Impairment,2,2,0
County Durham,State-funded primary,Autistic Spectrum Disorder,749,564,185
County Durham,State-funded primary,Hearing Impairment,54,34,20
County Durham,State-funded primary,Moderate Learning Difficulty,1836,1057,779
County Durham,State-funded primary,Multi- Sensory Impairment,42,35,7
County Durham,State-funded primary,Other Difficulty/Disability,323,212,111
County Durham,State-funded primary,Physical Disability,173,105,68
County Durham,State-funded primary,Profound & Multiple Learning Difficulty,33,19,14
County Durham,State-funded primary,SEN support but no specialist assessment of type of need,177,96,81
County Durham,State-funded primary,Severe Learning Difficulty,47,24,23
County Durham,State-funded primary,"Social, Emotional and Mental Health",1315,931,384
County Durham,State-funded primary,Specific Learning Difficulty,467,280,187
County Durham,State-funded primary,"Speech, Language and Communications needs",2213,1519,694
County Durham,State-funded primary,Visual Impairment,39,22,17
County Durham,State-funded secondary,Autistic Spectrum Disorder,721,541,180
County Durham,State-funded secondary,Hearing Impairment,58,23,35
County Durham,State-funded secondary,Moderate Learning Difficulty,1168,705,463
County Durham,State-funded secondary,Multi- Sensory Impairment,9,6,3
County Durham,State-funded secondary,Other Difficulty/Disability,267,170,97
County Durham,State-funded secondary,Physical Disability,103,62,41
County Durham,State-funded secondary,Profound & Multiple Learning Difficulty,10,6,4
County Durham,State-funded secondary,SEN support but no specialist assessment of type of need,149,87,62
County Durham,State-funded secondary,Severe Learning Difficulty,10,6,4
County Durham,State-funded secondary,"Social, Emotional and Mental Health",1064,667,397
County Durham,State-funded secondary,Specific Learning Difficulty,466,260,206
County Durham,State-funded secondary,"Speech, Language and Communications needs",410,280,130
County Durham,State-funded secondary,Visual Impairment,37,20,17
County Durham,State-funded special school,Autistic Spectrum Disorder,794,627,167
County Durham,State-funded special school,Hearing Impairment,2,1,1
County Durham,State-funded special school,Moderate Learning Difficulty,136,83,53
County Durham,State-funded special school,Other Difficulty/Disability,7,4,3
County Durham,State-funded special school,Physical Disability,7,5,2
County Durham,State-funded special school,Profound & Multiple Learning Difficulty,94,55,39
County Durham,State-funded special school,Severe Learning Difficulty,301,175,126
County Durham,State-funded special school,"Social, Emotional and Mental Health",280,247,33
County Durham,State-funded special school,Specific Learning Difficulty,13,8,5
County Durham,State-funded special school,"Speech, Language and Communications needs",36,26,10
County Durham,State-funded special school,Visual Impairment,1,0,1
Northumberland,State-funded AP school,Moderate Learning Difficulty,2,1,1
Northumberland,State-funded AP school,Physical Disability,1,0,1
Northumberland,State-funded AP school,SEN support but no specialist assessment of type of need,10,5,5
Northumberland,State-funded AP school,"Social, Emotional and Mental Health",4,3,1
Northumberland,State-funded AP school,"Speech, Language and Communications needs",3,3,0
Northumberland,State-funded primary,Autistic Spectrum Disorder,330,255,75
Northumberland,State-funded primary,Hearing Impairment,47,18,29
Northumberland,State-funded primary,Moderate Learning Difficulty,622,342,280
Northumberland,State-funded primary,Multi- Sensory Impairment,15,11,4
Northumberland,State-funded primary,Other Difficulty/Disability,55,38,17
Northumberland,State-funded primary,Physical Disability,88,43,45
Northumberland,State-funded primary,Profound & Multiple Learning Difficulty,4,1,3
Northumberland,State-funded primary,SEN support but no specialist assessment of type of need,71,40,31
Northumberland,State-funded primary,Severe Learning Difficulty,10,5,5
Northumberland,State-funded primary,"Social, Emotional and Mental Health",966,684,282
Northumberland,State-funded primary,Specific Learning Difficulty,247,131,116
Northumberland,State-funded primary,"Speech, Language and Communications needs",1507,1039,468
Northumberland,State-funded primary,Visual Impairment,31,18,13
Northumberland,State-funded secondary,Autistic Spectrum Disorder,411,278,133
Northumberland,State-funded secondary,Hearing Impairment,77,39,38
Northumberland,State-funded secondary,Moderate Learning Difficulty,599,353,246
Northumberland,State-funded secondary,Multi- Sensory Impairment,3,2,1
Northumberland,State-funded secondary,Other Difficulty/Disability,67,43,24
Northumberland,State-funded secondary,Physical Disability,114,71,43
Northumberland,State-funded secondary,Profound & Multiple Learning Difficulty,2,2,0
Northumberland,State-funded secondary,SEN support but no specialist assessment of type of need,19,14,5
Northumberland,State-funded secondary,Severe Learning Difficulty,3,2,1
Northumberland,State-funded secondary,"Social, Emotional and Mental Health",876,589,287
Northumberland,State-funded secondary,Specific Learning Difficulty,348,192,156
Northumberland,State-funded secondary,"Speech, Language and Communications needs",419,290,129
Northumberland,State-funded secondary,Visual Impairment,52,29,23
Northumberland,State-funded special school,Autistic Spectrum Disorder,366,297,69
Northumberland,State-funded special school,Hearing Impairment,2,2,0
Northumberland,State-funded special school,Moderate Learning Difficulty,72,50,22
Northumberland,State-funded special school,Other Difficulty/Disability,18,12,6
Northumberland,State-funded special school,Physical Disability,27,17,10
Northumberland,State-funded special school,Profound & Multiple Learning Difficulty,52,27,25
Northumberland,State-funded special school,Severe Learning Difficulty,176,125,51
Northumberland,State-funded special school,"Social, Emotional and Mental Health",287,232,55
Northumberland,State-funded special school,Specific Learning Difficulty,35,22,13
Northumberland,State-funded special school,"Speech, Language and Communications needs",192,133,59
Northumberland,State-funded special school,Visual Impairment,2,2,0
Newcastle upon Tyne,Non-maintained special school,Autistic Spectrum Disorder,61,49,12
Newcastle upon Tyne,Non-maintained special school,Hearing Impairment,10,5,5
Newcastle upon Tyne,Non-maintained special school,Moderate Learning Difficulty,2,0,2
Newcastle upon Tyne,Non-maintained special school,Physical Disability,1,1,0
Newcastle upon Tyne,Non-maintained special school,Profound & Multiple Learning Difficulty,12,6,6
Newcastle upon Tyne,Non-maintained special school,Severe Learning Difficulty,11,9,2
Newcastle upon Tyne,Non-maintained special school,"Social, Emotional and Mental Health",24,19,5
Newcastle upon Tyne,Non-maintained special school,Specific Learning Difficulty,1,1,0
Newcastle upon Tyne,Non-maintained special school,Visual Impairment,1,1,0
Newcastle upon Tyne,State-funded AP school,Autistic Spectrum Disorder,13,7,6
Newcastle upon Tyne,State-funded AP school,Moderate Learning Difficulty,6,3,3
Newcastle upon Tyne,State-funded AP school,Other Difficulty/Disability,2,0,2
Newcastle upon Tyne,State-funded AP school,Physical Disability,1,1,0
Newcastle upon Tyne,State-funded AP school,SEN support but no specialist assessment of type of need,2,2,0
Newcastle upon Tyne,State-funded AP school,"Social, Emotional and Mental Health",49,35,14
Newcastle upon Tyne,State-funded AP school,Specific Learning Difficulty,5,5,0
Newcastle upon Tyne,State-funded AP school,"Speech, Language and Communications needs",1,1,0
Newcastle upon Tyne,State-funded AP school,Visual Impairment,1,0,1
Newcastle upon Tyne,State-funded nursery,Autistic Spectrum Disorder,1,1,0
Newcastle upon Tyne,State-funded nursery,Moderate Learning Difficulty,4,4,0
Newcastle upon Tyne,State-funded nursery,Other Difficulty/Disability,1,0,1
Newcastle upon Tyne,State-funded nursery,"Social, Emotional and Mental Health",6,5,1
Newcastle upon Tyne,State-funded nursery,"Speech, Language and Communications needs",53,37,16
Newcastle upon Tyne,State-funded primary,Autistic Spectrum Disorder,456,341,115
Newcastle upon Tyne,State-funded primary,Hearing Impairment,64,31,33
Newcastle upon Tyne,State-funded primary,Moderate Learning Difficulty,588,330,258
Newcastle upon Tyne,State-funded primary,Multi- Sensory Impairment,21,8,13
Newcastle upon Tyne,State-funded primary,Other Difficulty/Disability,66,34,32
Newcastle upon Tyne,State-funded primary,Physical Disability,90,49,41
Newcastle upon Tyne,State-funded primary,Profound & Multiple Learning Difficulty,1,1,0
Newcastle upon Tyne,State-funded primary,SEN support but no specialist assessment of type of need,57,38,19
Newcastle upon Tyne,State-funded primary,Severe Learning Difficulty,8,4,4
Newcastle upon Tyne,State-funded primary,"Social, Emotional and Mental Health",641,466,175
Newcastle upon Tyne,State-funded primary,Specific Learning Difficulty,217,125,92
Newcastle upon Tyne,State-funded primary,"Speech, Language and Communications needs",1546,1084,462
Newcastle upon Tyne,State-funded primary,Visual Impairment,28,14,14
Newcastle upon Tyne,State-funded secondary,Autistic Spectrum Disorder,366,254,112
Newcastle upon Tyne,State-funded secondary,Hearing Impairment,74,31,43
Newcastle upon Tyne,State-funded secondary,Moderate Learning Difficulty,523,307,216
Newcastle upon Tyne,State-funded secondary,Multi- Sensory Impairment,4,3,1
Newcastle upon Tyne,State-funded secondary,Other Difficulty/Disability,39,20,19
Newcastle upon Tyne,State-funded secondary,Physical Disability,59,33,26
Newcastle upon Tyne,State-funded secondary,Profound & Multiple Learning Difficulty,3,2,1
Newcastle upon Tyne,State-funded secondary,SEN support but no specialist assessment of type of need,31,21,10
Newcastle upon Tyne,State-funded secondary,Severe Learning Difficulty,17,9,8
Newcastle upon Tyne,State-funded secondary,"Social, Emotional and Mental Health",526,342,184
Newcastle upon Tyne,State-funded secondary,Specific Learning Difficulty,473,244,229
Newcastle upon Tyne,State-funded secondary,"Speech, Language and Communications needs",358,251,107
Newcastle upon Tyne,State-funded secondary,Visual Impairment,40,15,25
Newcastle upon Tyne,State-funded special school,Autistic Spectrum Disorder,327,253,74
Newcastle upon Tyne,State-funded special school,Moderate Learning Difficulty,8,6,2
Newcastle upon Tyne,State-funded special school,Other Difficulty/Disability,4,3,1
Newcastle upon Tyne,State-funded special school,Physical Disability,4,2,2
Newcastle upon Tyne,State-funded special school,Profound & Multiple Learning Difficulty,33,22,11
Newcastle upon Tyne,State-funded special school,Severe Learning Difficulty,327,202,125
Newcastle upon Tyne,State-funded special school,"Social, Emotional and Mental Health",151,137,14
Newcastle upon Tyne,State-funded special school,Specific Learning Difficulty,5,4,1
Newcastle upon Tyne,State-funded special school,"Speech, Language and Communications needs",19,19,0
Newcastle upon Tyne,State-funded special school,Visual Impairment,1,1,0
North Tyneside,Non-maintained special school,Autistic Spectrum Disorder,31,26,5
North Tyneside,Non-maintained special school,Hearing Impairment,1,1,0
North Tyneside,Non-maintained special school,Moderate Learning Difficulty,2,0,2
North Tyneside,Non-maintained special school,Other Difficulty/Disability,1,1,0
North Tyneside,Non-maintained special school,Physical Disability,37,26,11
North Tyneside,Non-maintained special school,Profound & Multiple Learning Difficulty,20,14,6
North Tyneside,Non-maintained special school,Severe Learning Difficulty,10,8,2
North Tyneside,Non-maintained special school,"Social, Emotional and Mental Health",5,4,1
North Tyneside,Non-maintained special school,"Speech, Language and Communications needs",50,38,12
North Tyneside,State-funded AP school,Autistic Spectrum Disorder,9,7,2
North Tyneside,State-funded AP school,Hearing Impairment,1,1,0
North Tyneside,State-funded AP school,Moderate Learning Difficulty,6,5,1
North Tyneside,State-funded AP school,Other Difficulty/Disability,7,1,6
North Tyneside,State-funded AP school,SEN support but no specialist assessment of type of need,27,7,20
North Tyneside,State-funded AP school,"Social, Emotional and Mental Health",98,59,39
North Tyneside,State-funded AP school,Specific Learning Difficulty,6,5,1
North Tyneside,State-funded AP school,"Speech, Language and Communications needs",11,9,2
North Tyneside,State-funded nursery,Moderate Learning Difficulty,1,0,1
North Tyneside,State-funded nursery,Profound & Multiple Learning Difficulty,1,1,0
North Tyneside,State-funded nursery,Severe Learning Difficulty,3,2,1
North Tyneside,State-funded primary,Autistic Spectrum Disorder,133,102,31
North Tyneside,State-funded primary,Hearing Impairment,23,9,14
North Tyneside,State-funded primary,Moderate Learning Difficulty,138,81,57
North Tyneside,State-funded primary,Multi- Sensory Impairment,7,5,2
North Tyneside,State-funded primary,Other Difficulty/Disability,147,79,68
North Tyneside,State-funded primary,Physical Disability,54,36,18
North Tyneside,State-funded primary,SEN support but no specialist assessment of type of need,32,21,11
North Tyneside,State-funded primary,Severe Learning Difficulty,4,3,1
North Tyneside,State-funded primary,"Social, Emotional and Mental Health",532,396,136
North Tyneside,State-funded primary,Specific Learning Difficulty,230,121,109
North Tyneside,State-funded primary,"Speech, Language and Communications needs",1308,861,447
North Tyneside,State-funded primary,Visual Impairment,16,10,6
North Tyneside,State-funded secondary,Autistic Spectrum Disorder,214,161,53
North Tyneside,State-funded secondary,Hearing Impairment,33,12,21
North Tyneside,State-funded secondary,Moderate Learning Difficulty,124,70,54
North Tyneside,State-funded secondary,Multi- Sensory Impairment,1,1,0
North Tyneside,State-funded secondary,Other Difficulty/Disability,131,76,55
North Tyneside,State-funded secondary,Physical Disability,41,26,15
North Tyneside,State-funded secondary,SEN support but no specialist assessment of type of need,6,5,1
North Tyneside,State-funded secondary,"Social, Emotional and Mental Health",528,331,197
North Tyneside,State-funded secondary,Specific Learning Difficulty,441,234,207
North Tyneside,State-funded secondary,"Speech, Language and Communications needs",348,245,103
North Tyneside,State-funded secondary,Visual Impairment,15,6,9
North Tyneside,State-funded special school,Autistic Spectrum Disorder,293,245,48
North Tyneside,State-funded special school,Hearing Impairment,5,2,3
North Tyneside,State-funded special school,Moderate Learning Difficulty,88,59,29
North Tyneside,State-funded special school,Multi- Sensory Impairment,2,1,1
North Tyneside,State-funded special school,Other Difficulty/Disability,13,6,7
North Tyneside,State-funded special school,Physical Disability,23,15,8
North Tyneside,State-funded special school,Profound & Multiple Learning Difficulty,29,17,12
North Tyneside,State-funded special school,Severe Learning Difficulty,78,47,31
North Tyneside,State-funded special school,"Social, Emotional and Mental Health",134,119,15
North Tyneside,State-funded special school,Specific Learning Difficulty,11,7,4
North Tyneside,State-funded special school,"Speech, Language and Communications needs",116,78,38
North Tyneside,State-funded special school,Visual Impairment,3,1,2
South Tyneside,State-funded AP school,"Social, Emotional and Mental Health",63,45,18
South Tyneside,State-funded nursery,Autistic Spectrum Disorder,15,12,3
South Tyneside,State-funded nursery,Other Difficulty/Disability,1,1,0
South Tyneside,State-funded nursery,Physical Disability,1,0,1
South Tyneside,State-funded nursery,Profound & Multiple Learning Difficulty,1,0,1
South Tyneside,State-funded nursery,SEN support but no specialist assessment of type of need,1,1,0
South Tyneside,State-funded nursery,"Social, Emotional and Mental Health",2,2,0
South Tyneside,State-funded nursery,"Speech, Language and Communications needs",11,11,0
South Tyneside,State-funded primary,Autistic Spectrum Disorder,333,254,79
South Tyneside,State-funded primary,Hearing Impairment,36,20,16
South Tyneside,State-funded primary,Moderate Learning Difficulty,494,300,194
South Tyneside,State-funded primary,Multi- Sensory Impairment,9,6,3
South Tyneside,State-funded primary,Other Difficulty/Disability,57,37,20
South Tyneside,State-funded primary,Physical Disability,49,28,21
South Tyneside,State-funded primary,Profound & Multiple Learning Difficulty,9,6,3
South Tyneside,State-funded primary,SEN support but no specialist assessment of type of need,121,80,41
South Tyneside,State-funded primary,Severe Learning Difficulty,15,9,6
South Tyneside,State-funded primary,"Social, Emotional and Mental Health",477,331,146
South Tyneside,State-funded primary,Specific Learning Difficulty,179,105,74
South Tyneside,State-funded primary,"Speech, Language and Communications needs",737,505,232
South Tyneside,State-funded primary,Visual Impairment,19,7,12
South Tyneside,State-funded secondary,Autistic Spectrum Disorder,276,211,65
South Tyneside,State-funded secondary,Hearing Impairment,31,15,16
South Tyneside,State-funded secondary,Moderate Learning Difficulty,154,76,78
South Tyneside,State-funded secondary,Multi- Sensory Impairment,2,0,2
South Tyneside,State-funded secondary,Other Difficulty/Disability,133,88,45
South Tyneside,State-funded secondary,Physical Disability,26,14,12
South Tyneside,State-funded secondary,Profound & Multiple Learning Difficulty,3,3,0
South Tyneside,State-funded secondary,SEN support but no specialist assessment of type of need,16,13,3
South Tyneside,State-funded secondary,Severe Learning Difficulty,2,2,0
South Tyneside,State-funded secondary,"Social, Emotional and Mental Health",464,287,177
South Tyneside,State-funded secondary,Specific Learning Difficulty,557,316,241
South Tyneside,State-funded secondary,"Speech, Language and Communications needs",128,86,42
South Tyneside,State-funded secondary,Visual Impairment,20,11,9
South Tyneside,State-funded special school,Autistic Spectrum Disorder,181,137,44
South Tyneside,State-funded special school,Hearing Impairment,6,4,2
South Tyneside,State-funded special school,Moderate Learning Difficulty,77,51,26
South Tyneside,State-funded special school,Multi- Sensory Impairment,2,2,0
South Tyneside,State-funded special school,Other Difficulty/Disability,24,11,13
South Tyneside,State-funded special school,Physical Disability,27,17,10
South Tyneside,State-funded special school,Profound & Multiple Learning Difficulty,28,11,17
South Tyneside,State-funded special school,Severe Learning Difficulty,135,93,42
South Tyneside,State-funded special school,"Social, Emotional and Mental Health",75,56,19
South Tyneside,State-funded special school,Specific Learning Difficulty,16,7,9
South Tyneside,State-funded special school,"Speech, Language and Communications needs",49,36,13
South Tyneside,State-funded special school,Visual Impairment,3,2,1
Sunderland,State-funded AP school,Autistic Spectrum Disorder,5,4,1
Sunderland,State-funded AP school,Moderate Learning Difficulty,2,1,1
Sunderland,State-funded AP school,SEN support but no specialist assessment of type of need,1,1,0
Sunderland,State-funded AP school,"Social, Emotional and Mental Health",58,42,16
Sunderland,State-funded AP school,"Speech, Language and Communications needs",3,3,0
Sunderland,State-funded nursery,Autistic Spectrum Disorder,7,5,2
Sunderland,State-funded nursery,Hearing Impairment,2,2,0
Sunderland,State-funded nursery,Other Difficulty/Disability,4,4,0
Sunderland,State-funded nursery,Physical Disability,10,5,5
Sunderland,State-funded nursery,Profound & Multiple Learning Difficulty,1,1,0
Sunderland,State-funded nursery,"Social, Emotional and Mental Health",5,2,3
Sunderland,State-funded nursery,"Speech, Language and Communications needs",66,40,26
Sunderland,State-funded primary,Autistic Spectrum Disorder,810,601,209
Sunderland,State-funded primary,Hearing Impairment,55,37,18
Sunderland,State-funded primary,Moderate Learning Difficulty,692,413,279
Sunderland,State-funded primary,Multi- Sensory Impairment,9,7,2
Sunderland,State-funded primary,Other Difficulty/Disability,159,89,70
Sunderland,State-funded primary,Physical Disability,116,66,50
Sunderland,State-funded primary,Profound & Multiple Learning Difficulty,5,4,1
Sunderland,State-funded primary,SEN support but no specialist assessment of type of need,82,49,33
Sunderland,State-funded primary,Severe Learning Difficulty,7,6,1
Sunderland,State-funded primary,"Social, Emotional and Mental Health",695,475,220
Sunderland,State-funded primary,Specific Learning Difficulty,140,83,57
Sunderland,State-funded primary,"Speech, Language and Communications needs",1258,874,384
Sunderland,State-funded primary,Visual Impairment,30,19,11
Sunderland,State-funded secondary,Autistic Spectrum Disorder,676,503,173
Sunderland,State-funded secondary,Hearing Impairment,37,17,20
Sunderland,State-funded secondary,Moderate Learning Difficulty,582,346,236
Sunderland,State-funded secondary,Multi- Sensory Impairment,5,2,3
Sunderland,State-funded secondary,Other Difficulty/Disability,91,55,36
Sunderland,State-funded secondary,Physical Disability,74,42,32
Sunderland,State-funded secondary,Profound & Multiple Learning Difficulty,3,2,1
Sunderland,State-funded secondary,SEN support but no specialist assessment of type of need,26,15,11
Sunderland,State-funded secondary,Severe Learning Difficulty,27,11,16
Sunderland,State-funded secondary,"Social, Emotional and Mental Health",656,430,226
Sunderland,State-funded secondary,Specific Learning Difficulty,228,136,92
Sunderland,State-funded secondary,"Speech, Language and Communications needs",259,157,102
Sunderland,State-funded secondary,Visual Impairment,28,22,6
Sunderland,State-funded special school,Autistic Spectrum Disorder,495,388,107
Sunderland,State-funded special school,Hearing Impairment,1,0,1
Sunderland,State-funded special school,Moderate Learning Difficulty,35,18,17
Sunderland,State-funded special school,Multi- Sensory Impairment,1,0,1
Sunderland,State-funded special school,Other Difficulty/Disability,7,6,1
Sunderland,State-funded special school,Physical Disability,6,3,3
Sunderland,State-funded special school,Profound & Multiple Learning Difficulty,43,27,16
Sunderland,State-funded special school,Severe Learning Difficulty,142,89,53
Sunderland,State-funded special school,"Social, Emotional and Mental Health",163,135,28
Sunderland,State-funded special school,Specific Learning Difficulty,8,4,4
Sunderland,State-funded special school,"Speech, Language and Communications needs",54,42,12
Sunderland,State-funded special school,Visual Impairment,2,2,0
Gateshead,State-funded AP school,Autistic Spectrum Disorder,1,1,0
Gateshead,State-funded AP school,Other Difficulty/Disability,1,1,0
Gateshead,State-funded AP school,"Social, Emotional and Mental Health",42,29,13
Gateshead,State-funded AP school,Specific Learning Difficulty,1,0,1
Gateshead,State-funded AP school,"Speech, Language and Communications needs",1,1,0
Gateshead,State-funded nursery,Autistic Spectrum Disorder,4,3,1
Gateshead,State-funded nursery,Hearing Impairment,1,0,1
Gateshead,State-funded nursery,"Speech, Language and Communications needs",5,5,0
Gateshead,State-funded primary,Autistic Spectrum Disorder,322,224,98
Gateshead,State-funded primary,Hearing Impairment,39,21,18
Gateshead,State-funded primary,Moderate Learning Difficulty,450,258,192
Gateshead,State-funded primary,Multi- Sensory Impairment,4,1,3
Gateshead,State-funded primary,Other Difficulty/Disability,176,119,57
Gateshead,State-funded primary,Physical Disability,53,36,17
Gateshead,State-funded primary,Profound & Multiple Learning Difficulty,5,3,2
Gateshead,State-funded primary,SEN support but no specialist assessment of type of need,118,69,49
Gateshead,State-funded primary,Severe Learning Difficulty,5,3,2
Gateshead,State-funded primary,"Social, Emotional and Mental Health",447,312,135
Gateshead,State-funded primary,Specific Learning Difficulty,151,83,68
Gateshead,State-funded primary,"Speech, Language and Communications needs",876,570,306
Gateshead,State-funded primary,Visual Impairment,35,23,12
Gateshead,State-funded secondary,Autistic Spectrum Disorder,275,207,68
Gateshead,State-funded secondary,Hearing Impairment,46,24,22
Gateshead,State-funded secondary,Moderate Learning Difficulty,239,133,106
Gateshead,State-funded secondary,Multi- Sensory Impairment,4,2,2
Gateshead,State-funded secondary,Other Difficulty/Disability,99,66,33
Gateshead,State-funded secondary,Physical Disability,42,27,15
Gateshead,State-funded secondary,Profound & Multiple Learning Difficulty,1,0,1
Gateshead,State-funded secondary,SEN support but no specialist assessment of type of need,82,51,31
Gateshead,State-funded secondary,Severe Learning Difficulty,1,1,0
Gateshead,State-funded secondary,"Social, Emotional and Mental Health",369,225,144
Gateshead,State-funded secondary,Specific Learning Difficulty,214,130,84
Gateshead,State-funded secondary,"Speech, Language and Communications needs",215,140,75
Gateshead,State-funded secondary,Visual Impairment,24,17,7
Gateshead,State-funded special school,Autistic Spectrum Disorder,294,231,63
Gateshead,State-funded special school,Hearing Impairment,4,3,1
Gateshead,State-funded special school,Moderate Learning Difficulty,86,56,30
Gateshead,State-funded special school,Multi- Sensory Impairment,2,2,0
Gateshead,State-funded special school,Other Difficulty/Disability,16,11,5
Gateshead,State-funded special school,Physical Disability,16,7,9
Gateshead,State-funded special school,Profound & Multiple Learning Difficulty,28,16,12
Gateshead,State-funded special school,Severe Learning Difficulty,63,42,21
Gateshead,State-funded special school,"Social, Emotional and Mental Health",149,129,20
Gateshead,State-funded special school,Specific Learning Difficulty,7,4,3
Gateshead,State-funded special school,"Speech, Language and Communications needs",70,50,20
Gateshead,State-funded special school,Visual Impairment,5,2,3
Halton,State-funded AP school,"Social, Emotional and Mental Health",37,18,19
Halton,State-funded nursery,Autistic Spectrum Disorder,1,0,1
Halton,State-funded nursery,Hearing Impairment,1,0,1
Halton,State-funded nursery,Other Difficulty/Disability,1,1,0
Halton,State-funded nursery,"Speech, Language and Communications needs",26,18,8
Halton,State-funded primary,Autistic Spectrum Disorder,62,43,19
Halton,State-funded primary,Hearing Impairment,30,14,16
Halton,State-funded primary,Moderate Learning Difficulty,333,187,146
Halton,State-funded primary,Multi- Sensory Impairment,12,8,4
Halton,State-funded primary,Other Difficulty/Disability,109,58,51
Halton,State-funded primary,Physical Disability,35,15,20
Halton,State-funded primary,Profound & Multiple Learning Difficulty,2,1,1
Halton,State-funded primary,SEN support but no specialist assessment of type of need,151,94,57
Halton,State-funded primary,Severe Learning Difficulty,9,5,4
Halton,State-funded primary,"Social, Emotional and Mental Health",391,280,111
Halton,State-funded primary,Specific Learning Difficulty,156,86,70
Halton,State-funded primary,"Speech, Language and Communications needs",749,509,240
Halton,State-funded primary,Visual Impairment,34,22,12
Halton,State-funded secondary,Autistic Spectrum Disorder,111,85,26
Halton,State-funded secondary,Hearing Impairment,19,14,5
Halton,State-funded secondary,Moderate Learning Difficulty,244,149,95
Halton,State-funded secondary,Multi- Sensory Impairment,3,3,0
Halton,State-funded secondary,Other Difficulty/Disability,64,29,35
Halton,State-funded secondary,Physical Disability,26,13,13
Halton,State-funded secondary,Profound & Multiple Learning Difficulty,1,0,1
Halton,State-funded secondary,SEN support but no specialist assessment of type of need,35,16,19
Halton,State-funded secondary,Severe Learning Difficulty,1,1,0
Halton,State-funded secondary,"Social, Emotional and Mental Health",296,208,88
Halton,State-funded secondary,Specific Learning Difficulty,134,74,60
Halton,State-funded secondary,"Speech, Language and Communications needs",220,152,68
Halton,State-funded secondary,Visual Impairment,19,6,13
Halton,State-funded special school,Autistic Spectrum Disorder,159,122,37
Halton,State-funded special school,Hearing Impairment,5,4,1
Halton,State-funded special school,Moderate Learning Difficulty,20,17,3
Halton,State-funded special school,Multi- Sensory Impairment,1,0,1
Halton,State-funded special school,Other Difficulty/Disability,6,5,1
Halton,State-funded special school,Physical Disability,18,12,6
Halton,State-funded special school,Profound & Multiple Learning Difficulty,24,16,8
Halton,State-funded special school,Severe Learning Difficulty,46,21,25
Halton,State-funded special school,"Social, Emotional and Mental Health",40,27,13
Halton,State-funded special school,Specific Learning Difficulty,12,9,3
Halton,State-funded special school,"Speech, Language and Communications needs",91,74,17
Halton,State-funded special school,Visual Impairment,2,2,0
Warrington,Non-maintained special school,"Social, Emotional and Mental Health",41,36,5
Warrington,State-funded AP school,Autistic Spectrum Disorder,2,1,1
Warrington,State-funded AP school,"Social, Emotional and Mental Health",5,1,4
Warrington,State-funded AP school,Specific Learning Difficulty,1,1,0
Warrington,State-funded AP school,Visual Impairment,1,0,1
Warrington,State-funded nursery,Autistic Spectrum Disorder,13,11,2
Warrington,State-funded nursery,Profound & Multiple Learning Difficulty,2,0,2
Warrington,State-funded nursery,"Speech, Language and Communications needs",12,10,2
Warrington,State-funded nursery,Visual Impairment,1,1,0
Warrington,State-funded primary,Autistic Spectrum Disorder,183,147,36
Warrington,State-funded primary,Hearing Impairment,40,25,15
Warrington,State-funded primary,Moderate Learning Difficulty,458,260,198
Warrington,State-funded primary,Multi- Sensory Impairment,14,9,5
Warrington,State-funded primary,Other Difficulty/Disability,102,63,39
Warrington,State-funded primary,Physical Disability,60,31,29
Warrington,State-funded primary,Profound & Multiple Learning Difficulty,11,7,4
Warrington,State-funded primary,SEN support but no specialist assessment of type of need,74,40,34
Warrington,State-funded primary,Severe Learning Difficulty,10,6,4
Warrington,State-funded primary,"Social, Emotional and Mental Health",452,335,117
Warrington,State-funded primary,Specific Learning Difficulty,223,118,105
Warrington,State-funded primary,"Speech, Language and Communications needs",955,667,288
Warrington,State-funded primary,Visual Impairment,46,18,28
Warrington,State-funded secondary,Autistic Spectrum Disorder,145,112,33
Warrington,State-funded secondary,Hearing Impairment,48,29,19
Warrington,State-funded secondary,Moderate Learning Difficulty,391,245,146
Warrington,State-funded secondary,Multi- Sensory Impairment,4,2,2
Warrington,State-funded secondary,Other Difficulty/Disability,120,73,47
Warrington,State-funded secondary,Physical Disability,47,29,18
Warrington,State-funded secondary,Profound & Multiple Learning Difficulty,2,2,0
Warrington,State-funded secondary,SEN support but no specialist assessment of type of need,41,24,17
Warrington,State-funded secondary,Severe Learning Difficulty,1,1,0
Warrington,State-funded secondary,"Social, Emotional and Mental Health",471,284,187
Warrington,State-funded secondary,Specific Learning Difficulty,309,169,140
Warrington,State-funded secondary,"Speech, Language and Communications needs",318,206,112
Warrington,State-funded secondary,Visual Impairment,50,25,25
Warrington,State-funded special school,Autistic Spectrum Disorder,183,143,40
Warrington,State-funded special school,Moderate Learning Difficulty,63,35,28
Warrington,State-funded special school,Other Difficulty/Disability,2,0,2
Warrington,State-funded special school,Physical Disability,3,1,2
Warrington,State-funded special school,Profound & Multiple Learning Difficulty,23,7,16
Warrington,State-funded special school,Severe Learning Difficulty,69,36,33
Warrington,State-funded special school,"Social, Emotional and Mental Health",56,48,8
Warrington,State-funded special school,Specific Learning Difficulty,3,1,2
Warrington,State-funded special school,"Speech, Language and Communications needs",1,0,1
Blackburn with Darwen,State-funded AP school,Autistic Spectrum Disorder,4,3,1
Blackburn with Darwen,State-funded AP school,Hearing Impairment,1,1,0
Blackburn with Darwen,State-funded AP school,Moderate Learning Difficulty,4,2,2
Blackburn with Darwen,State-funded AP school,"Social, Emotional and Mental Health",68,50,18
Blackburn with Darwen,State-funded AP school,"Speech, Language and Communications needs",2,2,0
Blackburn with Darwen,State-funded nursery,Other Difficulty/Disability,1,1,0
Blackburn with Darwen,State-funded nursery,Specific Learning Difficulty,2,2,0
Blackburn with Darwen,State-funded nursery,"Speech, Language and Communications needs",28,15,13
Blackburn with Darwen,State-funded primary,Autistic Spectrum Disorder,134,98,36
Blackburn with Darwen,State-funded primary,Hearing Impairment,48,26,22
Blackburn with Darwen,State-funded primary,Moderate Learning Difficulty,294,170,124
Blackburn with Darwen,State-funded primary,Multi- Sensory Impairment,4,3,1
Blackburn with Darwen,State-funded primary,Other Difficulty/Disability,47,28,19
Blackburn with Darwen,State-funded primary,Physical Disability,105,68,37
Blackburn with Darwen,State-funded primary,Profound & Multiple Learning Difficulty,11,6,5
Blackburn with Darwen,State-funded primary,SEN support but no specialist assessment of type of need,102,52,50
Blackburn with Darwen,State-funded primary,Severe Learning Difficulty,13,7,6
Blackburn with Darwen,State-funded primary,"Social, Emotional and Mental Health",446,317,129
Blackburn with Darwen,State-funded primary,Specific Learning Difficulty,211,112,99
Blackburn with Darwen,State-funded primary,"Speech, Language and Communications needs",1452,986,466
Blackburn with Darwen,State-funded primary,Visual Impairment,28,15,13
Blackburn with Darwen,State-funded secondary,Autistic Spectrum Disorder,146,103,43
Blackburn with Darwen,State-funded secondary,Hearing Impairment,46,22,24
Blackburn with Darwen,State-funded secondary,Moderate Learning Difficulty,414,195,219
Blackburn with Darwen,State-funded secondary,Multi- Sensory Impairment,2,2,0
Blackburn with Darwen,State-funded secondary,Other Difficulty/Disability,41,29,12
Blackburn with Darwen,State-funded secondary,Physical Disability,60,40,20
Blackburn with Darwen,State-funded secondary,Profound & Multiple Learning Difficulty,2,0,2
Blackburn with Darwen,State-funded secondary,SEN support but no specialist assessment of type of need,12,6,6
Blackburn with Darwen,State-funded secondary,Severe Learning Difficulty,4,2,2
Blackburn with Darwen,State-funded secondary,"Social, Emotional and Mental Health",388,248,140
Blackburn with Darwen,State-funded secondary,Specific Learning Difficulty,200,116,84
Blackburn with Darwen,State-funded secondary,"Speech, Language and Communications needs",418,301,117
Blackburn with Darwen,State-funded secondary,Visual Impairment,51,25,26
Blackburn with Darwen,State-funded special school,Autistic Spectrum Disorder,125,111,14
Blackburn with Darwen,State-funded special school,Moderate Learning Difficulty,52,31,21
Blackburn with Darwen,State-funded special school,Multi- Sensory Impairment,1,1,0
Blackburn with Darwen,State-funded special school,Physical Disability,16,7,9
Blackburn with Darwen,State-funded special school,Profound & Multiple Learning Difficulty,36,17,19
Blackburn with Darwen,State-funded special school,Severe Learning Difficulty,53,28,25
Blackburn with Darwen,State-funded special school,"Social, Emotional and Mental Health",56,46,10
Blackburn with Darwen,State-funded special school,"Speech, Language and Communications needs",22,13,9
Blackburn with Darwen,State-funded special school,Visual Impairment,9,7,2
Blackpool,State-funded AP school,Moderate Learning Difficulty,1,0,1
Blackpool,State-funded AP school,"Social, Emotional and Mental Health",73,50,23
Blackpool,State-funded AP school,"Speech, Language and Communications needs",2,1,1
Blackpool,State-funded primary,Autistic Spectrum Disorder,121,102,19
Blackpool,State-funded primary,Hearing Impairment,33,16,17
Blackpool,State-funded primary,Moderate Learning Difficulty,365,223,142
Blackpool,State-funded primary,Multi- Sensory Impairment,8,8,0
Blackpool,State-funded primary,Other Difficulty/Disability,14,7,7
Blackpool,State-funded primary,Physical Disability,61,31,30
Blackpool,State-funded primary,SEN support but no specialist assessment of type of need,64,34,30
Blackpool,State-funded primary,Severe Learning Difficulty,4,2,2
Blackpool,State-funded primary,"Social, Emotional and Mental Health",325,250,75
Blackpool,State-funded primary,Specific Learning Difficulty,138,76,62
Blackpool,State-funded primary,"Speech, Language and Communications needs",1006,653,353
Blackpool,State-funded primary,Visual Impairment,20,8,12
Blackpool,State-funded secondary,Autistic Spectrum Disorder,50,42,8
Blackpool,State-funded secondary,Hearing Impairment,29,7,22
Blackpool,State-funded secondary,Moderate Learning Difficulty,318,170,148
Blackpool,State-funded secondary,Multi- Sensory Impairment,4,2,2
Blackpool,State-funded secondary,Other Difficulty/Disability,148,88,60
Blackpool,State-funded secondary,Physical Disability,45,27,18
Blackpool,State-funded secondary,SEN support but no specialist assessment of type of need,13,11,2
Blackpool,State-funded secondary,Severe Learning Difficulty,2,1,1
Blackpool,State-funded secondary,"Social, Emotional and Mental Health",397,258,139
Blackpool,State-funded secondary,Specific Learning Difficulty,157,92,65
Blackpool,State-funded secondary,"Speech, Language and Communications needs",269,180,89
Blackpool,State-funded secondary,Visual Impairment,15,7,8
Blackpool,State-funded special school,Autistic Spectrum Disorder,169,134,35
Blackpool,State-funded special school,Hearing Impairment,4,2,2
Blackpool,State-funded special school,Moderate Learning Difficulty,111,67,44
Blackpool,State-funded special school,Multi- Sensory Impairment,1,1,0
Blackpool,State-funded special school,Other Difficulty/Disability,8,6,2
Blackpool,State-funded special school,Physical Disability,51,28,23
Blackpool,State-funded special school,Profound & Multiple Learning Difficulty,8,3,5
Blackpool,State-funded special school,Severe Learning Difficulty,86,47,39
Blackpool,State-funded special school,"Social, Emotional and Mental Health",53,45,8
Blackpool,State-funded special school,Specific Learning Difficulty,16,11,5
Blackpool,State-funded special school,"Speech, Language and Communications needs",70,43,27
Blackpool,State-funded special school,Visual Impairment,4,4,0
Cheshire East,Non-maintained special school,Autistic Spectrum Disorder,5,5,0
Cheshire East,Non-maintained special school,Moderate Learning Difficulty,2,2,0
Cheshire East,Non-maintained special school,Profound & Multiple Learning Difficulty,1,1,0
Cheshire East,Non-maintained special school,Severe Learning Difficulty,4,4,0
Cheshire East,Non-maintained special school,"Social, Emotional and Mental Health",1,1,0
Cheshire East,Non-maintained special school,Specific Learning Difficulty,3,3,0
Cheshire East,Non-maintained special school,"Speech, Language and Communications needs",1,1,0
Cheshire East,Non-maintained special school,Visual Impairment,1,1,0
Cheshire East,State-funded AP school,Moderate Learning Difficulty,4,4,0
Cheshire East,State-funded AP school,Other Difficulty/Disability,2,2,0
Cheshire East,State-funded AP school,SEN support but no specialist assessment of type of need,1,1,0
Cheshire East,State-funded AP school,"Social, Emotional and Mental Health",16,13,3
Cheshire East,State-funded AP school,Specific Learning Difficulty,2,2,0
Cheshire East,State-funded AP school,"Speech, Language and Communications needs",1,0,1
Cheshire East,State-funded nursery,Moderate Learning Difficulty,4,3,1
Cheshire East,State-funded nursery,Physical Disability,1,0,1
Cheshire East,State-funded nursery,"Speech, Language and Communications needs",4,2,2
Cheshire East,State-funded primary,Autistic Spectrum Disorder,339,246,93
Cheshire East,State-funded primary,Hearing Impairment,48,27,21
Cheshire East,State-funded primary,Moderate Learning Difficulty,1032,633,399
Cheshire East,State-funded primary,Multi- Sensory Impairment,33,19,14
Cheshire East,State-funded primary,Other Difficulty/Disability,136,82,54
Cheshire East,State-funded primary,Physical Disability,96,56,40
Cheshire East,State-funded primary,Profound & Multiple Learning Difficulty,24,16,8
Cheshire East,State-funded primary,SEN support but no specialist assessment of type of need,292,181,111
Cheshire East,State-funded primary,Severe Learning Difficulty,33,24,9
Cheshire East,State-funded primary,"Social, Emotional and Mental Health",785,556,229
Cheshire East,State-funded primary,Specific Learning Difficulty,566,330,236
Cheshire East,State-funded primary,"Speech, Language and Communications needs",1000,725,275
Cheshire East,State-funded primary,Visual Impairment,32,17,15
Cheshire East,State-funded secondary,Autistic Spectrum Disorder,425,293,132
Cheshire East,State-funded secondary,Hearing Impairment,42,25,17
Cheshire East,State-funded secondary,Moderate Learning Difficulty,360,219,141
Cheshire East,State-funded secondary,Multi- Sensory Impairment,11,8,3
Cheshire East,State-funded secondary,Other Difficulty/Disability,243,152,91
Cheshire East,State-funded secondary,Physical Disability,48,27,21
Cheshire East,State-funded secondary,Profound & Multiple Learning Difficulty,16,14,2
Cheshire East,State-funded secondary,SEN support but no specialist assessment of type of need,162,119,43
Cheshire East,State-funded secondary,Severe Learning Difficulty,14,9,5
Cheshire East,State-funded secondary,"Social, Emotional and Mental Health",584,370,214
Cheshire East,State-funded secondary,Specific Learning Difficulty,622,348,274
Cheshire East,State-funded secondary,"Speech, Language and Communications needs",329,224,105
Cheshire East,State-funded secondary,Visual Impairment,30,15,15
Cheshire East,State-funded special school,Autistic Spectrum Disorder,185,151,34
Cheshire East,State-funded special school,Moderate Learning Difficulty,19,15,4
Cheshire East,State-funded special school,Multi- Sensory Impairment,3,3,0
Cheshire East,State-funded special school,Other Difficulty/Disability,28,19,9
Cheshire East,State-funded special school,Physical Disability,4,0,4
Cheshire East,State-funded special school,Profound & Multiple Learning Difficulty,34,16,18
Cheshire East,State-funded special school,Severe Learning Difficulty,124,90,34
Cheshire East,State-funded special school,"Social, Emotional and Mental Health",153,118,35
Cheshire East,State-funded special school,Specific Learning Difficulty,21,13,8
Cheshire East,State-funded special school,"Speech, Language and Communications needs",45,28,17
Cheshire East,State-funded special school,Visual Impairment,1,0,1
Cheshire West and Chester,State-funded AP school,Autistic Spectrum Disorder,2,1,1
Cheshire West and Chester,State-funded AP school,Moderate Learning Difficulty,4,3,1
Cheshire West and Chester,State-funded AP school,Multi- Sensory Impairment,1,1,0
Cheshire West and Chester,State-funded AP school,Other Difficulty/Disability,2,1,1
Cheshire West and Chester,State-funded AP school,SEN support but no specialist assessment of type of need,1,1,0
Cheshire West and Chester,State-funded AP school,"Social, Emotional and Mental Health",42,25,17
Cheshire West and Chester,State-funded AP school,Specific Learning Difficulty,1,1,0
Cheshire West and Chester,State-funded AP school,"Speech, Language and Communications needs",5,4,1
Cheshire West and Chester,State-funded primary,Autistic Spectrum Disorder,384,288,96
Cheshire West and Chester,State-funded primary,Hearing Impairment,51,29,22
Cheshire West and Chester,State-funded primary,Moderate Learning Difficulty,600,349,251
Cheshire West and Chester,State-funded primary,Multi- Sensory Impairment,20,15,5
Cheshire West and Chester,State-funded primary,Other Difficulty/Disability,212,132,80
Cheshire West and Chester,State-funded primary,Physical Disability,97,59,38
Cheshire West and Chester,State-funded primary,Profound & Multiple Learning Difficulty,9,6,3
Cheshire West and Chester,State-funded primary,SEN support but no specialist assessment of type of need,335,210,125
Cheshire West and Chester,State-funded primary,Severe Learning Difficulty,18,11,7
Cheshire West and Chester,State-funded primary,"Social, Emotional and Mental Health",812,583,229
Cheshire West and Chester,State-funded primary,Specific Learning Difficulty,483,289,194
Cheshire West and Chester,State-funded primary,"Speech, Language and Communications needs",1429,977,452
Cheshire West and Chester,State-funded primary,Visual Impairment,39,21,18
Cheshire West and Chester,State-funded secondary,Autistic Spectrum Disorder,364,263,101
Cheshire West and Chester,State-funded secondary,Hearing Impairment,48,29,19
Cheshire West and Chester,State-funded secondary,Moderate Learning Difficulty,342,181,161
Cheshire West and Chester,State-funded secondary,Multi- Sensory Impairment,8,7,1
Cheshire West and Chester,State-funded secondary,Other Difficulty/Disability,116,64,52
Cheshire West and Chester,State-funded secondary,Physical Disability,52,31,21
Cheshire West and Chester,State-funded secondary,SEN support but no specialist assessment of type of need,106,60,46
Cheshire West and Chester,State-funded secondary,Severe Learning Difficulty,5,3,2
Cheshire West and Chester,State-funded secondary,"Social, Emotional and Mental Health",771,497,274
Cheshire West and Chester,State-funded secondary,Specific Learning Difficulty,636,384,252
Cheshire West and Chester,State-funded secondary,"Speech, Language and Communications needs",350,233,117
Cheshire West and Chester,State-funded secondary,Visual Impairment,69,27,42
Cheshire West and Chester,State-funded special school,Autistic Spectrum Disorder,350,290,60
Cheshire West and Chester,State-funded special school,Hearing Impairment,2,1,1
Cheshire West and Chester,State-funded special school,Moderate Learning Difficulty,111,74,37
Cheshire West and Chester,State-funded special school,Other Difficulty/Disability,17,11,6
Cheshire West and Chester,State-funded special school,Physical Disability,43,26,17
Cheshire West and Chester,State-funded special school,Profound & Multiple Learning Difficulty,34,17,17
Cheshire West and Chester,State-funded special school,Severe Learning Difficulty,175,98,77
Cheshire West and Chester,State-funded special school,"Social, Emotional and Mental Health",184,158,26
Cheshire West and Chester,State-funded special school,Specific Learning Difficulty,40,23,17
Cheshire West and Chester,State-funded special school,"Speech, Language and Communications needs",144,116,28
Cheshire West and Chester,State-funded special school,Visual Impairment,6,3,3
Bolton,Non-maintained special school,Autistic Spectrum Disorder,77,61,16
Bolton,Non-maintained special school,Moderate Learning Difficulty,1,0,1
Bolton,Non-maintained special school,Other Difficulty/Disability,1,0,1
Bolton,Non-maintained special school,Profound & Multiple Learning Difficulty,1,0,1
Bolton,Non-maintained special school,Severe Learning Difficulty,5,5,0
Bolton,Non-maintained special school,Specific Learning Difficulty,2,0,2
Bolton,State-funded AP school,Autistic Spectrum Disorder,3,2,1
Bolton,State-funded AP school,Moderate Learning Difficulty,12,11,1
Bolton,State-funded AP school,Other Difficulty/Disability,2,2,0
Bolton,State-funded AP school,"Social, Emotional and Mental Health",55,46,9
Bolton,State-funded AP school,Specific Learning Difficulty,3,2,1
Bolton,State-funded AP school,"Speech, Language and Communications needs",4,4,0
Bolton,State-funded nursery,Autistic Spectrum Disorder,15,12,3
Bolton,State-funded nursery,Other Difficulty/Disability,5,2,3
Bolton,State-funded nursery,Physical Disability,1,0,1
Bolton,State-funded nursery,Profound & Multiple Learning Difficulty,7,2,5
Bolton,State-funded nursery,"Speech, Language and Communications needs",33,21,12
Bolton,State-funded primary,Autistic Spectrum Disorder,288,219,69
Bolton,State-funded primary,Hearing Impairment,62,30,32
Bolton,State-funded primary,Moderate Learning Difficulty,745,468,277
Bolton,State-funded primary,Multi- Sensory Impairment,10,10,0
Bolton,State-funded primary,Other Difficulty/Disability,236,143,93
Bolton,State-funded primary,Physical Disability,116,69,47
Bolton,State-funded primary,Profound & Multiple Learning Difficulty,21,11,10
Bolton,State-funded primary,SEN support but no specialist assessment of type of need,110,64,46
Bolton,State-funded primary,Severe Learning Difficulty,21,13,8
Bolton,State-funded primary,"Social, Emotional and Mental Health",641,478,163
Bolton,State-funded primary,Specific Learning Difficulty,342,178,164
Bolton,State-funded primary,"Speech, Language and Communications needs",1942,1309,633
Bolton,State-funded primary,Visual Impairment,53,27,26
Bolton,State-funded secondary,Autistic Spectrum Disorder,219,172,47
Bolton,State-funded secondary,Hearing Impairment,72,36,36
Bolton,State-funded secondary,Moderate Learning Difficulty,693,399,294
Bolton,State-funded secondary,Multi- Sensory Impairment,7,3,4
Bolton,State-funded secondary,Other Difficulty/Disability,78,43,35
Bolton,State-funded secondary,Physical Disability,101,54,47
Bolton,State-funded secondary,Profound & Multiple Learning Difficulty,1,0,1
Bolton,State-funded secondary,SEN support but no specialist assessment of type of need,105,59,46
Bolton,State-funded secondary,Severe Learning Difficulty,10,7,3
Bolton,State-funded secondary,"Social, Emotional and Mental Health",641,433,208
Bolton,State-funded secondary,Specific Learning Difficulty,483,278,205
Bolton,State-funded secondary,"Speech, Language and Communications needs",395,280,115
Bolton,State-funded secondary,Visual Impairment,45,21,24
Bolton,State-funded special school,Autistic Spectrum Disorder,398,319,79
Bolton,State-funded special school,Hearing Impairment,77,53,24
Bolton,State-funded special school,Moderate Learning Difficulty,153,89,64
Bolton,State-funded special school,Other Difficulty/Disability,5,2,3
Bolton,State-funded special school,Physical Disability,13,9,4
Bolton,State-funded special school,Profound & Multiple Learning Difficulty,82,42,40
Bolton,State-funded special school,Severe Learning Difficulty,150,86,64
Bolton,State-funded special school,"Social, Emotional and Mental Health",97,76,21
Bolton,State-funded special school,Specific Learning Difficulty,6,5,1
Bolton,State-funded special school,"Speech, Language and Communications needs",51,33,18
Bolton,State-funded special school,Visual Impairment,5,2,3
Bury,State-funded AP school,Autistic Spectrum Disorder,1,1,0
Bury,State-funded AP school,Moderate Learning Difficulty,8,5,3
Bury,State-funded AP school,SEN support but no specialist assessment of type of need,1,1,0
Bury,State-funded AP school,"Social, Emotional and Mental Health",77,46,31
Bury,State-funded AP school,Specific Learning Difficulty,4,2,2
Bury,State-funded AP school,"Speech, Language and Communications needs",4,3,1
Bury,State-funded AP school,Visual Impairment,3,1,2
Bury,State-funded nursery,Hearing Impairment,2,0,2
Bury,State-funded nursery,Moderate Learning Difficulty,1,1,0
Bury,State-funded nursery,Profound & Multiple Learning Difficulty,1,1,0
Bury,State-funded nursery,"Speech, Language and Communications needs",12,7,5
Bury,State-funded primary,Autistic Spectrum Disorder,297,218,79
Bury,State-funded primary,Hearing Impairment,36,22,14
Bury,State-funded primary,Moderate Learning Difficulty,344,190,154
Bury,State-funded primary,Multi- Sensory Impairment,13,5,8
Bury,State-funded primary,Other Difficulty/Disability,86,49,37
Bury,State-funded primary,Physical Disability,58,37,21
Bury,State-funded primary,Profound & Multiple Learning Difficulty,7,5,2
Bury,State-funded primary,SEN support but no specialist assessment of type of need,297,181,116
Bury,State-funded primary,Severe Learning Difficulty,8,4,4
Bury,State-funded primary,"Social, Emotional and Mental Health",513,373,140
Bury,State-funded primary,Specific Learning Difficulty,247,120,127
Bury,State-funded primary,"Speech, Language and Communications needs",862,599,263
Bury,State-funded primary,Visual Impairment,30,17,13
Bury,State-funded secondary,Autistic Spectrum Disorder,165,126,39
Bury,State-funded secondary,Hearing Impairment,34,18,16
Bury,State-funded secondary,Moderate Learning Difficulty,325,170,155
Bury,State-funded secondary,Multi- Sensory Impairment,3,3,0
Bury,State-funded secondary,Other Difficulty/Disability,34,18,16
Bury,State-funded secondary,Physical Disability,47,33,14
Bury,State-funded secondary,Profound & Multiple Learning Difficulty,4,2,2
Bury,State-funded secondary,SEN support but no specialist assessment of type of need,85,42,43
Bury,State-funded secondary,Severe Learning Difficulty,3,3,0
Bury,State-funded secondary,"Social, Emotional and Mental Health",461,283,178
Bury,State-funded secondary,Specific Learning Difficulty,273,138,135
Bury,State-funded secondary,"Speech, Language and Communications needs",166,125,41
Bury,State-funded secondary,Visual Impairment,29,16,13
Bury,State-funded special school,Autistic Spectrum Disorder,184,152,32
Bury,State-funded special school,Hearing Impairment,2,2,0
Bury,State-funded special school,Moderate Learning Difficulty,38,26,12
Bury,State-funded special school,Multi- Sensory Impairment,1,1,0
Bury,State-funded special school,Other Difficulty/Disability,4,3,1
Bury,State-funded special school,Physical Disability,16,5,11
Bury,State-funded special school,Profound & Multiple Learning Difficulty,50,29,21
Bury,State-funded special school,Severe Learning Difficulty,79,50,29
Bury,State-funded special school,"Social, Emotional and Mental Health",36,21,15
Bury,State-funded special school,Specific Learning Difficulty,15,13,2
Bury,State-funded special school,"Speech, Language and Communications needs",50,36,14
Bury,State-funded special school,Visual Impairment,3,2,1
Manchester,State-funded AP school,Autistic Spectrum Disorder,4,4,0
Manchester,State-funded AP school,"Social, Emotional and Mental Health",230,188,42
Manchester,State-funded nursery,Other Difficulty/Disability,3,2,1
Manchester,State-funded nursery,Physical Disability,1,0,1
Manchester,State-funded nursery,SEN support but no specialist assessment of type of need,10,9,1
Manchester,State-funded nursery,Severe Learning Difficulty,1,1,0
Manchester,State-funded nursery,"Speech, Language and Communications needs",4,2,2
Manchester,State-funded primary,Autistic Spectrum Disorder,533,381,152
Manchester,State-funded primary,Hearing Impairment,154,94,60
Manchester,State-funded primary,Moderate Learning Difficulty,1398,785,613
Manchester,State-funded primary,Multi- Sensory Impairment,27,18,9
Manchester,State-funded primary,Other Difficulty/Disability,298,177,121
Manchester,State-funded primary,Physical Disability,221,115,106
Manchester,State-funded primary,Profound & Multiple Learning Difficulty,17,11,6
Manchester,State-funded primary,SEN support but no specialist assessment of type of need,511,294,217
Manchester,State-funded primary,Severe Learning Difficulty,53,35,18
Manchester,State-funded primary,"Social, Emotional and Mental Health",1573,1125,448
Manchester,State-funded primary,Specific Learning Difficulty,600,304,296
Manchester,State-funded primary,"Speech, Language and Communications needs",4192,2877,1315
Manchester,State-funded primary,Visual Impairment,68,40,28
Manchester,State-funded secondary,Autistic Spectrum Disorder,531,390,141
Manchester,State-funded secondary,Hearing Impairment,127,67,60
Manchester,State-funded secondary,Moderate Learning Difficulty,1172,633,539
Manchester,State-funded secondary,Multi- Sensory Impairment,27,19,8
Manchester,State-funded secondary,Other Difficulty/Disability,480,288,192
Manchester,State-funded secondary,Physical Disability,157,85,72
Manchester,State-funded secondary,Profound & Multiple Learning Difficulty,7,3,4
Manchester,State-funded secondary,SEN support but no specialist assessment of type of need,220,146,74
Manchester,State-funded secondary,Severe Learning Difficulty,19,11,8
Manchester,State-funded secondary,"Social, Emotional and Mental Health",1696,1038,658
Manchester,State-funded secondary,Specific Learning Difficulty,635,354,281
Manchester,State-funded secondary,"Speech, Language and Communications needs",1067,698,369
Manchester,State-funded secondary,Visual Impairment,93,53,40
Manchester,State-funded special school,Autistic Spectrum Disorder,864,681,183
Manchester,State-funded special school,Hearing Impairment,5,0,5
Manchester,State-funded special school,Moderate Learning Difficulty,37,23,14
Manchester,State-funded special school,Multi- Sensory Impairment,3,2,1
Manchester,State-funded special school,Other Difficulty/Disability,11,8,3
Manchester,State-funded special school,Physical Disability,44,26,18
Manchester,State-funded special school,Profound & Multiple Learning Difficulty,146,83,63
Manchester,State-funded special school,Severe Learning Difficulty,618,392,226
Manchester,State-funded special school,"Social, Emotional and Mental Health",310,260,50
Manchester,State-funded special school,Specific Learning Difficulty,38,30,8
Manchester,State-funded special school,"Speech, Language and Communications needs",84,66,18
Manchester,State-funded special school,Visual Impairment,3,0,3
Oldham,State-funded AP school,"Social, Emotional and Mental Health",42,30,12
Oldham,State-funded primary,Autistic Spectrum Disorder,324,230,94
Oldham,State-funded primary,Hearing Impairment,77,38,39
Oldham,State-funded primary,Moderate Learning Difficulty,686,425,261
Oldham,State-funded primary,Multi- Sensory Impairment,13,6,7
Oldham,State-funded primary,Other Difficulty/Disability,101,59,42
Oldham,State-funded primary,Physical Disability,100,54,46
Oldham,State-funded primary,Profound & Multiple Learning Difficulty,7,3,4
Oldham,State-funded primary,SEN support but no specialist assessment of type of need,219,128,91
Oldham,State-funded primary,Severe Learning Difficulty,17,9,8
Oldham,State-funded primary,"Social, Emotional and Mental Health",551,367,184
Oldham,State-funded primary,Specific Learning Difficulty,149,88,61
Oldham,State-funded primary,"Speech, Language and Communications needs",2106,1482,624
Oldham,State-funded primary,Visual Impairment,53,28,25
Oldham,State-funded secondary,Autistic Spectrum Disorder,312,242,70
Oldham,State-funded secondary,Hearing Impairment,58,31,27
Oldham,State-funded secondary,Moderate Learning Difficulty,488,265,223
Oldham,State-funded secondary,Multi- Sensory Impairment,16,10,6
Oldham,State-funded secondary,Other Difficulty/Disability,131,71,60
Oldham,State-funded secondary,Physical Disability,98,47,51
Oldham,State-funded secondary,Profound & Multiple Learning Difficulty,3,2,1
Oldham,State-funded secondary,SEN support but no specialist assessment of type of need,54,34,20
Oldham,State-funded secondary,Severe Learning Difficulty,13,9,4
Oldham,State-funded secondary,"Social, Emotional and Mental Health",603,386,217
Oldham,State-funded secondary,Specific Learning Difficulty,221,127,94
Oldham,State-funded secondary,"Speech, Language and Communications needs",484,340,144
Oldham,State-funded secondary,Visual Impairment,33,20,13
Oldham,State-funded special school,Autistic Spectrum Disorder,667,522,145
Oldham,State-funded special school,Hearing Impairment,5,4,1
Oldham,State-funded special school,Moderate Learning Difficulty,78,39,39
Oldham,State-funded special school,Other Difficulty/Disability,6,3,3
Oldham,State-funded special school,Physical Disability,95,59,36
Oldham,State-funded special school,Profound & Multiple Learning Difficulty,78,45,33
Oldham,State-funded special school,Severe Learning Difficulty,59,38,21
Oldham,State-funded special school,"Social, Emotional and Mental Health",171,152,19
Oldham,State-funded special school,Specific Learning Difficulty,31,16,15
Oldham,State-funded special school,"Speech, Language and Communications needs",139,96,43
Oldham,State-funded special school,Visual Impairment,9,7,2
Rochdale,State-funded AP school,Other Difficulty/Disability,2,2,0
Rochdale,State-funded AP school,SEN support but no specialist assessment of type of need,18,12,6
Rochdale,State-funded AP school,"Social, Emotional and Mental Health",97,62,35
Rochdale,State-funded nursery,Autistic Spectrum Disorder,2,1,1
Rochdale,State-funded nursery,Hearing Impairment,1,0,1
Rochdale,State-funded nursery,Physical Disability,2,2,0
Rochdale,State-funded nursery,SEN support but no specialist assessment of type of need,6,3,3
Rochdale,State-funded nursery,"Speech, Language and Communications needs",4,2,2
Rochdale,State-funded primary,Autistic Spectrum Disorder,472,367,105
Rochdale,State-funded primary,Hearing Impairment,77,37,40
Rochdale,State-funded primary,Moderate Learning Difficulty,612,355,257
Rochdale,State-funded primary,Multi- Sensory Impairment,21,12,9
Rochdale,State-funded primary,Other Difficulty/Disability,62,38,24
Rochdale,State-funded primary,Physical Disability,75,44,31
Rochdale,State-funded primary,Profound & Multiple Learning Difficulty,14,4,10
Rochdale,State-funded primary,SEN support but no specialist assessment of type of need,102,60,42
Rochdale,State-funded primary,Severe Learning Difficulty,11,6,5
Rochdale,State-funded primary,"Social, Emotional and Mental Health",683,488,195
Rochdale,State-funded primary,Specific Learning Difficulty,190,97,93
Rochdale,State-funded primary,"Speech, Language and Communications needs",1289,908,381
Rochdale,State-funded primary,Visual Impairment,34,16,18
Rochdale,State-funded secondary,Autistic Spectrum Disorder,415,305,110
Rochdale,State-funded secondary,Hearing Impairment,51,26,25
Rochdale,State-funded secondary,Moderate Learning Difficulty,486,285,201
Rochdale,State-funded secondary,Multi- Sensory Impairment,3,1,2
Rochdale,State-funded secondary,Other Difficulty/Disability,46,29,17
Rochdale,State-funded secondary,Physical Disability,64,33,31
Rochdale,State-funded secondary,Profound & Multiple Learning Difficulty,3,1,2
Rochdale,State-funded secondary,SEN support but no specialist assessment of type of need,42,29,13
Rochdale,State-funded secondary,Severe Learning Difficulty,10,7,3
Rochdale,State-funded secondary,"Social, Emotional and Mental Health",495,342,153
Rochdale,State-funded secondary,Specific Learning Difficulty,303,171,132
Rochdale,State-funded secondary,"Speech, Language and Communications needs",252,171,81
Rochdale,State-funded secondary,Visual Impairment,19,10,9
Rochdale,State-funded special school,Autistic Spectrum Disorder,292,241,51
Rochdale,State-funded special school,Hearing Impairment,2,0,2
Rochdale,State-funded special school,Moderate Learning Difficulty,33,22,11
Rochdale,State-funded special school,Multi- Sensory Impairment,1,1,0
Rochdale,State-funded special school,Other Difficulty/Disability,18,15,3
Rochdale,State-funded special school,Physical Disability,21,11,10
Rochdale,State-funded special school,Profound & Multiple Learning Difficulty,52,30,22
Rochdale,State-funded special school,Severe Learning Difficulty,84,52,32
Rochdale,State-funded special school,"Social, Emotional and Mental Health",68,54,14
Rochdale,State-funded special school,Specific Learning Difficulty,23,18,5
Rochdale,State-funded special school,"Speech, Language and Communications needs",63,51,12
Rochdale,State-funded special school,Visual Impairment,2,1,1
Salford,State-funded AP school,Autistic Spectrum Disorder,5,5,0
Salford,State-funded AP school,Moderate Learning Difficulty,13,11,2
Salford,State-funded AP school,Other Difficulty/Disability,1,0,1
Salford,State-funded AP school,"Social, Emotional and Mental Health",108,83,25
Salford,State-funded AP school,Specific Learning Difficulty,5,5,0
Salford,State-funded AP school,"Speech, Language and Communications needs",4,4,0
Salford,State-funded AP school,Visual Impairment,1,1,0
Salford,State-funded primary,Autistic Spectrum Disorder,416,316,100
Salford,State-funded primary,Hearing Impairment,71,35,36
Salford,State-funded primary,Moderate Learning Difficulty,896,486,410
Salford,State-funded primary,Multi- Sensory Impairment,5,4,1
Salford,State-funded primary,Other Difficulty/Disability,62,31,31
Salford,State-funded primary,Physical Disability,123,63,60
Salford,State-funded primary,Profound & Multiple Learning Difficulty,5,2,3
Salford,State-funded primary,SEN support but no specialist assessment of type of need,50,32,18
Salford,State-funded primary,Severe Learning Difficulty,28,19,9
Salford,State-funded primary,"Social, Emotional and Mental Health",810,563,247
Salford,State-funded primary,Specific Learning Difficulty,432,221,211
Salford,State-funded primary,"Speech, Language and Communications needs",1837,1277,560
Salford,State-funded primary,Visual Impairment,31,19,12
Salford,State-funded secondary,Autistic Spectrum Disorder,261,194,67
Salford,State-funded secondary,Hearing Impairment,48,24,24
Salford,State-funded secondary,Moderate Learning Difficulty,532,297,235
Salford,State-funded secondary,Multi- Sensory Impairment,1,1,0
Salford,State-funded secondary,Other Difficulty/Disability,71,45,26
Salford,State-funded secondary,Physical Disability,60,36,24
Salford,State-funded secondary,Profound & Multiple Learning Difficulty,1,0,1
Salford,State-funded secondary,SEN support but no specialist assessment of type of need,70,38,32
Salford,State-funded secondary,Severe Learning Difficulty,14,8,6
Salford,State-funded secondary,"Social, Emotional and Mental Health",738,482,256
Salford,State-funded secondary,Specific Learning Difficulty,454,229,225
Salford,State-funded secondary,"Speech, Language and Communications needs",282,188,94
Salford,State-funded secondary,Visual Impairment,24,17,7
Salford,State-funded special school,Autistic Spectrum Disorder,273,229,44
Salford,State-funded special school,Hearing Impairment,2,1,1
Salford,State-funded special school,Moderate Learning Difficulty,108,65,43
Salford,State-funded special school,Multi- Sensory Impairment,9,3,6
Salford,State-funded special school,Other Difficulty/Disability,15,11,4
Salford,State-funded special school,Physical Disability,16,7,9
Salford,State-funded special school,Profound & Multiple Learning Difficulty,49,33,16
Salford,State-funded special school,SEN support but no specialist assessment of type of need,1,1,0
Salford,State-funded special school,Severe Learning Difficulty,129,84,45
Salford,State-funded special school,"Social, Emotional and Mental Health",156,138,18
Salford,State-funded special school,Specific Learning Difficulty,25,14,11
Salford,State-funded special school,"Speech, Language and Communications needs",141,115,26
Salford,State-funded special school,Visual Impairment,1,0,1
Stockport,Non-maintained special school,Autistic Spectrum Disorder,129,105,24
Stockport,Non-maintained special school,Multi- Sensory Impairment,9,5,4
Stockport,Non-maintained special school,Profound & Multiple Learning Difficulty,2,2,0
Stockport,Non-maintained special school,Severe Learning Difficulty,6,4,2
Stockport,Non-maintained special school,"Social, Emotional and Mental Health",1,0,1
Stockport,Non-maintained special school,Specific Learning Difficulty,2,2,0
Stockport,Non-maintained special school,"Speech, Language and Communications needs",1,1,0
Stockport,Non-maintained special school,Visual Impairment,5,2,3
Stockport,State-funded AP school,"Social, Emotional and Mental Health",107,65,42
Stockport,State-funded AP school,Specific Learning Difficulty,1,0,1
Stockport,State-funded AP school,"Speech, Language and Communications needs",1,0,1
Stockport,State-funded nursery,Autistic Spectrum Disorder,11,9,2
Stockport,State-funded nursery,Moderate Learning Difficulty,1,1,0
Stockport,State-funded nursery,Multi- Sensory Impairment,1,0,1
Stockport,State-funded nursery,Other Difficulty/Disability,1,1,0
Stockport,State-funded nursery,Physical Disability,1,1,0
Stockport,State-funded nursery,Profound & Multiple Learning Difficulty,13,10,3
Stockport,State-funded nursery,Severe Learning Difficulty,1,1,0
Stockport,State-funded nursery,"Social, Emotional and Mental Health",4,2,2
Stockport,State-funded nursery,"Speech, Language and Communications needs",39,25,14
Stockport,State-funded nursery,Visual Impairment,1,1,0
Stockport,State-funded primary,Autistic Spectrum Disorder,317,244,73
Stockport,State-funded primary,Hearing Impairment,46,24,22
Stockport,State-funded primary,Moderate Learning Difficulty,803,458,345
Stockport,State-funded primary,Multi- Sensory Impairment,26,18,8
Stockport,State-funded primary,Other Difficulty/Disability,90,49,41
Stockport,State-funded primary,Physical Disability,85,46,39
Stockport,State-funded primary,Profound & Multiple Learning Difficulty,30,13,17
Stockport,State-funded primary,SEN support but no specialist assessment of type of need,93,54,39
Stockport,State-funded primary,Severe Learning Difficulty,32,18,14
Stockport,State-funded primary,"Social, Emotional and Mental Health",707,524,183
Stockport,State-funded primary,Specific Learning Difficulty,343,203,140
Stockport,State-funded primary,"Speech, Language and Communications needs",1238,856,382
Stockport,State-funded primary,Visual Impairment,39,23,16
Stockport,State-funded secondary,Autistic Spectrum Disorder,348,242,106
Stockport,State-funded secondary,Hearing Impairment,35,16,19
Stockport,State-funded secondary,Moderate Learning Difficulty,601,318,283
Stockport,State-funded secondary,Multi- Sensory Impairment,11,8,3
Stockport,State-funded secondary,Other Difficulty/Disability,158,94,64
Stockport,State-funded secondary,Physical Disability,64,34,30
Stockport,State-funded secondary,Profound & Multiple Learning Difficulty,1,1,0
Stockport,State-funded secondary,SEN support but no specialist assessment of type of need,41,20,21
Stockport,State-funded secondary,Severe Learning Difficulty,24,17,7
Stockport,State-funded secondary,"Social, Emotional and Mental Health",766,455,311
Stockport,State-funded secondary,Specific Learning Difficulty,416,217,199
Stockport,State-funded secondary,"Speech, Language and Communications needs",224,147,77
Stockport,State-funded secondary,Visual Impairment,58,34,24
Stockport,State-funded special school,Autistic Spectrum Disorder,327,270,57
Stockport,State-funded special school,Hearing Impairment,5,3,2
Stockport,State-funded special school,Moderate Learning Difficulty,66,39,27
Stockport,State-funded special school,Multi- Sensory Impairment,2,2,0
Stockport,State-funded special school,Other Difficulty/Disability,11,6,5
Stockport,State-funded special school,Physical Disability,12,10,2
Stockport,State-funded special school,Profound & Multiple Learning Difficulty,94,57,37
Stockport,State-funded special school,Severe Learning Difficulty,54,26,28
Stockport,State-funded special school,"Social, Emotional and Mental Health",104,91,13
Stockport,State-funded special school,Specific Learning Difficulty,10,5,5
Stockport,State-funded special school,"Speech, Language and Communications needs",46,30,16
Stockport,State-funded special school,Visual Impairment,6,4,2
Tameside,State-funded AP school,Moderate Learning Difficulty,4,3,1
Tameside,State-funded AP school,Other Difficulty/Disability,2,2,0
Tameside,State-funded AP school,SEN support but no specialist assessment of type of need,2,2,0
Tameside,State-funded AP school,"Social, Emotional and Mental Health",121,87,34
Tameside,State-funded AP school,Specific Learning Difficulty,8,8,0
Tameside,State-funded AP school,"Speech, Language and Communications needs",2,2,0
Tameside,State-funded primary,Autistic Spectrum Disorder,140,107,33
Tameside,State-funded primary,Hearing Impairment,50,19,31
Tameside,State-funded primary,Moderate Learning Difficulty,733,418,315
Tameside,State-funded primary,Multi- Sensory Impairment,14,6,8
Tameside,State-funded primary,Other Difficulty/Disability,167,108,59
Tameside,State-funded primary,Physical Disability,74,43,31
Tameside,State-funded primary,Profound & Multiple Learning Difficulty,3,1,2
Tameside,State-funded primary,SEN support but no specialist assessment of type of need,288,178,110
Tameside,State-funded primary,Severe Learning Difficulty,11,4,7
Tameside,State-funded primary,"Social, Emotional and Mental Health",762,545,217
Tameside,State-funded primary,Specific Learning Difficulty,314,187,127
Tameside,State-funded primary,"Speech, Language and Communications needs",1372,962,410
Tameside,State-funded primary,Visual Impairment,36,20,16
Tameside,State-funded secondary,Autistic Spectrum Disorder,151,120,31
Tameside,State-funded secondary,Hearing Impairment,41,25,16
Tameside,State-funded secondary,Moderate Learning Difficulty,405,229,176
Tameside,State-funded secondary,Multi- Sensory Impairment,12,11,1
Tameside,State-funded secondary,Other Difficulty/Disability,69,35,34
Tameside,State-funded secondary,Physical Disability,67,35,32
Tameside,State-funded secondary,SEN support but no specialist assessment of type of need,40,26,14
Tameside,State-funded secondary,Severe Learning Difficulty,7,4,3
Tameside,State-funded secondary,"Social, Emotional and Mental Health",576,397,179
Tameside,State-funded secondary,Specific Learning Difficulty,351,192,159
Tameside,State-funded secondary,"Speech, Language and Communications needs",339,203,136
Tameside,State-funded secondary,Visual Impairment,19,10,9
Tameside,State-funded special school,Autistic Spectrum Disorder,276,230,46
Tameside,State-funded special school,Moderate Learning Difficulty,135,94,41
Tameside,State-funded special school,Other Difficulty/Disability,13,7,6
Tameside,State-funded special school,Physical Disability,22,15,7
Tameside,State-funded special school,Profound & Multiple Learning Difficulty,55,31,24
Tameside,State-funded special school,Severe Learning Difficulty,109,72,37
Tameside,State-funded special school,"Social, Emotional and Mental Health",99,93,6
Tameside,State-funded special school,Specific Learning Difficulty,6,5,1
Tameside,State-funded special school,"Speech, Language and Communications needs",65,44,21
Tameside,State-funded special school,Visual Impairment,1,0,1
Trafford,Non-maintained special school,Autistic Spectrum Disorder,82,64,18
Trafford,Non-maintained special school,Moderate Learning Difficulty,9,4,5
Trafford,Non-maintained special school,Other Difficulty/Disability,3,1,2
Trafford,Non-maintained special school,Physical Disability,1,1,0
Trafford,Non-maintained special school,Severe Learning Difficulty,1,1,0
Trafford,Non-maintained special school,"Social, Emotional and Mental Health",5,4,1
Trafford,Non-maintained special school,Specific Learning Difficulty,12,10,2
Trafford,Non-maintained special school,"Speech, Language and Communications needs",5,4,1
Trafford,Non-maintained special school,Visual Impairment,1,1,0
Trafford,State-funded AP school,Autistic Spectrum Disorder,1,1,0
Trafford,State-funded AP school,Moderate Learning Difficulty,1,1,0
Trafford,State-funded AP school,SEN support but no specialist assessment of type of need,1,0,1
Trafford,State-funded AP school,"Social, Emotional and Mental Health",33,27,6
Trafford,State-funded AP school,"Speech, Language and Communications needs",1,0,1
Trafford,State-funded primary,Autistic Spectrum Disorder,122,94,28
Trafford,State-funded primary,Hearing Impairment,48,25,23
Trafford,State-funded primary,Moderate Learning Difficulty,526,298,228
Trafford,State-funded primary,Multi- Sensory Impairment,10,7,3
Trafford,State-funded primary,Other Difficulty/Disability,77,49,28
Trafford,State-funded primary,Physical Disability,74,42,32
Trafford,State-funded primary,Profound & Multiple Learning Difficulty,6,3,3
Trafford,State-funded primary,SEN support but no specialist assessment of type of need,91,54,37
Trafford,State-funded primary,Severe Learning Difficulty,11,10,1
Trafford,State-funded primary,"Social, Emotional and Mental Health",635,470,165
Trafford,State-funded primary,Specific Learning Difficulty,480,254,226
Trafford,State-funded primary,"Speech, Language and Communications needs",1005,693,312
Trafford,State-funded primary,Visual Impairment,24,15,9
Trafford,State-funded secondary,Autistic Spectrum Disorder,225,148,77
Trafford,State-funded secondary,Hearing Impairment,48,25,23
Trafford,State-funded secondary,Moderate Learning Difficulty,374,223,151
Trafford,State-funded secondary,Multi- Sensory Impairment,9,5,4
Trafford,State-funded secondary,Other Difficulty/Disability,102,78,24
Trafford,State-funded secondary,Physical Disability,76,53,23
Trafford,State-funded secondary,SEN support but no specialist assessment of type of need,53,23,30
Trafford,State-funded secondary,Severe Learning Difficulty,3,1,2
Trafford,State-funded secondary,"Social, Emotional and Mental Health",539,345,194
Trafford,State-funded secondary,Specific Learning Difficulty,700,368,332
Trafford,State-funded secondary,"Speech, Language and Communications needs",297,208,89
Trafford,State-funded secondary,Visual Impairment,43,33,10
Trafford,State-funded special school,Autistic Spectrum Disorder,289,230,59
Trafford,State-funded special school,Hearing Impairment,5,3,2
Trafford,State-funded special school,Moderate Learning Difficulty,75,43,32
Trafford,State-funded special school,Multi- Sensory Impairment,1,1,0
Trafford,State-funded special school,Other Difficulty/Disability,2,1,1
Trafford,State-funded special school,Physical Disability,4,3,1
Trafford,State-funded special school,Profound & Multiple Learning Difficulty,81,53,28
Trafford,State-funded special school,Severe Learning Difficulty,120,77,43
Trafford,State-funded special school,"Social, Emotional and Mental Health",147,128,19
Trafford,State-funded special school,Specific Learning Difficulty,17,10,7
Trafford,State-funded special school,"Speech, Language and Communications needs",102,70,32
Trafford,State-funded special school,Visual Impairment,1,1,0
Wigan,State-funded AP school,Hearing Impairment,1,1,0
Wigan,State-funded AP school,Moderate Learning Difficulty,9,8,1
Wigan,State-funded AP school,Multi- Sensory Impairment,1,0,1
Wigan,State-funded AP school,Other Difficulty/Disability,2,2,0
Wigan,State-funded AP school,SEN support but no specialist assessment of type of need,2,2,0
Wigan,State-funded AP school,"Social, Emotional and Mental Health",63,38,25
Wigan,State-funded AP school,Specific Learning Difficulty,4,3,1
Wigan,State-funded AP school,"Speech, Language and Communications needs",2,1,1
Wigan,State-funded nursery,Hearing Impairment,1,0,1
Wigan,State-funded nursery,Other Difficulty/Disability,2,2,0
Wigan,State-funded nursery,Severe Learning Difficulty,1,0,1
Wigan,State-funded nursery,"Social, Emotional and Mental Health",2,0,2
Wigan,State-funded nursery,Specific Learning Difficulty,1,0,1
Wigan,State-funded nursery,"Speech, Language and Communications needs",23,16,7
Wigan,State-funded nursery,Visual Impairment,1,0,1
Wigan,State-funded primary,Autistic Spectrum Disorder,270,213,57
Wigan,State-funded primary,Hearing Impairment,61,38,23
Wigan,State-funded primary,Moderate Learning Difficulty,1145,702,443
Wigan,State-funded primary,Multi- Sensory Impairment,22,15,7
Wigan,State-funded primary,Other Difficulty/Disability,143,94,49
Wigan,State-funded primary,Physical Disability,88,60,28
Wigan,State-funded primary,Profound & Multiple Learning Difficulty,17,14,3
Wigan,State-funded primary,SEN support but no specialist assessment of type of need,273,153,120
Wigan,State-funded primary,Severe Learning Difficulty,57,40,17
Wigan,State-funded primary,"Social, Emotional and Mental Health",1011,719,292
Wigan,State-funded primary,Specific Learning Difficulty,303,182,121
Wigan,State-funded primary,"Speech, Language and Communications needs",1499,1018,481
Wigan,State-funded primary,Visual Impairment,36,25,11
Wigan,State-funded secondary,Autistic Spectrum Disorder,292,207,85
Wigan,State-funded secondary,Hearing Impairment,84,39,45
Wigan,State-funded secondary,Moderate Learning Difficulty,924,547,377
Wigan,State-funded secondary,Multi- Sensory Impairment,21,15,6
Wigan,State-funded secondary,Other Difficulty/Disability,93,47,46
Wigan,State-funded secondary,Physical Disability,92,54,38
Wigan,State-funded secondary,Profound & Multiple Learning Difficulty,3,1,2
Wigan,State-funded secondary,SEN support but no specialist assessment of type of need,100,48,52
Wigan,State-funded secondary,Severe Learning Difficulty,17,12,5
Wigan,State-funded secondary,"Social, Emotional and Mental Health",784,570,214
Wigan,State-funded secondary,Specific Learning Difficulty,330,188,142
Wigan,State-funded secondary,"Speech, Language and Communications needs",379,263,116
Wigan,State-funded secondary,Visual Impairment,40,28,12
Wigan,State-funded special school,Autistic Spectrum Disorder,292,250,42
Wigan,State-funded special school,Hearing Impairment,2,0,2
Wigan,State-funded special school,Moderate Learning Difficulty,56,33,23
Wigan,State-funded special school,Other Difficulty/Disability,11,7,4
Wigan,State-funded special school,Physical Disability,13,4,9
Wigan,State-funded special school,Profound & Multiple Learning Difficulty,57,28,29
Wigan,State-funded special school,SEN support but no specialist assessment of type of need,2,2,0
Wigan,State-funded special school,Severe Learning Difficulty,151,93,58
Wigan,State-funded special school,"Social, Emotional and Mental Health",191,176,15
Wigan,State-funded special school,Specific Learning Difficulty,32,19,13
Wigan,State-funded special school,"Speech, Language and Communications needs",128,97,31
Wigan,State-funded special school,Visual Impairment,3,3,0
Knowsley,State-funded AP school,Autistic Spectrum Disorder,3,2,1
Knowsley,State-funded AP school,Moderate Learning Difficulty,4,1,3
Knowsley,State-funded AP school,"Social, Emotional and Mental Health",42,20,22
Knowsley,State-funded AP school,Specific Learning Difficulty,1,1,0
Knowsley,State-funded primary,Autistic Spectrum Disorder,249,198,51
Knowsley,State-funded primary,Hearing Impairment,14,10,4
Knowsley,State-funded primary,Moderate Learning Difficulty,483,272,211
Knowsley,State-funded primary,Multi- Sensory Impairment,7,6,1
Knowsley,State-funded primary,Other Difficulty/Disability,54,34,20
Knowsley,State-funded primary,Physical Disability,53,29,24
Knowsley,State-funded primary,Profound & Multiple Learning Difficulty,3,2,1
Knowsley,State-funded primary,SEN support but no specialist assessment of type of need,34,26,8
Knowsley,State-funded primary,Severe Learning Difficulty,16,12,4
Knowsley,State-funded primary,"Social, Emotional and Mental Health",425,316,109
Knowsley,State-funded primary,Specific Learning Difficulty,235,130,105
Knowsley,State-funded primary,"Speech, Language and Communications needs",1016,721,295
Knowsley,State-funded primary,Visual Impairment,16,9,7
Knowsley,State-funded secondary,Autistic Spectrum Disorder,226,142,84
Knowsley,State-funded secondary,Hearing Impairment,14,5,9
Knowsley,State-funded secondary,Moderate Learning Difficulty,359,193,166
Knowsley,State-funded secondary,Multi- Sensory Impairment,1,1,0
Knowsley,State-funded secondary,Other Difficulty/Disability,16,11,5
Knowsley,State-funded secondary,Physical Disability,39,23,16
Knowsley,State-funded secondary,Profound & Multiple Learning Difficulty,1,1,0
Knowsley,State-funded secondary,SEN support but no specialist assessment of type of need,7,4,3
Knowsley,State-funded secondary,Severe Learning Difficulty,2,2,0
Knowsley,State-funded secondary,"Social, Emotional and Mental Health",245,168,77
Knowsley,State-funded secondary,Specific Learning Difficulty,267,148,119
Knowsley,State-funded secondary,"Speech, Language and Communications needs",150,95,55
Knowsley,State-funded secondary,Visual Impairment,11,6,5
Knowsley,State-funded special school,Autistic Spectrum Disorder,210,171,39
Knowsley,State-funded special school,Hearing Impairment,3,2,1
Knowsley,State-funded special school,Moderate Learning Difficulty,57,39,18
Knowsley,State-funded special school,Other Difficulty/Disability,8,6,2
Knowsley,State-funded special school,Physical Disability,13,9,4
Knowsley,State-funded special school,Profound & Multiple Learning Difficulty,31,18,13
Knowsley,State-funded special school,Severe Learning Difficulty,104,70,34
Knowsley,State-funded special school,"Social, Emotional and Mental Health",125,108,17
Knowsley,State-funded special school,Specific Learning Difficulty,23,13,10
Knowsley,State-funded special school,"Speech, Language and Communications needs",103,75,28
Knowsley,State-funded special school,Visual Impairment,3,2,1
Liverpool,Non-maintained special school,Autistic Spectrum Disorder,4,1,3
Liverpool,Non-maintained special school,Other Difficulty/Disability,4,0,4
Liverpool,Non-maintained special school,Physical Disability,2,1,1
Liverpool,Non-maintained special school,Profound & Multiple Learning Difficulty,1,0,1
Liverpool,Non-maintained special school,SEN support but no specialist assessment of type of need,1,1,0
Liverpool,Non-maintained special school,Visual Impairment,116,75,41
Liverpool,State-funded AP school,Autistic Spectrum Disorder,14,12,2
Liverpool,State-funded AP school,Moderate Learning Difficulty,1,1,0
Liverpool,State-funded AP school,Other Difficulty/Disability,17,15,2
Liverpool,State-funded AP school,Physical Disability,1,1,0
Liverpool,State-funded AP school,"Social, Emotional and Mental Health",93,70,23
Liverpool,State-funded AP school,Specific Learning Difficulty,5,3,2
Liverpool,State-funded AP school,Visual Impairment,1,0,1
Liverpool,State-funded nursery,Autistic Spectrum Disorder,12,7,5
Liverpool,State-funded nursery,Moderate Learning Difficulty,1,0,1
Liverpool,State-funded nursery,Other Difficulty/Disability,2,1,1
Liverpool,State-funded nursery,Physical Disability,1,0,1
Liverpool,State-funded nursery,Severe Learning Difficulty,4,3,1
Liverpool,State-funded nursery,"Social, Emotional and Mental Health",11,7,4
Liverpool,State-funded nursery,Specific Learning Difficulty,1,0,1
Liverpool,State-funded nursery,"Speech, Language and Communications needs",115,70,45
Liverpool,State-funded nursery,Visual Impairment,2,2,0
Liverpool,State-funded primary,Autistic Spectrum Disorder,1672,1205,467
Liverpool,State-funded primary,Hearing Impairment,96,54,42
Liverpool,State-funded primary,Moderate Learning Difficulty,581,314,267
Liverpool,State-funded primary,Multi- Sensory Impairment,28,12,16
Liverpool,State-funded primary,Other Difficulty/Disability,141,91,50
Liverpool,State-funded primary,Physical Disability,212,116,96
Liverpool,State-funded primary,Profound & Multiple Learning Difficulty,15,9,6
Liverpool,State-funded primary,SEN support but no specialist assessment of type of need,89,48,41
Liverpool,State-funded primary,Severe Learning Difficulty,52,34,18
Liverpool,State-funded primary,"Social, Emotional and Mental Health",1505,1006,499
Liverpool,State-funded primary,Specific Learning Difficulty,827,440,387
Liverpool,State-funded primary,"Speech, Language and Communications needs",3081,2136,945
Liverpool,State-funded primary,Visual Impairment,35,18,17
Liverpool,State-funded secondary,Autistic Spectrum Disorder,1576,1034,542
Liverpool,State-funded secondary,Hearing Impairment,87,47,40
Liverpool,State-funded secondary,Moderate Learning Difficulty,727,381,346
Liverpool,State-funded secondary,Multi- Sensory Impairment,40,26,14
Liverpool,State-funded secondary,Other Difficulty/Disability,220,110,110
Liverpool,State-funded secondary,Physical Disability,197,98,99
Liverpool,State-funded secondary,Profound & Multiple Learning Difficulty,7,2,5
Liverpool,State-funded secondary,SEN support but no specialist assessment of type of need,131,85,46
Liverpool,State-funded secondary,Severe Learning Difficulty,6,3,3
Liverpool,State-funded secondary,"Social, Emotional and Mental Health",1460,874,586
Liverpool,State-funded secondary,Specific Learning Difficulty,1192,574,618
Liverpool,State-funded secondary,"Speech, Language and Communications needs",464,329,135
Liverpool,State-funded secondary,Visual Impairment,52,24,28
Liverpool,State-funded special school,Autistic Spectrum Disorder,516,415,101
Liverpool,State-funded special school,Hearing Impairment,3,3,0
Liverpool,State-funded special school,Moderate Learning Difficulty,86,53,33
Liverpool,State-funded special school,Multi- Sensory Impairment,1,1,0
Liverpool,State-funded special school,Other Difficulty/Disability,46,30,16
Liverpool,State-funded special school,Physical Disability,43,27,16
Liverpool,State-funded special school,Profound & Multiple Learning Difficulty,72,39,33
Liverpool,State-funded special school,Severe Learning Difficulty,573,414,159
Liverpool,State-funded special school,"Social, Emotional and Mental Health",276,248,28
Liverpool,State-funded special school,Specific Learning Difficulty,19,11,8
Liverpool,State-funded special school,"Speech, Language and Communications needs",58,39,19
Liverpool,State-funded special school,Visual Impairment,2,2,0
St. Helens,Non-maintained special school,Autistic Spectrum Disorder,64,52,12
St. Helens,State-funded AP school,Autistic Spectrum Disorder,3,0,3
St. Helens,State-funded AP school,"Social, Emotional and Mental Health",44,32,12
St. Helens,State-funded nursery,Other Difficulty/Disability,1,1,0
St. Helens,State-funded nursery,"Speech, Language and Communications needs",2,1,1
St. Helens,State-funded primary,Autistic Spectrum Disorder,308,232,76
St. Helens,State-funded primary,Hearing Impairment,30,22,8
St. Helens,State-funded primary,Moderate Learning Difficulty,289,154,135
St. Helens,State-funded primary,Multi- Sensory Impairment,17,11,6
St. Helens,State-funded primary,Other Difficulty/Disability,123,99,24
St. Helens,State-funded primary,Physical Disability,63,42,21
St. Helens,State-funded primary,Profound & Multiple Learning Difficulty,19,10,9
St. Helens,State-funded primary,SEN support but no specialist assessment of type of need,150,94,56
St. Helens,State-funded primary,Severe Learning Difficulty,9,4,5
St. Helens,State-funded primary,"Social, Emotional and Mental Health",533,385,148
St. Helens,State-funded primary,Specific Learning Difficulty,284,149,135
St. Helens,State-funded primary,"Speech, Language and Communications needs",830,562,268
St. Helens,State-funded primary,Visual Impairment,21,11,10
St. Helens,State-funded secondary,Autistic Spectrum Disorder,387,278,109
St. Helens,State-funded secondary,Hearing Impairment,45,22,23
St. Helens,State-funded secondary,Moderate Learning Difficulty,276,171,105
St. Helens,State-funded secondary,Multi- Sensory Impairment,2,1,1
St. Helens,State-funded secondary,Other Difficulty/Disability,79,49,30
St. Helens,State-funded secondary,Physical Disability,66,34,32
St. Helens,State-funded secondary,Profound & Multiple Learning Difficulty,2,2,0
St. Helens,State-funded secondary,SEN support but no specialist assessment of type of need,84,51,33
St. Helens,State-funded secondary,Severe Learning Difficulty,10,8,2
St. Helens,State-funded secondary,"Social, Emotional and Mental Health",499,353,146
St. Helens,State-funded secondary,Specific Learning Difficulty,577,296,281
St. Helens,State-funded secondary,"Speech, Language and Communications needs",122,71,51
St. Helens,State-funded secondary,Visual Impairment,31,20,11
St. Helens,State-funded special school,Autistic Spectrum Disorder,197,156,41
St. Helens,State-funded special school,Hearing Impairment,2,2,0
St. Helens,State-funded special school,Moderate Learning Difficulty,14,8,6
St. Helens,State-funded special school,Physical Disability,14,10,4
St. Helens,State-funded special school,Profound & Multiple Learning Difficulty,16,6,10
St. Helens,State-funded special school,Severe Learning Difficulty,80,45,35
St. Helens,State-funded special school,"Social, Emotional and Mental Health",59,55,4
St. Helens,State-funded special school,Specific Learning Difficulty,16,10,6
St. Helens,State-funded special school,"Speech, Language and Communications needs",1,0,1
Sefton,Non-maintained special school,Autistic Spectrum Disorder,69,64,5
Sefton,Non-maintained special school,Severe Learning Difficulty,1,1,0
Sefton,Non-maintained special school,"Social, Emotional and Mental Health",1,1,0
Sefton,Non-maintained special school,"Speech, Language and Communications needs",1,1,0
Sefton,State-funded AP school,Moderate Learning Difficulty,3,3,0
Sefton,State-funded AP school,Other Difficulty/Disability,2,2,0
Sefton,State-funded AP school,SEN support but no specialist assessment of type of need,2,0,2
Sefton,State-funded AP school,"Social, Emotional and Mental Health",31,25,6
Sefton,State-funded AP school,Specific Learning Difficulty,2,1,1
Sefton,State-funded nursery,Autistic Spectrum Disorder,2,1,1
Sefton,State-funded nursery,Moderate Learning Difficulty,1,0,1
Sefton,State-funded nursery,Multi- Sensory Impairment,1,1,0
Sefton,State-funded nursery,Other Difficulty/Disability,1,1,0
Sefton,State-funded nursery,Physical Disability,1,1,0
Sefton,State-funded nursery,Profound & Multiple Learning Difficulty,3,1,2
Sefton,State-funded nursery,SEN support but no specialist assessment of type of need,2,2,0
Sefton,State-funded nursery,Severe Learning Difficulty,2,2,0
Sefton,State-funded nursery,"Social, Emotional and Mental Health",1,1,0
Sefton,State-funded nursery,Specific Learning Difficulty,1,0,1
Sefton,State-funded nursery,"Speech, Language and Communications needs",32,25,7
Sefton,State-funded primary,Autistic Spectrum Disorder,599,442,157
Sefton,State-funded primary,Hearing Impairment,38,26,12
Sefton,State-funded primary,Moderate Learning Difficulty,427,228,199
Sefton,State-funded primary,Multi- Sensory Impairment,16,8,8
Sefton,State-funded primary,Other Difficulty/Disability,101,68,33
Sefton,State-funded primary,Physical Disability,80,44,36
Sefton,State-funded primary,Profound & Multiple Learning Difficulty,15,8,7
Sefton,State-funded primary,SEN support but no specialist assessment of type of need,105,61,44
Sefton,State-funded primary,Severe Learning Difficulty,10,6,4
Sefton,State-funded primary,"Social, Emotional and Mental Health",615,431,184
Sefton,State-funded primary,Specific Learning Difficulty,676,386,290
Sefton,State-funded primary,"Speech, Language and Communications needs",1143,800,343
Sefton,State-funded primary,Visual Impairment,33,13,20
Sefton,State-funded secondary,Autistic Spectrum Disorder,406,254,152
Sefton,State-funded secondary,Hearing Impairment,45,18,27
Sefton,State-funded secondary,Moderate Learning Difficulty,347,208,139
Sefton,State-funded secondary,Multi- Sensory Impairment,8,8,0
Sefton,State-funded secondary,Other Difficulty/Disability,155,94,61
Sefton,State-funded secondary,Physical Disability,94,44,50
Sefton,State-funded secondary,Profound & Multiple Learning Difficulty,3,1,2
Sefton,State-funded secondary,SEN support but no specialist assessment of type of need,64,38,26
Sefton,State-funded secondary,Severe Learning Difficulty,6,5,1
Sefton,State-funded secondary,"Social, Emotional and Mental Health",576,371,205
Sefton,State-funded secondary,Specific Learning Difficulty,555,315,240
Sefton,State-funded secondary,"Speech, Language and Communications needs",306,196,110
Sefton,State-funded secondary,Visual Impairment,21,13,8
Sefton,State-funded special school,Autistic Spectrum Disorder,382,304,78
Sefton,State-funded special school,Hearing Impairment,1,0,1
Sefton,State-funded special school,Moderate Learning Difficulty,15,9,6
Sefton,State-funded special school,Multi- Sensory Impairment,2,2,0
Sefton,State-funded special school,Other Difficulty/Disability,28,15,13
Sefton,State-funded special school,Physical Disability,7,6,1
Sefton,State-funded special school,Profound & Multiple Learning Difficulty,40,19,21
Sefton,State-funded special school,Severe Learning Difficulty,98,64,34
Sefton,State-funded special school,"Social, Emotional and Mental Health",111,98,13
Sefton,State-funded special school,Specific Learning Difficulty,5,2,3
Sefton,State-funded special school,"Speech, Language and Communications needs",98,64,34
Sefton,State-funded special school,Visual Impairment,3,1,2
Wirral,Non-maintained special school,Autistic Spectrum Disorder,66,51,15
Wirral,Non-maintained special school,Other Difficulty/Disability,8,6,2
Wirral,Non-maintained special school,"Social, Emotional and Mental Health",20,16,4
Wirral,Non-maintained special school,Specific Learning Difficulty,1,0,1
Wirral,Non-maintained special school,"Speech, Language and Communications needs",2,1,1
Wirral,State-funded nursery,Autistic Spectrum Disorder,13,6,7
Wirral,State-funded nursery,Moderate Learning Difficulty,5,4,1
Wirral,State-funded nursery,Other Difficulty/Disability,3,2,1
Wirral,State-funded nursery,Physical Disability,6,4,2
Wirral,State-funded nursery,Profound & Multiple Learning Difficulty,1,1,0
Wirral,State-funded nursery,"Social, Emotional and Mental Health",2,1,1
Wirral,State-funded nursery,"Speech, Language and Communications needs",49,36,13
Wirral,State-funded primary,Autistic Spectrum Disorder,304,228,76
Wirral,State-funded primary,Hearing Impairment,45,26,19
Wirral,State-funded primary,Moderate Learning Difficulty,417,249,168
Wirral,State-funded primary,Multi- Sensory Impairment,12,10,2
Wirral,State-funded primary,Other Difficulty/Disability,152,85,67
Wirral,State-funded primary,Physical Disability,163,100,63
Wirral,State-funded primary,Profound & Multiple Learning Difficulty,2,2,0
Wirral,State-funded primary,SEN support but no specialist assessment of type of need,129,76,53
Wirral,State-funded primary,Severe Learning Difficulty,6,2,4
Wirral,State-funded primary,"Social, Emotional and Mental Health",1278,888,390
Wirral,State-funded primary,Specific Learning Difficulty,745,430,315
Wirral,State-funded primary,"Speech, Language and Communications needs",1666,1123,543
Wirral,State-funded primary,Visual Impairment,33,11,22
Wirral,State-funded secondary,Autistic Spectrum Disorder,411,299,112
Wirral,State-funded secondary,Hearing Impairment,75,34,41
Wirral,State-funded secondary,Moderate Learning Difficulty,371,201,170
Wirral,State-funded secondary,Multi- Sensory Impairment,11,5,6
Wirral,State-funded secondary,Other Difficulty/Disability,193,98,95
Wirral,State-funded secondary,Physical Disability,110,63,47
Wirral,State-funded secondary,SEN support but no specialist assessment of type of need,133,40,93
Wirral,State-funded secondary,Severe Learning Difficulty,1,1,0
Wirral,State-funded secondary,"Social, Emotional and Mental Health",1376,926,450
Wirral,State-funded secondary,Specific Learning Difficulty,813,418,395
Wirral,State-funded secondary,"Speech, Language and Communications needs",363,235,128
Wirral,State-funded secondary,Visual Impairment,63,31,32
Wirral,State-funded special school,Autistic Spectrum Disorder,389,303,86
Wirral,State-funded special school,Hearing Impairment,2,1,1
Wirral,State-funded special school,Moderate Learning Difficulty,85,56,29
Wirral,State-funded special school,Other Difficulty/Disability,9,4,5
Wirral,State-funded special school,Physical Disability,4,2,2
Wirral,State-funded special school,Profound & Multiple Learning Difficulty,41,25,16
Wirral,State-funded special school,Severe Learning Difficulty,542,400,142
Wirral,State-funded special school,"Social, Emotional and Mental Health",235,202,33
Wirral,State-funded special school,Specific Learning Difficulty,9,9,0
Wirral,State-funded special school,"Speech, Language and Communications needs",71,53,18
Wirral,State-funded special school,Visual Impairment,2,2,0
Cumbria,State-funded AP school,Autistic Spectrum Disorder,2,0,2
Cumbria,State-funded AP school,Moderate Learning Difficulty,1,1,0
Cumbria,State-funded AP school,Other Difficulty/Disability,2,1,1
Cumbria,State-funded AP school,Severe Learning Difficulty,1,1,0
Cumbria,State-funded AP school,"Social, Emotional and Mental Health",100,79,21
Cumbria,State-funded AP school,Specific Learning Difficulty,2,1,1
Cumbria,State-funded AP school,"Speech, Language and Communications needs",4,4,0
Cumbria,State-funded nursery,Autistic Spectrum Disorder,7,7,0
Cumbria,State-funded nursery,Moderate Learning Difficulty,1,1,0
Cumbria,State-funded nursery,Multi- Sensory Impairment,1,1,0
Cumbria,State-funded nursery,Other Difficulty/Disability,1,1,0
Cumbria,State-funded nursery,SEN support but no specialist assessment of type of need,1,1,0
Cumbria,State-funded nursery,"Social, Emotional and Mental Health",3,2,1
Cumbria,State-funded nursery,"Speech, Language and Communications needs",13,8,5
Cumbria,State-funded primary,Autistic Spectrum Disorder,757,552,205
Cumbria,State-funded primary,Hearing Impairment,70,38,32
Cumbria,State-funded primary,Moderate Learning Difficulty,851,506,345
Cumbria,State-funded primary,Multi- Sensory Impairment,10,7,3
Cumbria,State-funded primary,Other Difficulty/Disability,157,106,51
Cumbria,State-funded primary,Physical Disability,177,98,79
Cumbria,State-funded primary,Profound & Multiple Learning Difficulty,24,12,12
Cumbria,State-funded primary,SEN support but no specialist assessment of type of need,173,106,67
Cumbria,State-funded primary,Severe Learning Difficulty,78,52,26
Cumbria,State-funded primary,"Social, Emotional and Mental Health",1089,732,357
Cumbria,State-funded primary,Specific Learning Difficulty,1105,687,418
Cumbria,State-funded primary,"Speech, Language and Communications needs",1678,1158,520
Cumbria,State-funded primary,Visual Impairment,54,29,25
Cumbria,State-funded secondary,Autistic Spectrum Disorder,629,468,161
Cumbria,State-funded secondary,Hearing Impairment,72,32,40
Cumbria,State-funded secondary,Moderate Learning Difficulty,534,317,217
Cumbria,State-funded secondary,Multi- Sensory Impairment,3,1,2
Cumbria,State-funded secondary,Other Difficulty/Disability,187,115,72
Cumbria,State-funded secondary,Physical Disability,140,91,49
Cumbria,State-funded secondary,SEN support but no specialist assessment of type of need,52,32,20
Cumbria,State-funded secondary,Severe Learning Difficulty,86,54,32
Cumbria,State-funded secondary,"Social, Emotional and Mental Health",1015,637,378
Cumbria,State-funded secondary,Specific Learning Difficulty,1541,895,646
Cumbria,State-funded secondary,"Speech, Language and Communications needs",482,322,160
Cumbria,State-funded secondary,Visual Impairment,47,26,21
Cumbria,State-funded special school,Autistic Spectrum Disorder,232,181,51
Cumbria,State-funded special school,Hearing Impairment,1,1,0
Cumbria,State-funded special school,Moderate Learning Difficulty,6,2,4
Cumbria,State-funded special school,Multi- Sensory Impairment,3,3,0
Cumbria,State-funded special school,Other Difficulty/Disability,6,3,3
Cumbria,State-funded special school,Physical Disability,27,17,10
Cumbria,State-funded special school,Profound & Multiple Learning Difficulty,57,27,30
Cumbria,State-funded special school,Severe Learning Difficulty,326,225,101
Cumbria,State-funded special school,"Social, Emotional and Mental Health",9,8,1
Cumbria,State-funded special school,Specific Learning Difficulty,22,16,6
Cumbria,State-funded special school,"Speech, Language and Communications needs",39,25,14
Cumbria,State-funded special school,Visual Impairment,2,0,2
Lancashire,State-funded AP school,Autistic Spectrum Disorder,9,8,1
Lancashire,State-funded AP school,Moderate Learning Difficulty,16,12,4
Lancashire,State-funded AP school,Other Difficulty/Disability,16,10,6
Lancashire,State-funded AP school,SEN support but no specialist assessment of type of need,3,3,0
Lancashire,State-funded AP school,Severe Learning Difficulty,1,0,1
Lancashire,State-funded AP school,"Social, Emotional and Mental Health",328,230,98
Lancashire,State-funded AP school,Specific Learning Difficulty,7,7,0
Lancashire,State-funded AP school,"Speech, Language and Communications needs",6,5,1
Lancashire,State-funded AP school,Visual Impairment,1,1,0
Lancashire,State-funded nursery,Autistic Spectrum Disorder,54,36,18
Lancashire,State-funded nursery,Hearing Impairment,10,5,5
Lancashire,State-funded nursery,Moderate Learning Difficulty,4,1,3
Lancashire,State-funded nursery,Multi- Sensory Impairment,1,0,1
Lancashire,State-funded nursery,Other Difficulty/Disability,12,6,6
Lancashire,State-funded nursery,Physical Disability,13,9,4
Lancashire,State-funded nursery,Profound & Multiple Learning Difficulty,4,2,2
Lancashire,State-funded nursery,SEN support but no specialist assessment of type of need,8,5,3
Lancashire,State-funded nursery,Severe Learning Difficulty,1,1,0
Lancashire,State-funded nursery,"Social, Emotional and Mental Health",18,12,6
Lancashire,State-funded nursery,Specific Learning Difficulty,2,2,0
Lancashire,State-funded nursery,"Speech, Language and Communications needs",300,208,92
Lancashire,State-funded nursery,Visual Impairment,5,1,4
Lancashire,State-funded primary,Autistic Spectrum Disorder,1184,893,291
Lancashire,State-funded primary,Hearing Impairment,262,148,114
Lancashire,State-funded primary,Moderate Learning Difficulty,2449,1440,1009
Lancashire,State-funded primary,Multi- Sensory Impairment,41,25,16
Lancashire,State-funded primary,Other Difficulty/Disability,765,475,290
Lancashire,State-funded primary,Physical Disability,347,206,141
Lancashire,State-funded primary,Profound & Multiple Learning Difficulty,45,29,16
Lancashire,State-funded primary,SEN support but no specialist assessment of type of need,959,608,351
Lancashire,State-funded primary,Severe Learning Difficulty,83,56,27
Lancashire,State-funded primary,"Social, Emotional and Mental Health",2160,1537,623
Lancashire,State-funded primary,Specific Learning Difficulty,1361,783,578
Lancashire,State-funded primary,"Speech, Language and Communications needs",4150,2939,1211
Lancashire,State-funded primary,Visual Impairment,189,90,99
Lancashire,State-funded secondary,Autistic Spectrum Disorder,1220,904,316
Lancashire,State-funded secondary,Hearing Impairment,234,107,127
Lancashire,State-funded secondary,Moderate Learning Difficulty,1497,891,606
Lancashire,State-funded secondary,Multi- Sensory Impairment,47,25,22
Lancashire,State-funded secondary,Other Difficulty/Disability,843,505,338
Lancashire,State-funded secondary,Physical Disability,274,155,119
Lancashire,State-funded secondary,Profound & Multiple Learning Difficulty,7,4,3
Lancashire,State-funded secondary,SEN support but no specialist assessment of type of need,359,204,155
Lancashire,State-funded secondary,Severe Learning Difficulty,25,15,10
Lancashire,State-funded secondary,"Social, Emotional and Mental Health",1876,1260,616
Lancashire,State-funded secondary,Specific Learning Difficulty,2081,1185,896
Lancashire,State-funded secondary,"Speech, Language and Communications needs",951,687,264
Lancashire,State-funded secondary,Visual Impairment,130,70,60
Lancashire,State-funded special school,Autistic Spectrum Disorder,1223,964,259
Lancashire,State-funded special school,Hearing Impairment,43,27,16
Lancashire,State-funded special school,Moderate Learning Difficulty,403,251,152
Lancashire,State-funded special school,Multi- Sensory Impairment,15,7,8
Lancashire,State-funded special school,Other Difficulty/Disability,24,17,7
Lancashire,State-funded special school,Physical Disability,177,113,64
Lancashire,State-funded special school,Profound & Multiple Learning Difficulty,171,93,78
Lancashire,State-funded special school,Severe Learning Difficulty,447,289,158
Lancashire,State-funded special school,"Social, Emotional and Mental Health",453,398,55
Lancashire,State-funded special school,Specific Learning Difficulty,42,30,12
Lancashire,State-funded special school,"Speech, Language and Communications needs",414,292,122
Lancashire,State-funded special school,Visual Impairment,38,28,10
"Kingston upon Hull, City of",State-funded AP school,Autistic Spectrum Disorder,21,18,3
"Kingston upon Hull, City of",State-funded AP school,Hearing Impairment,1,1,0
"Kingston upon Hull, City of",State-funded AP school,Moderate Learning Difficulty,30,19,11
"Kingston upon Hull, City of",State-funded AP school,Other Difficulty/Disability,7,5,2
"Kingston upon Hull, City of",State-funded AP school,Physical Disability,2,1,1
"Kingston upon Hull, City of",State-funded AP school,SEN support but no specialist assessment of type of need,1,1,0
"Kingston upon Hull, City of",State-funded AP school,Severe Learning Difficulty,3,2,1
"Kingston upon Hull, City of",State-funded AP school,"Social, Emotional and Mental Health",190,133,57
"Kingston upon Hull, City of",State-funded AP school,Specific Learning Difficulty,13,9,4
"Kingston upon Hull, City of",State-funded AP school,"Speech, Language and Communications needs",46,38,8
"Kingston upon Hull, City of",State-funded AP school,Visual Impairment,2,2,0
"Kingston upon Hull, City of",State-funded nursery,Multi- Sensory Impairment,3,1,2
"Kingston upon Hull, City of",State-funded nursery,"Social, Emotional and Mental Health",1,1,0
"Kingston upon Hull, City of",State-funded nursery,"Speech, Language and Communications needs",12,11,1
"Kingston upon Hull, City of",State-funded primary,Autistic Spectrum Disorder,328,255,73
"Kingston upon Hull, City of",State-funded primary,Hearing Impairment,51,30,21
"Kingston upon Hull, City of",State-funded primary,Moderate Learning Difficulty,489,299,190
"Kingston upon Hull, City of",State-funded primary,Multi- Sensory Impairment,10,6,4
"Kingston upon Hull, City of",State-funded primary,Other Difficulty/Disability,79,48,31
"Kingston upon Hull, City of",State-funded primary,Physical Disability,125,67,58
"Kingston upon Hull, City of",State-funded primary,Profound & Multiple Learning Difficulty,3,1,2
"Kingston upon Hull, City of",State-funded primary,SEN support but no specialist assessment of type of need,116,66,50
"Kingston upon Hull, City of",State-funded primary,Severe Learning Difficulty,32,17,15
"Kingston upon Hull, City of",State-funded primary,"Social, Emotional and Mental Health",441,325,116
"Kingston upon Hull, City of",State-funded primary,Specific Learning Difficulty,436,231,205
"Kingston upon Hull, City of",State-funded primary,"Speech, Language and Communications needs",2182,1526,656
"Kingston upon Hull, City of",State-funded primary,Visual Impairment,41,19,22
"Kingston upon Hull, City of",State-funded secondary,Autistic Spectrum Disorder,305,236,69
"Kingston upon Hull, City of",State-funded secondary,Hearing Impairment,50,26,24
"Kingston upon Hull, City of",State-funded secondary,Moderate Learning Difficulty,471,254,217
"Kingston upon Hull, City of",State-funded secondary,Multi- Sensory Impairment,2,1,1
"Kingston upon Hull, City of",State-funded secondary,Other Difficulty/Disability,78,44,34
"Kingston upon Hull, City of",State-funded secondary,Physical Disability,67,27,40
"Kingston upon Hull, City of",State-funded secondary,SEN support but no specialist assessment of type of need,62,38,24
"Kingston upon Hull, City of",State-funded secondary,Severe Learning Difficulty,11,6,5
"Kingston upon Hull, City of",State-funded secondary,"Social, Emotional and Mental Health",480,330,150
"Kingston upon Hull, City of",State-funded secondary,Specific Learning Difficulty,550,304,246
"Kingston upon Hull, City of",State-funded secondary,"Speech, Language and Communications needs",445,304,141
"Kingston upon Hull, City of",State-funded secondary,Visual Impairment,39,21,18
"Kingston upon Hull, City of",State-funded special school,Autistic Spectrum Disorder,114,87,27
"Kingston upon Hull, City of",State-funded special school,Hearing Impairment,1,1,0
"Kingston upon Hull, City of",State-funded special school,Moderate Learning Difficulty,17,14,3
"Kingston upon Hull, City of",State-funded special school,Other Difficulty/Disability,8,7,1
"Kingston upon Hull, City of",State-funded special school,Physical Disability,68,47,21
"Kingston upon Hull, City of",State-funded special school,Profound & Multiple Learning Difficulty,23,12,11
"Kingston upon Hull, City of",State-funded special school,Severe Learning Difficulty,261,171,90
"Kingston upon Hull, City of",State-funded special school,"Social, Emotional and Mental Health",145,125,20
"Kingston upon Hull, City of",State-funded special school,Specific Learning Difficulty,15,11,4
"Kingston upon Hull, City of",State-funded special school,"Speech, Language and Communications needs",91,74,17
"Kingston upon Hull, City of",State-funded special school,Visual Impairment,3,1,2
East Riding of Yorkshire,State-funded AP school,Autistic Spectrum Disorder,6,5,1
East Riding of Yorkshire,State-funded AP school,Moderate Learning Difficulty,13,11,2
East Riding of Yorkshire,State-funded AP school,Other Difficulty/Disability,1,1,0
East Riding of Yorkshire,State-funded AP school,Physical Disability,3,3,0
East Riding of Yorkshire,State-funded AP school,"Social, Emotional and Mental Health",60,51,9
East Riding of Yorkshire,State-funded AP school,Specific Learning Difficulty,7,6,1
East Riding of Yorkshire,State-funded AP school,"Speech, Language and Communications needs",7,6,1
East Riding of Yorkshire,State-funded AP school,Visual Impairment,1,1,0
East Riding of Yorkshire,State-funded nursery,Autistic Spectrum Disorder,4,3,1
East Riding of Yorkshire,State-funded nursery,Hearing Impairment,1,1,0
East Riding of Yorkshire,State-funded nursery,Other Difficulty/Disability,6,4,2
East Riding of Yorkshire,State-funded nursery,Physical Disability,2,0,2
East Riding of Yorkshire,State-funded nursery,"Social, Emotional and Mental Health",1,1,0
East Riding of Yorkshire,State-funded nursery,"Speech, Language and Communications needs",37,27,10
East Riding of Yorkshire,State-funded primary,Autistic Spectrum Disorder,187,156,31
East Riding of Yorkshire,State-funded primary,Hearing Impairment,33,14,19
East Riding of Yorkshire,State-funded primary,Moderate Learning Difficulty,855,528,327
East Riding of Yorkshire,State-funded primary,Multi- Sensory Impairment,20,13,7
East Riding of Yorkshire,State-funded primary,Other Difficulty/Disability,154,97,57
East Riding of Yorkshire,State-funded primary,Physical Disability,116,76,40
East Riding of Yorkshire,State-funded primary,Profound & Multiple Learning Difficulty,6,6,0
East Riding of Yorkshire,State-funded primary,SEN support but no specialist assessment of type of need,171,98,73
East Riding of Yorkshire,State-funded primary,Severe Learning Difficulty,20,12,8
East Riding of Yorkshire,State-funded primary,"Social, Emotional and Mental Health",565,394,171
East Riding of Yorkshire,State-funded primary,Specific Learning Difficulty,493,270,223
East Riding of Yorkshire,State-funded primary,"Speech, Language and Communications needs",1182,850,332
East Riding of Yorkshire,State-funded primary,Visual Impairment,31,18,13
East Riding of Yorkshire,State-funded secondary,Autistic Spectrum Disorder,278,219,59
East Riding of Yorkshire,State-funded secondary,Hearing Impairment,51,27,24
East Riding of Yorkshire,State-funded secondary,Moderate Learning Difficulty,692,401,291
East Riding of Yorkshire,State-funded secondary,Multi- Sensory Impairment,6,4,2
East Riding of Yorkshire,State-funded secondary,Other Difficulty/Disability,78,41,37
East Riding of Yorkshire,State-funded secondary,Physical Disability,92,50,42
East Riding of Yorkshire,State-funded secondary,Profound & Multiple Learning Difficulty,1,0,1
East Riding of Yorkshire,State-funded secondary,SEN support but no specialist assessment of type of need,49,31,18
East Riding of Yorkshire,State-funded secondary,Severe Learning Difficulty,8,4,4
East Riding of Yorkshire,State-funded secondary,"Social, Emotional and Mental Health",548,374,174
East Riding of Yorkshire,State-funded secondary,Specific Learning Difficulty,637,405,232
East Riding of Yorkshire,State-funded secondary,"Speech, Language and Communications needs",329,220,109
East Riding of Yorkshire,State-funded secondary,Visual Impairment,42,28,14
East Riding of Yorkshire,State-funded special school,Autistic Spectrum Disorder,83,69,14
East Riding of Yorkshire,State-funded special school,Hearing Impairment,1,1,0
East Riding of Yorkshire,State-funded special school,Moderate Learning Difficulty,25,16,9
East Riding of Yorkshire,State-funded special school,Multi- Sensory Impairment,1,1,0
East Riding of Yorkshire,State-funded special school,Other Difficulty/Disability,23,17,6
East Riding of Yorkshire,State-funded special school,Physical Disability,14,11,3
East Riding of Yorkshire,State-funded special school,Profound & Multiple Learning Difficulty,18,9,9
East Riding of Yorkshire,State-funded special school,Severe Learning Difficulty,221,154,67
East Riding of Yorkshire,State-funded special school,"Social, Emotional and Mental Health",8,7,1
East Riding of Yorkshire,State-funded special school,Specific Learning Difficulty,6,5,1
East Riding of Yorkshire,State-funded special school,"Speech, Language and Communications needs",42,30,12
North East Lincolnshire,State-funded AP school,"Social, Emotional and Mental Health",69,46,23
North East Lincolnshire,State-funded AP school,"Speech, Language and Communications needs",3,3,0
North East Lincolnshire,State-funded nursery,"Speech, Language and Communications needs",1,0,1
North East Lincolnshire,State-funded primary,Autistic Spectrum Disorder,79,66,13
North East Lincolnshire,State-funded primary,Hearing Impairment,18,12,6
North East Lincolnshire,State-funded primary,Moderate Learning Difficulty,749,399,350
North East Lincolnshire,State-funded primary,Multi- Sensory Impairment,3,2,1
North East Lincolnshire,State-funded primary,Other Difficulty/Disability,39,24,15
North East Lincolnshire,State-funded primary,Physical Disability,79,41,38
North East Lincolnshire,State-funded primary,Profound & Multiple Learning Difficulty,8,4,4
North East Lincolnshire,State-funded primary,SEN support but no specialist assessment of type of need,45,28,17
North East Lincolnshire,State-funded primary,Severe Learning Difficulty,9,4,5
North East Lincolnshire,State-funded primary,"Social, Emotional and Mental Health",361,267,94
North East Lincolnshire,State-funded primary,Specific Learning Difficulty,197,113,84
North East Lincolnshire,State-funded primary,"Speech, Language and Communications needs",587,442,145
North East Lincolnshire,State-funded primary,Visual Impairment,23,16,7
North East Lincolnshire,State-funded secondary,Autistic Spectrum Disorder,61,44,17
North East Lincolnshire,State-funded secondary,Hearing Impairment,23,10,13
North East Lincolnshire,State-funded secondary,Moderate Learning Difficulty,500,297,203
North East Lincolnshire,State-funded secondary,Multi- Sensory Impairment,1,1,0
North East Lincolnshire,State-funded secondary,Other Difficulty/Disability,18,13,5
North East Lincolnshire,State-funded secondary,Physical Disability,51,30,21
North East Lincolnshire,State-funded secondary,SEN support but no specialist assessment of type of need,9,4,5
North East Lincolnshire,State-funded secondary,Severe Learning Difficulty,7,3,4
North East Lincolnshire,State-funded secondary,"Social, Emotional and Mental Health",325,231,94
North East Lincolnshire,State-funded secondary,Specific Learning Difficulty,258,158,100
North East Lincolnshire,State-funded secondary,"Speech, Language and Communications needs",97,70,27
North East Lincolnshire,State-funded secondary,Visual Impairment,13,7,6
North East Lincolnshire,State-funded special school,Autistic Spectrum Disorder,106,90,16
North East Lincolnshire,State-funded special school,Moderate Learning Difficulty,35,24,11
North East Lincolnshire,State-funded special school,Physical Disability,12,5,7
North East Lincolnshire,State-funded special school,Profound & Multiple Learning Difficulty,37,21,16
North East Lincolnshire,State-funded special school,Severe Learning Difficulty,116,78,38
North East Lincolnshire,State-funded special school,"Social, Emotional and Mental Health",2,2,0
North East Lincolnshire,State-funded special school,Specific Learning Difficulty,14,10,4
North East Lincolnshire,State-funded special school,"Speech, Language and Communications needs",33,23,10
North East Lincolnshire,State-funded special school,Visual Impairment,2,2,0
North Lincolnshire,State-funded AP school,Autistic Spectrum Disorder,1,1,0
North Lincolnshire,State-funded AP school,"Social, Emotional and Mental Health",6,4,2
North Lincolnshire,State-funded primary,Autistic Spectrum Disorder,229,174,55
North Lincolnshire,State-funded primary,Hearing Impairment,30,16,14
North Lincolnshire,State-funded primary,Moderate Learning Difficulty,301,178,123
North Lincolnshire,State-funded primary,Other Difficulty/Disability,27,14,13
North Lincolnshire,State-funded primary,Physical Disability,80,60,20
North Lincolnshire,State-funded primary,SEN support but no specialist assessment of type of need,45,25,20
North Lincolnshire,State-funded primary,Severe Learning Difficulty,2,2,0
North Lincolnshire,State-funded primary,"Social, Emotional and Mental Health",404,313,91
North Lincolnshire,State-funded primary,Specific Learning Difficulty,309,159,150
North Lincolnshire,State-funded primary,"Speech, Language and Communications needs",668,441,227
North Lincolnshire,State-funded primary,Visual Impairment,21,12,9
North Lincolnshire,State-funded secondary,Autistic Spectrum Disorder,297,217,80
North Lincolnshire,State-funded secondary,Hearing Impairment,37,20,17
North Lincolnshire,State-funded secondary,Moderate Learning Difficulty,357,222,135
North Lincolnshire,State-funded secondary,Multi- Sensory Impairment,2,0,2
North Lincolnshire,State-funded secondary,Other Difficulty/Disability,50,31,19
North Lincolnshire,State-funded secondary,Physical Disability,62,29,33
North Lincolnshire,State-funded secondary,SEN support but no specialist assessment of type of need,49,23,26
North Lincolnshire,State-funded secondary,Severe Learning Difficulty,4,1,3
North Lincolnshire,State-funded secondary,"Social, Emotional and Mental Health",529,331,198
North Lincolnshire,State-funded secondary,Specific Learning Difficulty,327,187,140
North Lincolnshire,State-funded secondary,"Speech, Language and Communications needs",131,89,42
North Lincolnshire,State-funded secondary,Visual Impairment,17,9,8
North Lincolnshire,State-funded special school,Autistic Spectrum Disorder,111,89,22
North Lincolnshire,State-funded special school,Hearing Impairment,1,1,0
North Lincolnshire,State-funded special school,Moderate Learning Difficulty,38,26,12
North Lincolnshire,State-funded special school,Other Difficulty/Disability,1,0,1
North Lincolnshire,State-funded special school,Physical Disability,26,15,11
North Lincolnshire,State-funded special school,Profound & Multiple Learning Difficulty,14,8,6
North Lincolnshire,State-funded special school,Severe Learning Difficulty,29,15,14
North Lincolnshire,State-funded special school,"Social, Emotional and Mental Health",6,3,3
North Lincolnshire,State-funded special school,Specific Learning Difficulty,3,2,1
North Lincolnshire,State-funded special school,"Speech, Language and Communications needs",114,79,35
North Lincolnshire,State-funded special school,Visual Impairment,1,0,1
York,State-funded AP school,Autistic Spectrum Disorder,36,26,10
York,State-funded AP school,Moderate Learning Difficulty,5,4,1
York,State-funded AP school,Other Difficulty/Disability,1,1,0
York,State-funded AP school,Physical Disability,1,1,0
York,State-funded AP school,"Social, Emotional and Mental Health",78,57,21
York,State-funded AP school,Specific Learning Difficulty,1,1,0
York,State-funded AP school,"Speech, Language and Communications needs",9,5,4
York,State-funded nursery,Autistic Spectrum Disorder,4,4,0
York,State-funded nursery,Other Difficulty/Disability,1,1,0
York,State-funded nursery,Physical Disability,1,1,0
York,State-funded nursery,"Social, Emotional and Mental Health",3,3,0
York,State-funded nursery,"Speech, Language and Communications needs",14,9,5
York,State-funded primary,Autistic Spectrum Disorder,260,192,68
York,State-funded primary,Hearing Impairment,38,22,16
York,State-funded primary,Moderate Learning Difficulty,207,119,88
York,State-funded primary,Multi- Sensory Impairment,3,2,1
York,State-funded primary,Other Difficulty/Disability,34,17,17
York,State-funded primary,Physical Disability,67,37,30
York,State-funded primary,SEN support but no specialist assessment of type of need,28,21,7
York,State-funded primary,"Social, Emotional and Mental Health",454,297,157
York,State-funded primary,Specific Learning Difficulty,252,143,109
York,State-funded primary,"Speech, Language and Communications needs",460,333,127
York,State-funded primary,Visual Impairment,14,7,7
York,State-funded secondary,Autistic Spectrum Disorder,256,182,74
York,State-funded secondary,Hearing Impairment,44,18,26
York,State-funded secondary,Moderate Learning Difficulty,164,90,74
York,State-funded secondary,Other Difficulty/Disability,52,36,16
York,State-funded secondary,Physical Disability,55,33,22
York,State-funded secondary,Profound & Multiple Learning Difficulty,1,1,0
York,State-funded secondary,SEN support but no specialist assessment of type of need,8,4,4
York,State-funded secondary,Severe Learning Difficulty,1,0,1
York,State-funded secondary,"Social, Emotional and Mental Health",361,231,130
York,State-funded secondary,Specific Learning Difficulty,326,191,135
York,State-funded secondary,"Speech, Language and Communications needs",107,64,43
York,State-funded secondary,Visual Impairment,21,16,5
York,State-funded special school,Autistic Spectrum Disorder,151,129,22
York,State-funded special school,Moderate Learning Difficulty,45,24,21
York,State-funded special school,Other Difficulty/Disability,1,1,0
York,State-funded special school,Physical Disability,24,14,10
York,State-funded special school,Profound & Multiple Learning Difficulty,31,16,15
York,State-funded special school,Severe Learning Difficulty,27,17,10
York,State-funded special school,"Social, Emotional and Mental Health",2,2,0
York,State-funded special school,Specific Learning Difficulty,1,0,1
York,State-funded special school,"Speech, Language and Communications needs",26,14,12
York,State-funded special school,Visual Impairment,4,2,2
Barnsley,State-funded AP school,Autistic Spectrum Disorder,3,2,1
Barnsley,State-funded AP school,Moderate Learning Difficulty,3,3,0
Barnsley,State-funded AP school,SEN support but no specialist assessment of type of need,1,0,1
Barnsley,State-funded AP school,"Social, Emotional and Mental Health",26,19,7
Barnsley,State-funded AP school,Specific Learning Difficulty,3,2,1
Barnsley,State-funded AP school,"Speech, Language and Communications needs",2,2,0
Barnsley,State-funded primary,Autistic Spectrum Disorder,455,350,105
Barnsley,State-funded primary,Hearing Impairment,41,21,20
Barnsley,State-funded primary,Moderate Learning Difficulty,431,263,168
Barnsley,State-funded primary,Multi- Sensory Impairment,9,8,1
Barnsley,State-funded primary,Other Difficulty/Disability,78,44,34
Barnsley,State-funded primary,Physical Disability,77,47,30
Barnsley,State-funded primary,Profound & Multiple Learning Difficulty,4,3,1
Barnsley,State-funded primary,SEN support but no specialist assessment of type of need,7,4,3
Barnsley,State-funded primary,Severe Learning Difficulty,23,17,6
Barnsley,State-funded primary,"Social, Emotional and Mental Health",567,414,153
Barnsley,State-funded primary,Specific Learning Difficulty,442,264,178
Barnsley,State-funded primary,"Speech, Language and Communications needs",1006,706,300
Barnsley,State-funded primary,Visual Impairment,27,13,14
Barnsley,State-funded secondary,Autistic Spectrum Disorder,331,235,96
Barnsley,State-funded secondary,Hearing Impairment,42,22,20
Barnsley,State-funded secondary,Moderate Learning Difficulty,467,279,188
Barnsley,State-funded secondary,Multi- Sensory Impairment,3,2,1
Barnsley,State-funded secondary,Other Difficulty/Disability,49,42,7
Barnsley,State-funded secondary,Physical Disability,57,32,25
Barnsley,State-funded secondary,Profound & Multiple Learning Difficulty,3,0,3
Barnsley,State-funded secondary,SEN support but no specialist assessment of type of need,6,4,2
Barnsley,State-funded secondary,Severe Learning Difficulty,4,3,1
Barnsley,State-funded secondary,"Social, Emotional and Mental Health",447,286,161
Barnsley,State-funded secondary,Specific Learning Difficulty,332,188,144
Barnsley,State-funded secondary,"Speech, Language and Communications needs",176,126,50
Barnsley,State-funded secondary,Visual Impairment,24,10,14
Barnsley,State-funded special school,Autistic Spectrum Disorder,122,97,25
Barnsley,State-funded special school,Hearing Impairment,6,4,2
Barnsley,State-funded special school,Moderate Learning Difficulty,34,21,13
Barnsley,State-funded special school,Multi- Sensory Impairment,1,0,1
Barnsley,State-funded special school,Other Difficulty/Disability,7,6,1
Barnsley,State-funded special school,Physical Disability,9,5,4
Barnsley,State-funded special school,Profound & Multiple Learning Difficulty,19,11,8
Barnsley,State-funded special school,Severe Learning Difficulty,28,16,12
Barnsley,State-funded special school,"Social, Emotional and Mental Health",99,95,4
Barnsley,State-funded special school,Specific Learning Difficulty,41,29,12
Barnsley,State-funded special school,"Speech, Language and Communications needs",63,46,17
Barnsley,State-funded special school,Visual Impairment,9,6,3
Doncaster,Non-maintained special school,Hearing Impairment,35,19,16
Doncaster,Non-maintained special school,Multi- Sensory Impairment,1,1,0
Doncaster,Non-maintained special school,Profound & Multiple Learning Difficulty,1,0,1
Doncaster,Non-maintained special school,"Speech, Language and Communications needs",1,1,0
Doncaster,State-funded AP school,Autistic Spectrum Disorder,15,12,3
Doncaster,State-funded AP school,Physical Disability,1,1,0
Doncaster,State-funded AP school,"Social, Emotional and Mental Health",4,2,2
Doncaster,State-funded AP school,Specific Learning Difficulty,1,1,0
Doncaster,State-funded AP school,"Speech, Language and Communications needs",1,1,0
Doncaster,State-funded primary,Autistic Spectrum Disorder,353,278,75
Doncaster,State-funded primary,Hearing Impairment,77,34,43
Doncaster,State-funded primary,Moderate Learning Difficulty,601,379,222
Doncaster,State-funded primary,Multi- Sensory Impairment,3,2,1
Doncaster,State-funded primary,Other Difficulty/Disability,47,27,20
Doncaster,State-funded primary,Physical Disability,117,68,49
Doncaster,State-funded primary,Profound & Multiple Learning Difficulty,5,2,3
Doncaster,State-funded primary,SEN support but no specialist assessment of type of need,45,30,15
Doncaster,State-funded primary,Severe Learning Difficulty,6,2,4
Doncaster,State-funded primary,"Social, Emotional and Mental Health",989,721,268
Doncaster,State-funded primary,Specific Learning Difficulty,665,375,290
Doncaster,State-funded primary,"Speech, Language and Communications needs",1600,1169,431
Doncaster,State-funded primary,Visual Impairment,49,28,21
Doncaster,State-funded secondary,Autistic Spectrum Disorder,437,341,96
Doncaster,State-funded secondary,Hearing Impairment,60,35,25
Doncaster,State-funded secondary,Moderate Learning Difficulty,473,285,188
Doncaster,State-funded secondary,Other Difficulty/Disability,60,42,18
Doncaster,State-funded secondary,Physical Disability,69,34,35
Doncaster,State-funded secondary,Profound & Multiple Learning Difficulty,1,1,0
Doncaster,State-funded secondary,SEN support but no specialist assessment of type of need,28,21,7
Doncaster,State-funded secondary,Severe Learning Difficulty,1,1,0
Doncaster,State-funded secondary,"Social, Emotional and Mental Health",635,443,192
Doncaster,State-funded secondary,Specific Learning Difficulty,475,265,210
Doncaster,State-funded secondary,"Speech, Language and Communications needs",275,199,76
Doncaster,State-funded secondary,Visual Impairment,39,18,21
Doncaster,State-funded special school,Autistic Spectrum Disorder,294,239,55
Doncaster,State-funded special school,Hearing Impairment,3,2,1
Doncaster,State-funded special school,Moderate Learning Difficulty,89,57,32
Doncaster,State-funded special school,Other Difficulty/Disability,8,6,2
Doncaster,State-funded special school,Physical Disability,31,18,13
Doncaster,State-funded special school,Profound & Multiple Learning Difficulty,46,24,22
Doncaster,State-funded special school,Severe Learning Difficulty,88,51,37
Doncaster,State-funded special school,"Social, Emotional and Mental Health",31,20,11
Doncaster,State-funded special school,Specific Learning Difficulty,14,9,5
Doncaster,State-funded special school,"Speech, Language and Communications needs",105,76,29
Doncaster,State-funded special school,Visual Impairment,5,3,2
Rotherham,State-funded AP school,Hearing Impairment,1,0,1
Rotherham,State-funded AP school,Moderate Learning Difficulty,7,5,2
Rotherham,State-funded AP school,Other Difficulty/Disability,2,2,0
Rotherham,State-funded AP school,"Social, Emotional and Mental Health",70,49,21
Rotherham,State-funded AP school,Specific Learning Difficulty,11,5,6
Rotherham,State-funded nursery,Autistic Spectrum Disorder,4,4,0
Rotherham,State-funded nursery,Hearing Impairment,1,0,1
Rotherham,State-funded nursery,Other Difficulty/Disability,18,12,6
Rotherham,State-funded nursery,Physical Disability,5,2,3
Rotherham,State-funded nursery,Specific Learning Difficulty,5,3,2
Rotherham,State-funded nursery,"Speech, Language and Communications needs",54,43,11
Rotherham,State-funded primary,Autistic Spectrum Disorder,695,497,198
Rotherham,State-funded primary,Hearing Impairment,70,43,27
Rotherham,State-funded primary,Moderate Learning Difficulty,428,234,194
Rotherham,State-funded primary,Multi- Sensory Impairment,10,4,6
Rotherham,State-funded primary,Other Difficulty/Disability,224,134,90
Rotherham,State-funded primary,Physical Disability,84,50,34
Rotherham,State-funded primary,Profound & Multiple Learning Difficulty,5,4,1
Rotherham,State-funded primary,SEN support but no specialist assessment of type of need,271,162,109
Rotherham,State-funded primary,Severe Learning Difficulty,7,3,4
Rotherham,State-funded primary,"Social, Emotional and Mental Health",672,456,216
Rotherham,State-funded primary,Specific Learning Difficulty,775,417,358
Rotherham,State-funded primary,"Speech, Language and Communications needs",1426,970,456
Rotherham,State-funded primary,Visual Impairment,39,18,21
Rotherham,State-funded secondary,Autistic Spectrum Disorder,614,451,163
Rotherham,State-funded secondary,Hearing Impairment,60,28,32
Rotherham,State-funded secondary,Moderate Learning Difficulty,447,256,191
Rotherham,State-funded secondary,Other Difficulty/Disability,165,102,63
Rotherham,State-funded secondary,Physical Disability,81,45,36
Rotherham,State-funded secondary,Profound & Multiple Learning Difficulty,1,0,1
Rotherham,State-funded secondary,SEN support but no specialist assessment of type of need,51,26,25
Rotherham,State-funded secondary,Severe Learning Difficulty,4,4,0
Rotherham,State-funded secondary,"Social, Emotional and Mental Health",696,467,229
Rotherham,State-funded secondary,Specific Learning Difficulty,916,511,405
Rotherham,State-funded secondary,"Speech, Language and Communications needs",219,144,75
Rotherham,State-funded secondary,Visual Impairment,45,26,19
Rotherham,State-funded special school,Autistic Spectrum Disorder,349,282,67
Rotherham,State-funded special school,Hearing Impairment,9,6,3
Rotherham,State-funded special school,Moderate Learning Difficulty,176,117,59
Rotherham,State-funded special school,Multi- Sensory Impairment,1,1,0
Rotherham,State-funded special school,Other Difficulty/Disability,39,23,16
Rotherham,State-funded special school,Physical Disability,46,20,26
Rotherham,State-funded special school,Profound & Multiple Learning Difficulty,47,26,21
Rotherham,State-funded special school,Severe Learning Difficulty,63,43,20
Rotherham,State-funded special school,"Social, Emotional and Mental Health",159,127,32
Rotherham,State-funded special school,Specific Learning Difficulty,70,49,21
Rotherham,State-funded special school,"Speech, Language and Communications needs",117,84,33
Rotherham,State-funded special school,Visual Impairment,9,5,4
Sheffield,Non-maintained special school,Other Difficulty/Disability,1,1,0
Sheffield,Non-maintained special school,Physical Disability,33,19,14
Sheffield,Non-maintained special school,Profound & Multiple Learning Difficulty,11,5,6
Sheffield,Non-maintained special school,Severe Learning Difficulty,1,0,1
Sheffield,State-funded AP school,Autistic Spectrum Disorder,8,6,2
Sheffield,State-funded AP school,Hearing Impairment,3,2,1
Sheffield,State-funded AP school,Moderate Learning Difficulty,13,8,5
Sheffield,State-funded AP school,Multi- Sensory Impairment,1,1,0
Sheffield,State-funded AP school,Other Difficulty/Disability,6,6,0
Sheffield,State-funded AP school,"Social, Emotional and Mental Health",101,79,22
Sheffield,State-funded AP school,Specific Learning Difficulty,7,5,2
Sheffield,State-funded AP school,"Speech, Language and Communications needs",7,6,1
Sheffield,State-funded nursery,Autistic Spectrum Disorder,8,7,1
Sheffield,State-funded nursery,Hearing Impairment,2,1,1
Sheffield,State-funded nursery,Multi- Sensory Impairment,2,1,1
Sheffield,State-funded nursery,Other Difficulty/Disability,2,2,0
Sheffield,State-funded nursery,Profound & Multiple Learning Difficulty,1,0,1
Sheffield,State-funded nursery,"Social, Emotional and Mental Health",1,0,1
Sheffield,State-funded nursery,Specific Learning Difficulty,1,1,0
Sheffield,State-funded nursery,"Speech, Language and Communications needs",39,23,16
Sheffield,State-funded primary,Autistic Spectrum Disorder,1210,907,303
Sheffield,State-funded primary,Hearing Impairment,161,65,96
Sheffield,State-funded primary,Moderate Learning Difficulty,1196,673,523
Sheffield,State-funded primary,Multi- Sensory Impairment,5,3,2
Sheffield,State-funded primary,Other Difficulty/Disability,215,109,106
Sheffield,State-funded primary,Physical Disability,134,77,57
Sheffield,State-funded primary,Profound & Multiple Learning Difficulty,21,14,7
Sheffield,State-funded primary,SEN support but no specialist assessment of type of need,141,83,58
Sheffield,State-funded primary,Severe Learning Difficulty,40,26,14
Sheffield,State-funded primary,"Social, Emotional and Mental Health",1325,977,348
Sheffield,State-funded primary,Specific Learning Difficulty,580,330,250
Sheffield,State-funded primary,"Speech, Language and Communications needs",3340,2315,1025
Sheffield,State-funded primary,Visual Impairment,57,35,22
Sheffield,State-funded secondary,Autistic Spectrum Disorder,1124,795,329
Sheffield,State-funded secondary,Hearing Impairment,153,74,79
Sheffield,State-funded secondary,Moderate Learning Difficulty,999,578,421
Sheffield,State-funded secondary,Multi- Sensory Impairment,5,3,2
Sheffield,State-funded secondary,Other Difficulty/Disability,208,124,84
Sheffield,State-funded secondary,Physical Disability,87,48,39
Sheffield,State-funded secondary,Profound & Multiple Learning Difficulty,3,2,1
Sheffield,State-funded secondary,SEN support but no specialist assessment of type of need,28,15,13
Sheffield,State-funded secondary,Severe Learning Difficulty,38,23,15
Sheffield,State-funded secondary,"Social, Emotional and Mental Health",1404,889,515
Sheffield,State-funded secondary,Specific Learning Difficulty,862,475,387
Sheffield,State-funded secondary,"Speech, Language and Communications needs",646,437,209
Sheffield,State-funded secondary,Visual Impairment,74,51,23
Sheffield,State-funded special school,Autistic Spectrum Disorder,788,610,178
Sheffield,State-funded special school,Hearing Impairment,4,2,2
Sheffield,State-funded special school,Moderate Learning Difficulty,49,27,22
Sheffield,State-funded special school,Other Difficulty/Disability,23,14,9
Sheffield,State-funded special school,Physical Disability,38,22,16
Sheffield,State-funded special school,Profound & Multiple Learning Difficulty,76,50,26
Sheffield,State-funded special school,Severe Learning Difficulty,261,153,108
Sheffield,State-funded special school,"Social, Emotional and Mental Health",205,158,47
Sheffield,State-funded special school,Specific Learning Difficulty,27,19,8
Sheffield,State-funded special school,"Speech, Language and Communications needs",102,75,27
Sheffield,State-funded special school,Visual Impairment,6,4,2
Bradford,State-funded AP school,Autistic Spectrum Disorder,1,1,0
Bradford,State-funded AP school,Moderate Learning Difficulty,1,0,1
Bradford,State-funded AP school,Other Difficulty/Disability,1,1,0
Bradford,State-funded AP school,"Social, Emotional and Mental Health",76,61,15
Bradford,State-funded AP school,"Speech, Language and Communications needs",2,1,1
Bradford,State-funded nursery,Autistic Spectrum Disorder,6,5,1
Bradford,State-funded nursery,Hearing Impairment,4,1,3
Bradford,State-funded nursery,Moderate Learning Difficulty,3,3,0
Bradford,State-funded nursery,Other Difficulty/Disability,3,2,1
Bradford,State-funded nursery,Physical Disability,12,7,5
Bradford,State-funded nursery,Profound & Multiple Learning Difficulty,17,10,7
Bradford,State-funded nursery,Severe Learning Difficulty,16,12,4
Bradford,State-funded nursery,"Social, Emotional and Mental Health",6,6,0
Bradford,State-funded nursery,Specific Learning Difficulty,4,3,1
Bradford,State-funded nursery,"Speech, Language and Communications needs",140,93,47
Bradford,State-funded nursery,Visual Impairment,3,2,1
Bradford,State-funded primary,Autistic Spectrum Disorder,767,590,177
Bradford,State-funded primary,Hearing Impairment,214,120,94
Bradford,State-funded primary,Moderate Learning Difficulty,1669,1009,660
Bradford,State-funded primary,Multi- Sensory Impairment,14,8,6
Bradford,State-funded primary,Other Difficulty/Disability,259,146,113
Bradford,State-funded primary,Physical Disability,289,145,144
Bradford,State-funded primary,Profound & Multiple Learning Difficulty,21,13,8
Bradford,State-funded primary,SEN support but no specialist assessment of type of need,325,200,125
Bradford,State-funded primary,Severe Learning Difficulty,65,40,25
Bradford,State-funded primary,"Social, Emotional and Mental Health",1462,1054,408
Bradford,State-funded primary,Specific Learning Difficulty,462,261,201
Bradford,State-funded primary,"Speech, Language and Communications needs",3521,2400,1121
Bradford,State-funded primary,Visual Impairment,91,46,45
Bradford,State-funded secondary,Autistic Spectrum Disorder,800,616,184
Bradford,State-funded secondary,Hearing Impairment,185,89,96
Bradford,State-funded secondary,Moderate Learning Difficulty,1854,1084,770
Bradford,State-funded secondary,Multi- Sensory Impairment,1,1,0
Bradford,State-funded secondary,Other Difficulty/Disability,167,97,70
Bradford,State-funded secondary,Physical Disability,273,145,128
Bradford,State-funded secondary,Profound & Multiple Learning Difficulty,2,1,1
Bradford,State-funded secondary,SEN support but no specialist assessment of type of need,90,52,38
Bradford,State-funded secondary,Severe Learning Difficulty,78,36,42
Bradford,State-funded secondary,"Social, Emotional and Mental Health",1633,1094,539
Bradford,State-funded secondary,Specific Learning Difficulty,877,444,433
Bradford,State-funded secondary,"Speech, Language and Communications needs",828,580,248
Bradford,State-funded secondary,Visual Impairment,117,63,54
Bradford,State-funded special school,Autistic Spectrum Disorder,544,438,106
Bradford,State-funded special school,Hearing Impairment,5,3,2
Bradford,State-funded special school,Moderate Learning Difficulty,19,12,7
Bradford,State-funded special school,Multi- Sensory Impairment,5,4,1
Bradford,State-funded special school,Other Difficulty/Disability,5,4,1
Bradford,State-funded special school,Physical Disability,88,54,34
Bradford,State-funded special school,Profound & Multiple Learning Difficulty,185,106,79
Bradford,State-funded special school,Severe Learning Difficulty,250,147,103
Bradford,State-funded special school,"Social, Emotional and Mental Health",205,183,22
Bradford,State-funded special school,Specific Learning Difficulty,10,9,1
Bradford,State-funded special school,"Speech, Language and Communications needs",142,103,39
Bradford,State-funded special school,Visual Impairment,11,9,2
Calderdale,Non-maintained special school,"Social, Emotional and Mental Health",78,78,0
Calderdale,State-funded AP school,Moderate Learning Difficulty,10,8,2
Calderdale,State-funded AP school,SEN support but no specialist assessment of type of need,1,1,0
Calderdale,State-funded AP school,"Social, Emotional and Mental Health",60,45,15
Calderdale,State-funded AP school,Specific Learning Difficulty,2,2,0
Calderdale,State-funded AP school,"Speech, Language and Communications needs",3,3,0
Calderdale,State-funded primary,Autistic Spectrum Disorder,188,140,48
Calderdale,State-funded primary,Hearing Impairment,44,28,16
Calderdale,State-funded primary,Moderate Learning Difficulty,764,434,330
Calderdale,State-funded primary,Multi- Sensory Impairment,10,5,5
Calderdale,State-funded primary,Other Difficulty/Disability,104,64,40
Calderdale,State-funded primary,Physical Disability,96,58,38
Calderdale,State-funded primary,Profound & Multiple Learning Difficulty,16,8,8
Calderdale,State-funded primary,SEN support but no specialist assessment of type of need,82,50,32
Calderdale,State-funded primary,Severe Learning Difficulty,11,9,2
Calderdale,State-funded primary,"Social, Emotional and Mental Health",500,369,131
Calderdale,State-funded primary,Specific Learning Difficulty,310,173,137
Calderdale,State-funded primary,"Speech, Language and Communications needs",928,634,294
Calderdale,State-funded primary,Visual Impairment,33,18,15
Calderdale,State-funded secondary,Autistic Spectrum Disorder,324,238,86
Calderdale,State-funded secondary,Hearing Impairment,57,31,26
Calderdale,State-funded secondary,Moderate Learning Difficulty,570,340,230
Calderdale,State-funded secondary,Multi- Sensory Impairment,4,2,2
Calderdale,State-funded secondary,Other Difficulty/Disability,81,50,31
Calderdale,State-funded secondary,Physical Disability,67,37,30
Calderdale,State-funded secondary,Profound & Multiple Learning Difficulty,2,2,0
Calderdale,State-funded secondary,SEN support but no specialist assessment of type of need,104,58,46
Calderdale,State-funded secondary,Severe Learning Difficulty,11,6,5
Calderdale,State-funded secondary,"Social, Emotional and Mental Health",379,252,127
Calderdale,State-funded secondary,Specific Learning Difficulty,441,216,225
Calderdale,State-funded secondary,"Speech, Language and Communications needs",198,129,69
Calderdale,State-funded secondary,Visual Impairment,38,21,17
Calderdale,State-funded special school,Autistic Spectrum Disorder,157,127,30
Calderdale,State-funded special school,Hearing Impairment,2,2,0
Calderdale,State-funded special school,Moderate Learning Difficulty,6,3,3
Calderdale,State-funded special school,Multi- Sensory Impairment,3,2,1
Calderdale,State-funded special school,Other Difficulty/Disability,3,1,2
Calderdale,State-funded special school,Physical Disability,11,3,8
Calderdale,State-funded special school,Profound & Multiple Learning Difficulty,43,20,23
Calderdale,State-funded special school,Severe Learning Difficulty,183,114,69
Calderdale,State-funded special school,"Social, Emotional and Mental Health",11,11,0
Calderdale,State-funded special school,Specific Learning Difficulty,10,10,0
Calderdale,State-funded special school,"Speech, Language and Communications needs",25,20,5
Calderdale,State-funded special school,Visual Impairment,6,1,5
Kirklees,Non-maintained special school,Autistic Spectrum Disorder,1,0,1
Kirklees,Non-maintained special school,Multi- Sensory Impairment,1,0,1
Kirklees,Non-maintained special school,Other Difficulty/Disability,1,1,0
Kirklees,Non-maintained special school,Profound & Multiple Learning Difficulty,33,12,21
Kirklees,Non-maintained special school,Severe Learning Difficulty,2,2,0
Kirklees,Non-maintained special school,"Social, Emotional and Mental Health",1,1,0
Kirklees,State-funded AP school,Autistic Spectrum Disorder,1,0,1
Kirklees,State-funded AP school,Hearing Impairment,1,0,1
Kirklees,State-funded AP school,Moderate Learning Difficulty,4,3,1
Kirklees,State-funded AP school,SEN support but no specialist assessment of type of need,1,0,1
Kirklees,State-funded AP school,"Social, Emotional and Mental Health",37,26,11
Kirklees,State-funded AP school,Specific Learning Difficulty,1,1,0
Kirklees,State-funded AP school,"Speech, Language and Communications needs",2,2,0
Kirklees,State-funded nursery,"Speech, Language and Communications needs",9,4,5
Kirklees,State-funded primary,Autistic Spectrum Disorder,228,180,48
Kirklees,State-funded primary,Hearing Impairment,100,52,48
Kirklees,State-funded primary,Moderate Learning Difficulty,1548,930,618
Kirklees,State-funded primary,Multi- Sensory Impairment,38,27,11
Kirklees,State-funded primary,Other Difficulty/Disability,121,73,48
Kirklees,State-funded primary,Physical Disability,141,84,57
Kirklees,State-funded primary,Profound & Multiple Learning Difficulty,44,31,13
Kirklees,State-funded primary,SEN support but no specialist assessment of type of need,561,351,210
Kirklees,State-funded primary,Severe Learning Difficulty,57,37,20
Kirklees,State-funded primary,"Social, Emotional and Mental Health",1002,730,272
Kirklees,State-funded primary,Specific Learning Difficulty,415,236,179
Kirklees,State-funded primary,"Speech, Language and Communications needs",1950,1409,541
Kirklees,State-funded primary,Visual Impairment,68,38,30
Kirklees,State-funded secondary,Autistic Spectrum Disorder,223,150,73
Kirklees,State-funded secondary,Hearing Impairment,108,55,53
Kirklees,State-funded secondary,Moderate Learning Difficulty,721,476,245
Kirklees,State-funded secondary,Multi- Sensory Impairment,29,14,15
Kirklees,State-funded secondary,Other Difficulty/Disability,314,194,120
Kirklees,State-funded secondary,Physical Disability,135,71,64
Kirklees,State-funded secondary,Profound & Multiple Learning Difficulty,8,7,1
Kirklees,State-funded secondary,SEN support but no specialist assessment of type of need,175,89,86
Kirklees,State-funded secondary,Severe Learning Difficulty,20,14,6
Kirklees,State-funded secondary,"Social, Emotional and Mental Health",1010,629,381
Kirklees,State-funded secondary,Specific Learning Difficulty,542,317,225
Kirklees,State-funded secondary,"Speech, Language and Communications needs",558,404,154
Kirklees,State-funded secondary,Visual Impairment,82,43,39
Kirklees,State-funded special school,Autistic Spectrum Disorder,225,184,41
Kirklees,State-funded special school,Hearing Impairment,1,0,1
Kirklees,State-funded special school,Moderate Learning Difficulty,69,46,23
Kirklees,State-funded special school,Multi- Sensory Impairment,2,2,0
Kirklees,State-funded special school,Other Difficulty/Disability,12,10,2
Kirklees,State-funded special school,Physical Disability,18,14,4
Kirklees,State-funded special school,Profound & Multiple Learning Difficulty,114,55,59
Kirklees,State-funded special school,Severe Learning Difficulty,115,72,43
Kirklees,State-funded special school,"Social, Emotional and Mental Health",113,107,6
Kirklees,State-funded special school,Specific Learning Difficulty,20,11,9
Kirklees,State-funded special school,"Speech, Language and Communications needs",131,90,41
Kirklees,State-funded special school,Visual Impairment,3,2,1
Leeds,Non-maintained special school,Autistic Spectrum Disorder,16,12,4
Leeds,Non-maintained special school,Hearing Impairment,17,10,7
Leeds,Non-maintained special school,Moderate Learning Difficulty,2,2,0
Leeds,Non-maintained special school,Multi- Sensory Impairment,1,0,1
Leeds,Non-maintained special school,Other Difficulty/Disability,1,0,1
Leeds,Non-maintained special school,Profound & Multiple Learning Difficulty,1,1,0
Leeds,Non-maintained special school,Severe Learning Difficulty,1,1,0
Leeds,Non-maintained special school,"Social, Emotional and Mental Health",3,3,0
Leeds,Non-maintained special school,Specific Learning Difficulty,1,1,0
Leeds,Non-maintained special school,"Speech, Language and Communications needs",10,8,2
Leeds,Non-maintained special school,Visual Impairment,3,0,3
Leeds,State-funded AP school,"Social, Emotional and Mental Health",2,2,0
Leeds,State-funded primary,Autistic Spectrum Disorder,1163,871,292
Leeds,State-funded primary,Hearing Impairment,177,92,85
Leeds,State-funded primary,Moderate Learning Difficulty,2003,1165,838
Leeds,State-funded primary,Multi- Sensory Impairment,13,9,4
Leeds,State-funded primary,Other Difficulty/Disability,329,192,137
Leeds,State-funded primary,Physical Disability,254,154,100
Leeds,State-funded primary,Profound & Multiple Learning Difficulty,25,15,10
Leeds,State-funded primary,SEN support but no specialist assessment of type of need,187,129,58
Leeds,State-funded primary,Severe Learning Difficulty,78,47,31
Leeds,State-funded primary,"Social, Emotional and Mental Health",1824,1336,488
Leeds,State-funded primary,Specific Learning Difficulty,949,493,456
Leeds,State-funded primary,"Speech, Language and Communications needs",5755,3976,1779
Leeds,State-funded primary,Visual Impairment,111,64,47
Leeds,State-funded secondary,Autistic Spectrum Disorder,1085,755,330
Leeds,State-funded secondary,Hearing Impairment,237,111,126
Leeds,State-funded secondary,Moderate Learning Difficulty,1574,920,654
Leeds,State-funded secondary,Multi- Sensory Impairment,9,5,4
Leeds,State-funded secondary,Other Difficulty/Disability,219,130,89
Leeds,State-funded secondary,Physical Disability,159,90,69
Leeds,State-funded secondary,Profound & Multiple Learning Difficulty,9,6,3
Leeds,State-funded secondary,SEN support but no specialist assessment of type of need,233,132,101
Leeds,State-funded secondary,Severe Learning Difficulty,19,12,7
Leeds,State-funded secondary,"Social, Emotional and Mental Health",2013,1284,728
Leeds,State-funded secondary,Specific Learning Difficulty,1437,752,685
Leeds,State-funded secondary,"Speech, Language and Communications needs",991,676,315
Leeds,State-funded secondary,Visual Impairment,81,43,38
Leeds,State-funded special school,Autistic Spectrum Disorder,723,585,138
Leeds,State-funded special school,Hearing Impairment,4,3,1
Leeds,State-funded special school,Moderate Learning Difficulty,233,151,82
Leeds,State-funded special school,Multi- Sensory Impairment,2,1,1
Leeds,State-funded special school,Other Difficulty/Disability,116,70,46
Leeds,State-funded special school,Physical Disability,30,18,12
Leeds,State-funded special school,Profound & Multiple Learning Difficulty,91,52,39
Leeds,State-funded special school,SEN support but no specialist assessment of type of need,1,1,0
Leeds,State-funded special school,Severe Learning Difficulty,195,127,68
Leeds,State-funded special school,"Social, Emotional and Mental Health",328,284,44
Leeds,State-funded special school,Specific Learning Difficulty,84,58,26
Leeds,State-funded special school,"Speech, Language and Communications needs",145,104,41
Leeds,State-funded special school,Visual Impairment,11,6,5
Wakefield,State-funded AP school,Autistic Spectrum Disorder,22,19,3
Wakefield,State-funded AP school,Moderate Learning Difficulty,6,4,2
Wakefield,State-funded AP school,Other Difficulty/Disability,3,2,1
Wakefield,State-funded AP school,Physical Disability,3,1,2
Wakefield,State-funded AP school,Profound & Multiple Learning Difficulty,6,5,1
Wakefield,State-funded AP school,SEN support but no specialist assessment of type of need,3,0,3
Wakefield,State-funded AP school,Severe Learning Difficulty,4,2,2
Wakefield,State-funded AP school,"Social, Emotional and Mental Health",68,61,7
Wakefield,State-funded AP school,Specific Learning Difficulty,1,1,0
Wakefield,State-funded AP school,"Speech, Language and Communications needs",30,27,3
Wakefield,State-funded AP school,Visual Impairment,3,2,1
Wakefield,State-funded nursery,Autistic Spectrum Disorder,2,2,0
Wakefield,State-funded nursery,Hearing Impairment,1,1,0
Wakefield,State-funded nursery,Multi- Sensory Impairment,1,1,0
Wakefield,State-funded nursery,"Speech, Language and Communications needs",25,16,9
Wakefield,State-funded primary,Autistic Spectrum Disorder,572,449,123
Wakefield,State-funded primary,Hearing Impairment,125,57,68
Wakefield,State-funded primary,Moderate Learning Difficulty,849,494,355
Wakefield,State-funded primary,Multi- Sensory Impairment,11,7,4
Wakefield,State-funded primary,Other Difficulty/Disability,170,108,62
Wakefield,State-funded primary,Physical Disability,187,103,84
Wakefield,State-funded primary,Profound & Multiple Learning Difficulty,7,4,3
Wakefield,State-funded primary,SEN support but no specialist assessment of type of need,531,353,178
Wakefield,State-funded primary,Severe Learning Difficulty,31,22,9
Wakefield,State-funded primary,"Social, Emotional and Mental Health",979,715,264
Wakefield,State-funded primary,Specific Learning Difficulty,277,163,114
Wakefield,State-funded primary,"Speech, Language and Communications needs",1899,1320,579
Wakefield,State-funded primary,Visual Impairment,81,46,35
Wakefield,State-funded secondary,Autistic Spectrum Disorder,673,505,168
Wakefield,State-funded secondary,Hearing Impairment,91,50,41
Wakefield,State-funded secondary,Moderate Learning Difficulty,558,330,228
Wakefield,State-funded secondary,Multi- Sensory Impairment,4,3,1
Wakefield,State-funded secondary,Other Difficulty/Disability,177,100,77
Wakefield,State-funded secondary,Physical Disability,163,78,85
Wakefield,State-funded secondary,SEN support but no specialist assessment of type of need,52,29,23
Wakefield,State-funded secondary,Severe Learning Difficulty,23,13,10
Wakefield,State-funded secondary,"Social, Emotional and Mental Health",756,469,287
Wakefield,State-funded secondary,Specific Learning Difficulty,350,204,146
Wakefield,State-funded secondary,"Speech, Language and Communications needs",316,219,97
Wakefield,State-funded secondary,Visual Impairment,68,36,32
Wakefield,State-funded special school,Autistic Spectrum Disorder,215,174,41
Wakefield,State-funded special school,Hearing Impairment,1,1,0
Wakefield,State-funded special school,Moderate Learning Difficulty,8,4,4
Wakefield,State-funded special school,Multi- Sensory Impairment,1,1,0
Wakefield,State-funded special school,Other Difficulty/Disability,4,2,2
Wakefield,State-funded special school,Physical Disability,20,12,8
Wakefield,State-funded special school,Profound & Multiple Learning Difficulty,59,29,30
Wakefield,State-funded special school,Severe Learning Difficulty,169,91,78
Wakefield,State-funded special school,"Social, Emotional and Mental Health",83,68,15
Wakefield,State-funded special school,Specific Learning Difficulty,12,5,7
Wakefield,State-funded special school,"Speech, Language and Communications needs",78,57,21
North Yorkshire,Non-maintained special school,Autistic Spectrum Disorder,63,63,0
North Yorkshire,Non-maintained special school,"Social, Emotional and Mental Health",3,3,0
North Yorkshire,State-funded AP school,Moderate Learning Difficulty,1,1,0
North Yorkshire,State-funded AP school,SEN support but no specialist assessment of type of need,1,1,0
North Yorkshire,State-funded AP school,"Social, Emotional and Mental Health",32,21,11
North Yorkshire,State-funded AP school,Specific Learning Difficulty,3,2,1
North Yorkshire,State-funded nursery,Autistic Spectrum Disorder,6,3,3
North Yorkshire,State-funded nursery,Moderate Learning Difficulty,2,2,0
North Yorkshire,State-funded nursery,Other Difficulty/Disability,2,0,2
North Yorkshire,State-funded nursery,Profound & Multiple Learning Difficulty,1,1,0
North Yorkshire,State-funded nursery,"Speech, Language and Communications needs",4,3,1
North Yorkshire,State-funded primary,Autistic Spectrum Disorder,848,617,231
North Yorkshire,State-funded primary,Hearing Impairment,96,54,42
North Yorkshire,State-funded primary,Moderate Learning Difficulty,1100,638,462
North Yorkshire,State-funded primary,Multi- Sensory Impairment,32,18,14
North Yorkshire,State-funded primary,Other Difficulty/Disability,137,81,56
North Yorkshire,State-funded primary,Physical Disability,167,95,72
North Yorkshire,State-funded primary,Profound & Multiple Learning Difficulty,20,13,7
North Yorkshire,State-funded primary,SEN support but no specialist assessment of type of need,308,189,119
North Yorkshire,State-funded primary,Severe Learning Difficulty,45,29,16
North Yorkshire,State-funded primary,"Social, Emotional and Mental Health",1140,821,319
North Yorkshire,State-funded primary,Specific Learning Difficulty,1087,618,469
North Yorkshire,State-funded primary,"Speech, Language and Communications needs",1879,1346,533
North Yorkshire,State-funded primary,Visual Impairment,43,17,26
North Yorkshire,State-funded secondary,Autistic Spectrum Disorder,851,605,246
North Yorkshire,State-funded secondary,Hearing Impairment,110,53,57
North Yorkshire,State-funded secondary,Moderate Learning Difficulty,775,452,322
North Yorkshire,State-funded secondary,Multi- Sensory Impairment,16,9,7
North Yorkshire,State-funded secondary,Other Difficulty/Disability,289,195,94
North Yorkshire,State-funded secondary,Physical Disability,140,83,57
North Yorkshire,State-funded secondary,Profound & Multiple Learning Difficulty,1,1,0
North Yorkshire,State-funded secondary,SEN support but no specialist assessment of type of need,142,84,58
North Yorkshire,State-funded secondary,Severe Learning Difficulty,14,8,6
North Yorkshire,State-funded secondary,"Social, Emotional and Mental Health",1201,761,440
North Yorkshire,State-funded secondary,Specific Learning Difficulty,1199,700,499
North Yorkshire,State-funded secondary,"Speech, Language and Communications needs",459,314,145
North Yorkshire,State-funded secondary,Visual Impairment,59,30,29
North Yorkshire,State-funded special school,Autistic Spectrum Disorder,438,352,86
North Yorkshire,State-funded special school,Hearing Impairment,5,2,3
North Yorkshire,State-funded special school,Moderate Learning Difficulty,132,72,60
North Yorkshire,State-funded special school,Multi- Sensory Impairment,4,2,2
North Yorkshire,State-funded special school,Other Difficulty/Disability,13,6,7
North Yorkshire,State-funded special school,Physical Disability,53,35,18
North Yorkshire,State-funded special school,Profound & Multiple Learning Difficulty,57,39,18
North Yorkshire,State-funded special school,Severe Learning Difficulty,127,72,55
North Yorkshire,State-funded special school,"Social, Emotional and Mental Health",175,154,21
North Yorkshire,State-funded special school,Specific Learning Difficulty,19,11,8
North Yorkshire,State-funded special school,"Speech, Language and Communications needs",134,80,54
North Yorkshire,State-funded special school,Visual Impairment,11,6,5
Derby,Non-maintained special school,Hearing Impairment,93,55,38
Derby,Non-maintained special school,Multi- Sensory Impairment,1,1,0
Derby,Non-maintained special school,Profound & Multiple Learning Difficulty,1,1,0
Derby,Non-maintained special school,"Speech, Language and Communications needs",8,4,4
Derby,State-funded AP school,Moderate Learning Difficulty,1,1,0
Derby,State-funded AP school,SEN support but no specialist assessment of type of need,1,1,0
Derby,State-funded AP school,"Social, Emotional and Mental Health",56,42,14
Derby,State-funded nursery,Autistic Spectrum Disorder,28,23,5
Derby,State-funded nursery,Hearing Impairment,1,0,1
Derby,State-funded nursery,Moderate Learning Difficulty,2,2,0
Derby,State-funded nursery,Multi- Sensory Impairment,1,0,1
Derby,State-funded nursery,Other Difficulty/Disability,1,1,0
Derby,State-funded nursery,Physical Disability,5,3,2
Derby,State-funded nursery,SEN support but no specialist assessment of type of need,10,5,5
Derby,State-funded nursery,"Social, Emotional and Mental Health",21,14,7
Derby,State-funded nursery,"Speech, Language and Communications needs",39,25,14
Derby,State-funded nursery,Visual Impairment,2,1,1
Derby,State-funded primary,Autistic Spectrum Disorder,764,563,201
Derby,State-funded primary,Hearing Impairment,73,30,43
Derby,State-funded primary,Moderate Learning Difficulty,695,403,292
Derby,State-funded primary,Multi- Sensory Impairment,5,2,3
Derby,State-funded primary,Other Difficulty/Disability,72,51,21
Derby,State-funded primary,Physical Disability,110,63,47
Derby,State-funded primary,Profound & Multiple Learning Difficulty,6,4,2
Derby,State-funded primary,SEN support but no specialist assessment of type of need,144,83,61
Derby,State-funded primary,Severe Learning Difficulty,24,14,10
Derby,State-funded primary,"Social, Emotional and Mental Health",661,480,181
Derby,State-funded primary,Specific Learning Difficulty,216,131,85
Derby,State-funded primary,"Speech, Language and Communications needs",1343,945,398
Derby,State-funded primary,Visual Impairment,43,28,15
Derby,State-funded secondary,Autistic Spectrum Disorder,516,374,142
Derby,State-funded secondary,Hearing Impairment,70,39,31
Derby,State-funded secondary,Moderate Learning Difficulty,590,335,255
Derby,State-funded secondary,Multi- Sensory Impairment,6,2,4
Derby,State-funded secondary,Other Difficulty/Disability,242,160,82
Derby,State-funded secondary,Physical Disability,77,39,38
Derby,State-funded secondary,SEN support but no specialist assessment of type of need,35,28,7
Derby,State-funded secondary,Severe Learning Difficulty,15,9,6
Derby,State-funded secondary,"Social, Emotional and Mental Health",734,447,287
Derby,State-funded secondary,Specific Learning Difficulty,327,202,125
Derby,State-funded secondary,"Speech, Language and Communications needs",211,144,67
Derby,State-funded secondary,Visual Impairment,44,21,23
Derby,State-funded special school,Autistic Spectrum Disorder,365,288,77
Derby,State-funded special school,Hearing Impairment,5,4,1
Derby,State-funded special school,Moderate Learning Difficulty,69,43,26
Derby,State-funded special school,Multi- Sensory Impairment,5,3,2
Derby,State-funded special school,Other Difficulty/Disability,10,6,4
Derby,State-funded special school,Physical Disability,13,7,6
Derby,State-funded special school,Profound & Multiple Learning Difficulty,101,62,39
Derby,State-funded special school,Severe Learning Difficulty,70,41,29
Derby,State-funded special school,"Social, Emotional and Mental Health",133,102,31
Derby,State-funded special school,Specific Learning Difficulty,23,13,10
Derby,State-funded special school,"Speech, Language and Communications needs",59,42,17
Derby,State-funded special school,Visual Impairment,7,6,1
Leicester,State-funded AP school,Autistic Spectrum Disorder,2,2,0
Leicester,State-funded AP school,Other Difficulty/Disability,9,5,4
Leicester,State-funded AP school,"Social, Emotional and Mental Health",12,10,2
Leicester,State-funded primary,Autistic Spectrum Disorder,375,279,96
Leicester,State-funded primary,Hearing Impairment,69,38,31
Leicester,State-funded primary,Moderate Learning Difficulty,830,496,334
Leicester,State-funded primary,Multi- Sensory Impairment,6,3,3
Leicester,State-funded primary,Other Difficulty/Disability,185,118,67
Leicester,State-funded primary,Physical Disability,102,65,37
Leicester,State-funded primary,Profound & Multiple Learning Difficulty,7,2,5
Leicester,State-funded primary,SEN support but no specialist assessment of type of need,162,103,59
Leicester,State-funded primary,Severe Learning Difficulty,17,10,7
Leicester,State-funded primary,"Social, Emotional and Mental Health",943,686,257
Leicester,State-funded primary,Specific Learning Difficulty,238,133,105
Leicester,State-funded primary,"Speech, Language and Communications needs",1974,1428,546
Leicester,State-funded primary,Visual Impairment,62,36,26
Leicester,State-funded secondary,Autistic Spectrum Disorder,239,175,64
Leicester,State-funded secondary,Hearing Impairment,76,37,39
Leicester,State-funded secondary,Moderate Learning Difficulty,844,477,367
Leicester,State-funded secondary,Multi- Sensory Impairment,4,2,2
Leicester,State-funded secondary,Other Difficulty/Disability,242,153,89
Leicester,State-funded secondary,Physical Disability,64,31,33
Leicester,State-funded secondary,SEN support but no specialist assessment of type of need,59,37,22
Leicester,State-funded secondary,Severe Learning Difficulty,10,4,6
Leicester,State-funded secondary,"Social, Emotional and Mental Health",872,584,288
Leicester,State-funded secondary,Specific Learning Difficulty,312,176,136
Leicester,State-funded secondary,"Speech, Language and Communications needs",435,318,117
Leicester,State-funded secondary,Visual Impairment,63,38,25
Leicester,State-funded special school,Autistic Spectrum Disorder,343,262,81
Leicester,State-funded special school,Hearing Impairment,10,8,2
Leicester,State-funded special school,Moderate Learning Difficulty,47,32,15
Leicester,State-funded special school,Multi- Sensory Impairment,3,2,1
Leicester,State-funded special school,Other Difficulty/Disability,4,4,0
Leicester,State-funded special school,Physical Disability,144,86,58
Leicester,State-funded special school,Profound & Multiple Learning Difficulty,24,12,12
Leicester,State-funded special school,Severe Learning Difficulty,125,77,48
Leicester,State-funded special school,"Social, Emotional and Mental Health",260,225,35
Leicester,State-funded special school,Specific Learning Difficulty,10,9,1
Leicester,State-funded special school,"Speech, Language and Communications needs",263,181,82
Leicester,State-funded special school,Visual Impairment,6,4,2
Rutland,State-funded primary,Autistic Spectrum Disorder,32,23,9
Rutland,State-funded primary,Hearing Impairment,5,3,2
Rutland,State-funded primary,Moderate Learning Difficulty,71,44,27
Rutland,State-funded primary,Multi- Sensory Impairment,2,2,0
Rutland,State-funded primary,Other Difficulty/Disability,7,4,3
Rutland,State-funded primary,Physical Disability,6,2,4
Rutland,State-funded primary,SEN support but no specialist assessment of type of need,29,20,9
Rutland,State-funded primary,Severe Learning Difficulty,4,4,0
Rutland,State-funded primary,"Social, Emotional and Mental Health",114,87,27
Rutland,State-funded primary,Specific Learning Difficulty,65,37,28
Rutland,State-funded primary,"Speech, Language and Communications needs",89,62,27
Rutland,State-funded primary,Visual Impairment,4,2,2
Rutland,State-funded secondary,Autistic Spectrum Disorder,42,32,10
Rutland,State-funded secondary,Hearing Impairment,6,5,1
Rutland,State-funded secondary,Moderate Learning Difficulty,79,47,32
Rutland,State-funded secondary,Multi- Sensory Impairment,1,1,0
Rutland,State-funded secondary,Other Difficulty/Disability,9,6,3
Rutland,State-funded secondary,Physical Disability,3,2,1
Rutland,State-funded secondary,SEN support but no specialist assessment of type of need,17,10,7
Rutland,State-funded secondary,Severe Learning Difficulty,1,1,0
Rutland,State-funded secondary,"Social, Emotional and Mental Health",80,56,24
Rutland,State-funded secondary,Specific Learning Difficulty,101,59,42
Rutland,State-funded secondary,"Speech, Language and Communications needs",26,18,8
Rutland,State-funded secondary,Visual Impairment,4,3,1
Rutland,State-funded special school,Autistic Spectrum Disorder,6,5,1
Rutland,State-funded special school,Profound & Multiple Learning Difficulty,1,0,1
Rutland,State-funded special school,Severe Learning Difficulty,1,0,1
Nottingham,Non-maintained special school,Autistic Spectrum Disorder,53,48,5
Nottingham,Non-maintained special school,"Speech, Language and Communications needs",1,1,0
Nottingham,State-funded AP school,Autistic Spectrum Disorder,17,14,3
Nottingham,State-funded AP school,Moderate Learning Difficulty,5,5,0
Nottingham,State-funded AP school,Multi- Sensory Impairment,1,1,0
Nottingham,State-funded AP school,Other Difficulty/Disability,19,12,7
Nottingham,State-funded AP school,Physical Disability,1,0,1
Nottingham,State-funded AP school,SEN support but no specialist assessment of type of need,2,1,1
Nottingham,State-funded AP school,"Social, Emotional and Mental Health",179,138,41
Nottingham,State-funded AP school,Specific Learning Difficulty,7,5,2
Nottingham,State-funded AP school,"Speech, Language and Communications needs",2,2,0
Nottingham,State-funded nursery,Autistic Spectrum Disorder,1,1,0
Nottingham,State-funded nursery,Moderate Learning Difficulty,2,1,1
Nottingham,State-funded nursery,"Social, Emotional and Mental Health",2,2,0
Nottingham,State-funded nursery,Specific Learning Difficulty,1,1,0
Nottingham,State-funded nursery,"Speech, Language and Communications needs",10,8,2
Nottingham,State-funded primary,Autistic Spectrum Disorder,702,558,144
Nottingham,State-funded primary,Hearing Impairment,75,39,36
Nottingham,State-funded primary,Moderate Learning Difficulty,778,476,302
Nottingham,State-funded primary,Multi- Sensory Impairment,9,6,3
Nottingham,State-funded primary,Other Difficulty/Disability,234,156,78
Nottingham,State-funded primary,Physical Disability,131,64,67
Nottingham,State-funded primary,Profound & Multiple Learning Difficulty,17,14,3
Nottingham,State-funded primary,SEN support but no specialist assessment of type of need,149,97,52
Nottingham,State-funded primary,Severe Learning Difficulty,16,9,7
Nottingham,State-funded primary,"Social, Emotional and Mental Health",841,594,247
Nottingham,State-funded primary,Specific Learning Difficulty,225,118,107
Nottingham,State-funded primary,"Speech, Language and Communications needs",1077,762,315
Nottingham,State-funded primary,Visual Impairment,32,19,13
Nottingham,State-funded secondary,Autistic Spectrum Disorder,518,409,109
Nottingham,State-funded secondary,Hearing Impairment,48,25,23
Nottingham,State-funded secondary,Moderate Learning Difficulty,536,307,229
Nottingham,State-funded secondary,Multi- Sensory Impairment,2,2,0
Nottingham,State-funded secondary,Other Difficulty/Disability,185,125,60
Nottingham,State-funded secondary,Physical Disability,83,47,36
Nottingham,State-funded secondary,Profound & Multiple Learning Difficulty,3,1,2
Nottingham,State-funded secondary,SEN support but no specialist assessment of type of need,45,15,30
Nottingham,State-funded secondary,Severe Learning Difficulty,11,8,3
Nottingham,State-funded secondary,"Social, Emotional and Mental Health",685,452,233
Nottingham,State-funded secondary,Specific Learning Difficulty,287,141,146
Nottingham,State-funded secondary,"Speech, Language and Communications needs",224,156,68
Nottingham,State-funded secondary,Visual Impairment,29,18,11
Nottingham,State-funded special school,Autistic Spectrum Disorder,269,226,43
Nottingham,State-funded special school,Hearing Impairment,3,3,0
Nottingham,State-funded special school,Moderate Learning Difficulty,17,12,5
Nottingham,State-funded special school,Other Difficulty/Disability,7,7,0
Nottingham,State-funded special school,Physical Disability,6,1,5
Nottingham,State-funded special school,Profound & Multiple Learning Difficulty,59,36,23
Nottingham,State-funded special school,Severe Learning Difficulty,110,63,47
Nottingham,State-funded special school,"Social, Emotional and Mental Health",109,103,6
Nottingham,State-funded special school,Specific Learning Difficulty,30,13,17
Nottingham,State-funded special school,"Speech, Language and Communications needs",25,22,3
Nottingham,State-funded special school,Visual Impairment,2,1,1
North Northamptonshire,State-funded nursery,Autistic Spectrum Disorder,9,7,2
North Northamptonshire,State-funded nursery,Hearing Impairment,2,2,0
North Northamptonshire,State-funded nursery,Moderate Learning Difficulty,1,0,1
North Northamptonshire,State-funded nursery,Multi- Sensory Impairment,1,0,1
North Northamptonshire,State-funded nursery,Other Difficulty/Disability,1,0,1
North Northamptonshire,State-funded nursery,Physical Disability,3,1,2
North Northamptonshire,State-funded nursery,Profound & Multiple Learning Difficulty,1,1,0
North Northamptonshire,State-funded nursery,"Social, Emotional and Mental Health",17,11,6
North Northamptonshire,State-funded nursery,"Speech, Language and Communications needs",37,24,13
North Northamptonshire,State-funded primary,Autistic Spectrum Disorder,312,232,80
North Northamptonshire,State-funded primary,Hearing Impairment,89,38,51
North Northamptonshire,State-funded primary,Moderate Learning Difficulty,647,375,272
North Northamptonshire,State-funded primary,Multi- Sensory Impairment,10,5,5
North Northamptonshire,State-funded primary,Other Difficulty/Disability,175,111,64
North Northamptonshire,State-funded primary,Physical Disability,98,57,41
North Northamptonshire,State-funded primary,Profound & Multiple Learning Difficulty,8,5,3
North Northamptonshire,State-funded primary,SEN support but no specialist assessment of type of need,230,143,87
North Northamptonshire,State-funded primary,Severe Learning Difficulty,33,23,10
North Northamptonshire,State-funded primary,"Social, Emotional and Mental Health",833,618,215
North Northamptonshire,State-funded primary,Specific Learning Difficulty,506,292,214
North Northamptonshire,State-funded primary,"Speech, Language and Communications needs",1324,927,397
North Northamptonshire,State-funded primary,Visual Impairment,35,20,15
North Northamptonshire,State-funded secondary,Autistic Spectrum Disorder,298,220,78
North Northamptonshire,State-funded secondary,Hearing Impairment,75,35,40
North Northamptonshire,State-funded secondary,Moderate Learning Difficulty,356,205,151
North Northamptonshire,State-funded secondary,Multi- Sensory Impairment,36,21,15
North Northamptonshire,State-funded secondary,Other Difficulty/Disability,182,119,63
North Northamptonshire,State-funded secondary,Physical Disability,90,43,47
North Northamptonshire,State-funded secondary,Profound & Multiple Learning Difficulty,13,6,7
North Northamptonshire,State-funded secondary,SEN support but no specialist assessment of type of need,170,102,68
North Northamptonshire,State-funded secondary,Severe Learning Difficulty,59,37,22
North Northamptonshire,State-funded secondary,"Social, Emotional and Mental Health",751,504,247
North Northamptonshire,State-funded secondary,Specific Learning Difficulty,678,340,338
North Northamptonshire,State-funded secondary,"Speech, Language and Communications needs",234,157,77
North Northamptonshire,State-funded secondary,Visual Impairment,44,21,23
North Northamptonshire,State-funded special school,Autistic Spectrum Disorder,266,216,50
North Northamptonshire,State-funded special school,Hearing Impairment,7,4,3
North Northamptonshire,State-funded special school,Moderate Learning Difficulty,167,111,56
North Northamptonshire,State-funded special school,Multi- Sensory Impairment,5,3,2
North Northamptonshire,State-funded special school,Other Difficulty/Disability,45,27,18
North Northamptonshire,State-funded special school,Physical Disability,24,13,11
North Northamptonshire,State-funded special school,Profound & Multiple Learning Difficulty,30,15,15
North Northamptonshire,State-funded special school,SEN support but no specialist assessment of type of need,1,0,1
North Northamptonshire,State-funded special school,Severe Learning Difficulty,144,92,52
North Northamptonshire,State-funded special school,"Social, Emotional and Mental Health",186,161,25
North Northamptonshire,State-funded special school,Specific Learning Difficulty,66,39,27
North Northamptonshire,State-funded special school,"Speech, Language and Communications needs",248,183,65
North Northamptonshire,State-funded special school,Visual Impairment,6,4,2
West Northamptonshire,State-funded AP school,Autistic Spectrum Disorder,2,0,2
West Northamptonshire,State-funded AP school,Moderate Learning Difficulty,1,1,0
West Northamptonshire,State-funded AP school,Other Difficulty/Disability,2,1,1
West Northamptonshire,State-funded AP school,SEN support but no specialist assessment of type of need,1,1,0
West Northamptonshire,State-funded AP school,"Social, Emotional and Mental Health",123,98,25
West Northamptonshire,State-funded AP school,Specific Learning Difficulty,3,2,1
West Northamptonshire,State-funded AP school,"Speech, Language and Communications needs",1,1,0
West Northamptonshire,State-funded nursery,Autistic Spectrum Disorder,4,3,1
West Northamptonshire,State-funded nursery,Hearing Impairment,1,1,0
West Northamptonshire,State-funded nursery,Other Difficulty/Disability,1,0,1
West Northamptonshire,State-funded nursery,Physical Disability,1,0,1
West Northamptonshire,State-funded nursery,SEN support but no specialist assessment of type of need,4,2,2
West Northamptonshire,State-funded nursery,"Social, Emotional and Mental Health",2,2,0
West Northamptonshire,State-funded nursery,"Speech, Language and Communications needs",1,1,0
West Northamptonshire,State-funded primary,Autistic Spectrum Disorder,598,437,161
West Northamptonshire,State-funded primary,Hearing Impairment,100,46,54
West Northamptonshire,State-funded primary,Moderate Learning Difficulty,523,296,227
West Northamptonshire,State-funded primary,Multi- Sensory Impairment,16,11,5
West Northamptonshire,State-funded primary,Other Difficulty/Disability,334,229,105
West Northamptonshire,State-funded primary,Physical Disability,146,86,60
West Northamptonshire,State-funded primary,Profound & Multiple Learning Difficulty,16,10,6
West Northamptonshire,State-funded primary,SEN support but no specialist assessment of type of need,320,191,129
West Northamptonshire,State-funded primary,Severe Learning Difficulty,60,33,27
West Northamptonshire,State-funded primary,"Social, Emotional and Mental Health",875,620,255
West Northamptonshire,State-funded primary,Specific Learning Difficulty,474,271,203
West Northamptonshire,State-funded primary,"Speech, Language and Communications needs",1349,968,381
West Northamptonshire,State-funded primary,Visual Impairment,45,22,23
West Northamptonshire,State-funded secondary,Autistic Spectrum Disorder,456,329,127
West Northamptonshire,State-funded secondary,Hearing Impairment,119,55,64
West Northamptonshire,State-funded secondary,Moderate Learning Difficulty,656,327,329
West Northamptonshire,State-funded secondary,Multi- Sensory Impairment,14,6,8
West Northamptonshire,State-funded secondary,Other Difficulty/Disability,235,109,126
West Northamptonshire,State-funded secondary,Physical Disability,107,61,46
West Northamptonshire,State-funded secondary,Profound & Multiple Learning Difficulty,11,7,4
West Northamptonshire,State-funded secondary,SEN support but no specialist assessment of type of need,243,197,46
West Northamptonshire,State-funded secondary,Severe Learning Difficulty,16,11,5
West Northamptonshire,State-funded secondary,"Social, Emotional and Mental Health",961,629,332
West Northamptonshire,State-funded secondary,Specific Learning Difficulty,812,451,361
West Northamptonshire,State-funded secondary,"Speech, Language and Communications needs",373,261,112
West Northamptonshire,State-funded secondary,Visual Impairment,69,43,26
West Northamptonshire,State-funded special school,Autistic Spectrum Disorder,487,381,106
West Northamptonshire,State-funded special school,Hearing Impairment,7,3,4
West Northamptonshire,State-funded special school,Moderate Learning Difficulty,86,52,34
West Northamptonshire,State-funded special school,Multi- Sensory Impairment,1,0,1
West Northamptonshire,State-funded special school,Other Difficulty/Disability,26,16,10
West Northamptonshire,State-funded special school,Physical Disability,17,10,7
West Northamptonshire,State-funded special school,Profound & Multiple Learning Difficulty,37,21,16
West Northamptonshire,State-funded special school,Severe Learning Difficulty,177,99,78
West Northamptonshire,State-funded special school,"Social, Emotional and Mental Health",137,118,19
West Northamptonshire,State-funded special school,Specific Learning Difficulty,51,29,22
West Northamptonshire,State-funded special school,"Speech, Language and Communications needs",139,97,42
West Northamptonshire,State-funded special school,Visual Impairment,4,2,2
Derbyshire,State-funded AP school,Autistic Spectrum Disorder,8,6,2
Derbyshire,State-funded AP school,Moderate Learning Difficulty,7,7,0
Derbyshire,State-funded AP school,Multi- Sensory Impairment,1,1,0
Derbyshire,State-funded AP school,Other Difficulty/Disability,2,2,0
Derbyshire,State-funded AP school,Physical Disability,1,1,0
Derbyshire,State-funded AP school,SEN support but no specialist assessment of type of need,95,64,31
Derbyshire,State-funded AP school,"Social, Emotional and Mental Health",96,77,19
Derbyshire,State-funded AP school,Specific Learning Difficulty,9,7,2
Derbyshire,State-funded AP school,"Speech, Language and Communications needs",4,3,1
Derbyshire,State-funded nursery,Autistic Spectrum Disorder,15,13,2
Derbyshire,State-funded nursery,Hearing Impairment,1,1,0
Derbyshire,State-funded nursery,Multi- Sensory Impairment,1,1,0
Derbyshire,State-funded nursery,Physical Disability,7,5,2
Derbyshire,State-funded nursery,Profound & Multiple Learning Difficulty,2,2,0
Derbyshire,State-funded nursery,SEN support but no specialist assessment of type of need,2,2,0
Derbyshire,State-funded nursery,"Social, Emotional and Mental Health",11,7,4
Derbyshire,State-funded nursery,"Speech, Language and Communications needs",74,41,33
Derbyshire,State-funded primary,Autistic Spectrum Disorder,1415,1073,342
Derbyshire,State-funded primary,Hearing Impairment,222,120,102
Derbyshire,State-funded primary,Moderate Learning Difficulty,2189,1291,898
Derbyshire,State-funded primary,Multi- Sensory Impairment,47,30,17
Derbyshire,State-funded primary,Other Difficulty/Disability,328,220,108
Derbyshire,State-funded primary,Physical Disability,327,178,149
Derbyshire,State-funded primary,Profound & Multiple Learning Difficulty,47,31,16
Derbyshire,State-funded primary,SEN support but no specialist assessment of type of need,609,389,220
Derbyshire,State-funded primary,Severe Learning Difficulty,90,59,31
Derbyshire,State-funded primary,"Social, Emotional and Mental Health",2078,1475,603
Derbyshire,State-funded primary,Specific Learning Difficulty,843,495,348
Derbyshire,State-funded primary,"Speech, Language and Communications needs",2698,1855,843
Derbyshire,State-funded primary,Visual Impairment,121,72,49
Derbyshire,State-funded secondary,Autistic Spectrum Disorder,1228,872,356
Derbyshire,State-funded secondary,Hearing Impairment,161,88,73
Derbyshire,State-funded secondary,Moderate Learning Difficulty,1442,851,591
Derbyshire,State-funded secondary,Multi- Sensory Impairment,48,29,19
Derbyshire,State-funded secondary,Other Difficulty/Disability,287,185,102
Derbyshire,State-funded secondary,Physical Disability,204,122,82
Derbyshire,State-funded secondary,Profound & Multiple Learning Difficulty,2,2,0
Derbyshire,State-funded secondary,SEN support but no specialist assessment of type of need,165,94,71
Derbyshire,State-funded secondary,Severe Learning Difficulty,32,20,12
Derbyshire,State-funded secondary,"Social, Emotional and Mental Health",1718,1070,648
Derbyshire,State-funded secondary,Specific Learning Difficulty,1360,794,566
Derbyshire,State-funded secondary,"Speech, Language and Communications needs",442,314,128
Derbyshire,State-funded secondary,Visual Impairment,88,47,41
Derbyshire,State-funded special school,Autistic Spectrum Disorder,526,415,111
Derbyshire,State-funded special school,Hearing Impairment,4,3,1
Derbyshire,State-funded special school,Moderate Learning Difficulty,41,21,20
Derbyshire,State-funded special school,Multi- Sensory Impairment,7,5,2
Derbyshire,State-funded special school,Other Difficulty/Disability,17,12,5
Derbyshire,State-funded special school,Physical Disability,32,22,10
Derbyshire,State-funded special school,Profound & Multiple Learning Difficulty,97,65,32
Derbyshire,State-funded special school,Severe Learning Difficulty,180,111,69
Derbyshire,State-funded special school,"Social, Emotional and Mental Health",86,69,17
Derbyshire,State-funded special school,Specific Learning Difficulty,33,16,17
Derbyshire,State-funded special school,"Speech, Language and Communications needs",150,114,36
Derbyshire,State-funded special school,Visual Impairment,3,3,0
Leicestershire,State-funded AP school,Moderate Learning Difficulty,1,1,0
Leicestershire,State-funded AP school,"Social, Emotional and Mental Health",2,2,0
Leicestershire,State-funded nursery,Autistic Spectrum Disorder,18,15,3
Leicestershire,State-funded nursery,Moderate Learning Difficulty,1,0,1
Leicestershire,State-funded nursery,Other Difficulty/Disability,1,1,0
Leicestershire,State-funded nursery,Physical Disability,1,1,0
Leicestershire,State-funded nursery,Profound & Multiple Learning Difficulty,3,3,0
Leicestershire,State-funded nursery,SEN support but no specialist assessment of type of need,6,6,0
Leicestershire,State-funded nursery,Severe Learning Difficulty,79,45,34
Leicestershire,State-funded primary,Autistic Spectrum Disorder,768,583,185
Leicestershire,State-funded primary,Hearing Impairment,118,50,68
Leicestershire,State-funded primary,Moderate Learning Difficulty,2160,1270,890
Leicestershire,State-funded primary,Multi- Sensory Impairment,32,21,11
Leicestershire,State-funded primary,Other Difficulty/Disability,213,126,87
Leicestershire,State-funded primary,Physical Disability,181,98,83
Leicestershire,State-funded primary,Profound & Multiple Learning Difficulty,17,13,4
Leicestershire,State-funded primary,SEN support but no specialist assessment of type of need,272,174,98
Leicestershire,State-funded primary,Severe Learning Difficulty,39,25,14
Leicestershire,State-funded primary,"Social, Emotional and Mental Health",1515,1120,395
Leicestershire,State-funded primary,Specific Learning Difficulty,757,450,307
Leicestershire,State-funded primary,"Speech, Language and Communications needs",1918,1351,567
Leicestershire,State-funded primary,Visual Impairment,84,41,43
Leicestershire,State-funded secondary,Autistic Spectrum Disorder,798,568,230
Leicestershire,State-funded secondary,Hearing Impairment,136,67,69
Leicestershire,State-funded secondary,Moderate Learning Difficulty,1703,1020,683
Leicestershire,State-funded secondary,Multi- Sensory Impairment,23,16,7
Leicestershire,State-funded secondary,Other Difficulty/Disability,407,254,153
Leicestershire,State-funded secondary,Physical Disability,153,83,70
Leicestershire,State-funded secondary,Profound & Multiple Learning Difficulty,9,5,4
Leicestershire,State-funded secondary,SEN support but no specialist assessment of type of need,36,16,20
Leicestershire,State-funded secondary,Severe Learning Difficulty,23,14,9
Leicestershire,State-funded secondary,"Social, Emotional and Mental Health",1547,996,551
Leicestershire,State-funded secondary,Specific Learning Difficulty,1311,766,545
Leicestershire,State-funded secondary,"Speech, Language and Communications needs",471,324,147
Leicestershire,State-funded secondary,Visual Impairment,93,49,44
Leicestershire,State-funded special school,Autistic Spectrum Disorder,313,251,62
Leicestershire,State-funded special school,Hearing Impairment,4,3,1
Leicestershire,State-funded special school,Moderate Learning Difficulty,172,107,65
Leicestershire,State-funded special school,Multi- Sensory Impairment,15,8,7
Leicestershire,State-funded special school,Other Difficulty/Disability,11,5,6
Leicestershire,State-funded special school,Physical Disability,26,17,9
Leicestershire,State-funded special school,Profound & Multiple Learning Difficulty,82,39,43
Leicestershire,State-funded special school,Severe Learning Difficulty,625,453,172
Leicestershire,State-funded special school,"Social, Emotional and Mental Health",109,84,25
Leicestershire,State-funded special school,Specific Learning Difficulty,35,20,15
Leicestershire,State-funded special school,"Speech, Language and Communications needs",343,234,109
Leicestershire,State-funded special school,Visual Impairment,6,3,3
Lincolnshire,State-funded AP school,Autistic Spectrum Disorder,5,5,0
Lincolnshire,State-funded AP school,Moderate Learning Difficulty,5,5,0
Lincolnshire,State-funded AP school,Multi- Sensory Impairment,1,1,0
Lincolnshire,State-funded AP school,Other Difficulty/Disability,1,0,1
Lincolnshire,State-funded AP school,SEN support but no specialist assessment of type of need,1,1,0
Lincolnshire,State-funded AP school,"Social, Emotional and Mental Health",146,107,39
Lincolnshire,State-funded AP school,Specific Learning Difficulty,3,2,1
Lincolnshire,State-funded AP school,"Speech, Language and Communications needs",11,8,3
Lincolnshire,State-funded nursery,Autistic Spectrum Disorder,5,3,2
Lincolnshire,State-funded nursery,Other Difficulty/Disability,1,0,1
Lincolnshire,State-funded nursery,Physical Disability,1,0,1
Lincolnshire,State-funded nursery,Profound & Multiple Learning Difficulty,1,1,0
Lincolnshire,State-funded nursery,SEN support but no specialist assessment of type of need,1,1,0
Lincolnshire,State-funded nursery,"Social, Emotional and Mental Health",7,7,0
Lincolnshire,State-funded nursery,Specific Learning Difficulty,5,4,1
Lincolnshire,State-funded nursery,"Speech, Language and Communications needs",21,19,2
Lincolnshire,State-funded primary,Autistic Spectrum Disorder,872,673,199
Lincolnshire,State-funded primary,Hearing Impairment,89,48,41
Lincolnshire,State-funded primary,Moderate Learning Difficulty,2481,1415,1066
Lincolnshire,State-funded primary,Multi- Sensory Impairment,32,16,16
Lincolnshire,State-funded primary,Other Difficulty/Disability,261,164,97
Lincolnshire,State-funded primary,Physical Disability,227,129,98
Lincolnshire,State-funded primary,Profound & Multiple Learning Difficulty,53,39,14
Lincolnshire,State-funded primary,SEN support but no specialist assessment of type of need,742,450,292
Lincolnshire,State-funded primary,Severe Learning Difficulty,88,53,35
Lincolnshire,State-funded primary,"Social, Emotional and Mental Health",1723,1246,477
Lincolnshire,State-funded primary,Specific Learning Difficulty,908,521,387
Lincolnshire,State-funded primary,"Speech, Language and Communications needs",2364,1677,687
Lincolnshire,State-funded primary,Visual Impairment,71,42,29
Lincolnshire,State-funded secondary,Autistic Spectrum Disorder,996,731,265
Lincolnshire,State-funded secondary,Hearing Impairment,116,50,66
Lincolnshire,State-funded secondary,Moderate Learning Difficulty,1830,1021,809
Lincolnshire,State-funded secondary,Multi- Sensory Impairment,15,8,7
Lincolnshire,State-funded secondary,Other Difficulty/Disability,535,334,201
Lincolnshire,State-funded secondary,Physical Disability,198,112,86
Lincolnshire,State-funded secondary,Profound & Multiple Learning Difficulty,6,5,1
Lincolnshire,State-funded secondary,SEN support but no specialist assessment of type of need,311,163,148
Lincolnshire,State-funded secondary,Severe Learning Difficulty,15,11,4
Lincolnshire,State-funded secondary,"Social, Emotional and Mental Health",1406,912,494
Lincolnshire,State-funded secondary,Specific Learning Difficulty,1893,1024,869
Lincolnshire,State-funded secondary,"Speech, Language and Communications needs",565,383,182
Lincolnshire,State-funded secondary,Visual Impairment,91,44,47
Lincolnshire,State-funded special school,Autistic Spectrum Disorder,582,463,119
Lincolnshire,State-funded special school,Hearing Impairment,6,0,6
Lincolnshire,State-funded special school,Moderate Learning Difficulty,205,129,76
Lincolnshire,State-funded special school,Multi- Sensory Impairment,21,12,9
Lincolnshire,State-funded special school,Other Difficulty/Disability,46,34,12
Lincolnshire,State-funded special school,Physical Disability,89,57,32
Lincolnshire,State-funded special school,Profound & Multiple Learning Difficulty,122,72,50
Lincolnshire,State-funded special school,Severe Learning Difficulty,284,187,97
Lincolnshire,State-funded special school,"Social, Emotional and Mental Health",447,367,80
Lincolnshire,State-funded special school,Specific Learning Difficulty,44,29,15
Lincolnshire,State-funded special school,"Speech, Language and Communications needs",306,218,88
Lincolnshire,State-funded special school,Visual Impairment,6,5,1
Nottinghamshire,Non-maintained special school,Autistic Spectrum Disorder,20,14,6
Nottinghamshire,Non-maintained special school,Moderate Learning Difficulty,3,2,1
Nottinghamshire,Non-maintained special school,Other Difficulty/Disability,2,0,2
Nottinghamshire,Non-maintained special school,Profound & Multiple Learning Difficulty,1,1,0
Nottinghamshire,Non-maintained special school,Severe Learning Difficulty,2,2,0
Nottinghamshire,Non-maintained special school,"Social, Emotional and Mental Health",9,6,3
Nottinghamshire,Non-maintained special school,Specific Learning Difficulty,4,4,0
Nottinghamshire,Non-maintained special school,"Speech, Language and Communications needs",36,25,11
Nottinghamshire,State-funded primary,Autistic Spectrum Disorder,1220,954,266
Nottinghamshire,State-funded primary,Hearing Impairment,121,65,56
Nottinghamshire,State-funded primary,Moderate Learning Difficulty,1375,838,537
Nottinghamshire,State-funded primary,Multi- Sensory Impairment,28,18,10
Nottinghamshire,State-funded primary,Other Difficulty/Disability,230,171,59
Nottinghamshire,State-funded primary,Physical Disability,322,165,157
Nottinghamshire,State-funded primary,Profound & Multiple Learning Difficulty,32,24,8
Nottinghamshire,State-funded primary,SEN support but no specialist assessment of type of need,300,199,101
Nottinghamshire,State-funded primary,Severe Learning Difficulty,59,33,26
Nottinghamshire,State-funded primary,"Social, Emotional and Mental Health",1671,1212,459
Nottinghamshire,State-funded primary,Specific Learning Difficulty,869,543,326
Nottinghamshire,State-funded primary,"Speech, Language and Communications needs",2006,1431,575
Nottinghamshire,State-funded primary,Visual Impairment,82,34,48
Nottinghamshire,State-funded secondary,Autistic Spectrum Disorder,1333,955,378
Nottinghamshire,State-funded secondary,Hearing Impairment,94,48,46
Nottinghamshire,State-funded secondary,Moderate Learning Difficulty,802,489,313
Nottinghamshire,State-funded secondary,Multi- Sensory Impairment,15,7,8
Nottinghamshire,State-funded secondary,Other Difficulty/Disability,221,130,91
Nottinghamshire,State-funded secondary,Physical Disability,241,130,111
Nottinghamshire,State-funded secondary,Profound & Multiple Learning Difficulty,5,3,2
Nottinghamshire,State-funded secondary,SEN support but no specialist assessment of type of need,80,52,28
Nottinghamshire,State-funded secondary,Severe Learning Difficulty,34,20,14
Nottinghamshire,State-funded secondary,"Social, Emotional and Mental Health",1668,1024,644
Nottinghamshire,State-funded secondary,Specific Learning Difficulty,855,513,342
Nottinghamshire,State-funded secondary,"Speech, Language and Communications needs",374,266,108
Nottinghamshire,State-funded secondary,Visual Impairment,96,54,42
Nottinghamshire,State-funded special school,Autistic Spectrum Disorder,673,537,136
Nottinghamshire,State-funded special school,Hearing Impairment,6,3,3
Nottinghamshire,State-funded special school,Moderate Learning Difficulty,53,35,18
Nottinghamshire,State-funded special school,Multi- Sensory Impairment,3,3,0
Nottinghamshire,State-funded special school,Other Difficulty/Disability,13,6,7
Nottinghamshire,State-funded special school,Physical Disability,31,22,9
Nottinghamshire,State-funded special school,Profound & Multiple Learning Difficulty,79,43,36
Nottinghamshire,State-funded special school,Severe Learning Difficulty,189,116,73
Nottinghamshire,State-funded special school,"Social, Emotional and Mental Health",79,63,16
Nottinghamshire,State-funded special school,Specific Learning Difficulty,33,17,16
Nottinghamshire,State-funded special school,"Speech, Language and Communications needs",38,22,16
Nottinghamshire,State-funded special school,Visual Impairment,1,1,0
"Herefordshire, County of",State-funded AP school,Moderate Learning Difficulty,5,5,0
"Herefordshire, County of",State-funded AP school,Other Difficulty/Disability,2,2,0
"Herefordshire, County of",State-funded AP school,"Social, Emotional and Mental Health",29,20,9
"Herefordshire, County of",State-funded AP school,Specific Learning Difficulty,5,3,2
"Herefordshire, County of",State-funded AP school,"Speech, Language and Communications needs",2,1,1
"Herefordshire, County of",State-funded primary,Autistic Spectrum Disorder,146,114,32
"Herefordshire, County of",State-funded primary,Hearing Impairment,38,18,20
"Herefordshire, County of",State-funded primary,Moderate Learning Difficulty,281,167,114
"Herefordshire, County of",State-funded primary,Multi- Sensory Impairment,4,3,1
"Herefordshire, County of",State-funded primary,Other Difficulty/Disability,51,30,21
"Herefordshire, County of",State-funded primary,Physical Disability,33,12,21
"Herefordshire, County of",State-funded primary,Profound & Multiple Learning Difficulty,4,1,3
"Herefordshire, County of",State-funded primary,SEN support but no specialist assessment of type of need,131,76,55
"Herefordshire, County of",State-funded primary,Severe Learning Difficulty,9,6,3
"Herefordshire, County of",State-funded primary,"Social, Emotional and Mental Health",374,270,104
"Herefordshire, County of",State-funded primary,Specific Learning Difficulty,458,247,211
"Herefordshire, County of",State-funded primary,"Speech, Language and Communications needs",727,535,192
"Herefordshire, County of",State-funded primary,Visual Impairment,11,9,2
"Herefordshire, County of",State-funded secondary,Autistic Spectrum Disorder,98,74,24
"Herefordshire, County of",State-funded secondary,Hearing Impairment,50,29,21
"Herefordshire, County of",State-funded secondary,Moderate Learning Difficulty,308,182,126
"Herefordshire, County of",State-funded secondary,Multi- Sensory Impairment,6,2,4
"Herefordshire, County of",State-funded secondary,Other Difficulty/Disability,110,79,31
"Herefordshire, County of",State-funded secondary,Physical Disability,48,28,20
"Herefordshire, County of",State-funded secondary,Profound & Multiple Learning Difficulty,4,3,1
"Herefordshire, County of",State-funded secondary,SEN support but no specialist assessment of type of need,41,23,18
"Herefordshire, County of",State-funded secondary,Severe Learning Difficulty,7,4,3
"Herefordshire, County of",State-funded secondary,"Social, Emotional and Mental Health",410,259,151
"Herefordshire, County of",State-funded secondary,Specific Learning Difficulty,629,353,276
"Herefordshire, County of",State-funded secondary,"Speech, Language and Communications needs",174,126,48
"Herefordshire, County of",State-funded secondary,Visual Impairment,26,13,13
"Herefordshire, County of",State-funded special school,Autistic Spectrum Disorder,93,82,11
"Herefordshire, County of",State-funded special school,Hearing Impairment,2,2,0
"Herefordshire, County of",State-funded special school,Moderate Learning Difficulty,19,12,7
"Herefordshire, County of",State-funded special school,Other Difficulty/Disability,1,0,1
"Herefordshire, County of",State-funded special school,Physical Disability,2,2,0
"Herefordshire, County of",State-funded special school,Profound & Multiple Learning Difficulty,21,15,6
"Herefordshire, County of",State-funded special school,Severe Learning Difficulty,145,75,70
"Herefordshire, County of",State-funded special school,"Social, Emotional and Mental Health",95,89,6
"Herefordshire, County of",State-funded special school,"Speech, Language and Communications needs",15,9,6
"Herefordshire, County of",State-funded special school,Visual Impairment,1,1,0
Telford and Wrekin,State-funded AP school,Autistic Spectrum Disorder,5,5,0
Telford and Wrekin,State-funded AP school,Moderate Learning Difficulty,3,2,1
Telford and Wrekin,State-funded AP school,Other Difficulty/Disability,1,1,0
Telford and Wrekin,State-funded AP school,"Social, Emotional and Mental Health",36,27,9
Telford and Wrekin,State-funded AP school,"Speech, Language and Communications needs",5,5,0
Telford and Wrekin,State-funded nursery,"Speech, Language and Communications needs",24,17,7
Telford and Wrekin,State-funded primary,Autistic Spectrum Disorder,134,94,40
Telford and Wrekin,State-funded primary,Hearing Impairment,65,38,27
Telford and Wrekin,State-funded primary,Moderate Learning Difficulty,642,356,286
Telford and Wrekin,State-funded primary,Multi- Sensory Impairment,8,7,1
Telford and Wrekin,State-funded primary,Other Difficulty/Disability,58,34,24
Telford and Wrekin,State-funded primary,Physical Disability,76,40,36
Telford and Wrekin,State-funded primary,Profound & Multiple Learning Difficulty,7,5,2
Telford and Wrekin,State-funded primary,SEN support but no specialist assessment of type of need,189,110,79
Telford and Wrekin,State-funded primary,Severe Learning Difficulty,7,4,3
Telford and Wrekin,State-funded primary,"Social, Emotional and Mental Health",569,408,161
Telford and Wrekin,State-funded primary,Specific Learning Difficulty,174,107,67
Telford and Wrekin,State-funded primary,"Speech, Language and Communications needs",1101,759,342
Telford and Wrekin,State-funded primary,Visual Impairment,31,19,12
Telford and Wrekin,State-funded secondary,Autistic Spectrum Disorder,211,145,66
Telford and Wrekin,State-funded secondary,Hearing Impairment,54,23,31
Telford and Wrekin,State-funded secondary,Moderate Learning Difficulty,618,368,250
Telford and Wrekin,State-funded secondary,Multi- Sensory Impairment,10,8,2
Telford and Wrekin,State-funded secondary,Other Difficulty/Disability,48,27,21
Telford and Wrekin,State-funded secondary,Physical Disability,74,38,36
Telford and Wrekin,State-funded secondary,Profound & Multiple Learning Difficulty,2,2,0
Telford and Wrekin,State-funded secondary,SEN support but no specialist assessment of type of need,60,26,34
Telford and Wrekin,State-funded secondary,Severe Learning Difficulty,3,3,0
Telford and Wrekin,State-funded secondary,"Social, Emotional and Mental Health",456,318,138
Telford and Wrekin,State-funded secondary,Specific Learning Difficulty,332,176,156
Telford and Wrekin,State-funded secondary,"Speech, Language and Communications needs",234,163,71
Telford and Wrekin,State-funded secondary,Visual Impairment,48,28,20
Telford and Wrekin,State-funded special school,Autistic Spectrum Disorder,147,116,31
Telford and Wrekin,State-funded special school,Moderate Learning Difficulty,246,174,72
Telford and Wrekin,State-funded special school,Multi- Sensory Impairment,1,0,1
Telford and Wrekin,State-funded special school,Other Difficulty/Disability,2,1,1
Telford and Wrekin,State-funded special school,Physical Disability,3,3,0
Telford and Wrekin,State-funded special school,Profound & Multiple Learning Difficulty,85,66,19
Telford and Wrekin,State-funded special school,Severe Learning Difficulty,116,88,28
Telford and Wrekin,State-funded special school,"Social, Emotional and Mental Health",66,53,13
Telford and Wrekin,State-funded special school,Specific Learning Difficulty,2,2,0
Telford and Wrekin,State-funded special school,"Speech, Language and Communications needs",31,24,7
Stoke-on-Trent,State-funded AP school,Specific Learning Difficulty,1,0,1
Stoke-on-Trent,State-funded AP school,"Speech, Language and Communications needs",1,1,0
Stoke-on-Trent,State-funded nursery,Autistic Spectrum Disorder,2,1,1
Stoke-on-Trent,State-funded nursery,SEN support but no specialist assessment of type of need,2,0,2
Stoke-on-Trent,State-funded nursery,"Speech, Language and Communications needs",5,2,3
Stoke-on-Trent,State-funded primary,Autistic Spectrum Disorder,132,103,29
Stoke-on-Trent,State-funded primary,Hearing Impairment,74,46,28
Stoke-on-Trent,State-funded primary,Moderate Learning Difficulty,1191,679,512
Stoke-on-Trent,State-funded primary,Multi- Sensory Impairment,2,2,0
Stoke-on-Trent,State-funded primary,Other Difficulty/Disability,37,17,20
Stoke-on-Trent,State-funded primary,Physical Disability,111,61,50
Stoke-on-Trent,State-funded primary,Profound & Multiple Learning Difficulty,3,2,1
Stoke-on-Trent,State-funded primary,SEN support but no specialist assessment of type of need,63,48,15
Stoke-on-Trent,State-funded primary,Severe Learning Difficulty,10,8,2
Stoke-on-Trent,State-funded primary,"Social, Emotional and Mental Health",617,464,153
Stoke-on-Trent,State-funded primary,Specific Learning Difficulty,299,168,131
Stoke-on-Trent,State-funded primary,"Speech, Language and Communications needs",1726,1166,560
Stoke-on-Trent,State-funded primary,Visual Impairment,34,18,16
Stoke-on-Trent,State-funded secondary,Autistic Spectrum Disorder,106,83,23
Stoke-on-Trent,State-funded secondary,Hearing Impairment,46,28,18
Stoke-on-Trent,State-funded secondary,Moderate Learning Difficulty,886,481,405
Stoke-on-Trent,State-funded secondary,Multi- Sensory Impairment,1,0,1
Stoke-on-Trent,State-funded secondary,Other Difficulty/Disability,8,3,5
Stoke-on-Trent,State-funded secondary,Physical Disability,59,35,24
Stoke-on-Trent,State-funded secondary,Profound & Multiple Learning Difficulty,1,1,0
Stoke-on-Trent,State-funded secondary,SEN support but no specialist assessment of type of need,12,7,5
Stoke-on-Trent,State-funded secondary,Severe Learning Difficulty,2,2,0
Stoke-on-Trent,State-funded secondary,"Social, Emotional and Mental Health",633,411,222
Stoke-on-Trent,State-funded secondary,Specific Learning Difficulty,373,220,153
Stoke-on-Trent,State-funded secondary,"Speech, Language and Communications needs",441,277,164
Stoke-on-Trent,State-funded secondary,Visual Impairment,20,9,11
Stoke-on-Trent,State-funded special school,Autistic Spectrum Disorder,42,32,10
Stoke-on-Trent,State-funded special school,Hearing Impairment,5,3,2
Stoke-on-Trent,State-funded special school,Moderate Learning Difficulty,182,121,61
Stoke-on-Trent,State-funded special school,Multi- Sensory Impairment,11,7,4
Stoke-on-Trent,State-funded special school,Other Difficulty/Disability,22,18,4
Stoke-on-Trent,State-funded special school,Physical Disability,11,4,7
Stoke-on-Trent,State-funded special school,Profound & Multiple Learning Difficulty,41,27,14
Stoke-on-Trent,State-funded special school,Severe Learning Difficulty,191,122,69
Stoke-on-Trent,State-funded special school,"Social, Emotional and Mental Health",107,95,12
Stoke-on-Trent,State-funded special school,Specific Learning Difficulty,21,13,8
Stoke-on-Trent,State-funded special school,"Speech, Language and Communications needs",267,203,64
Stoke-on-Trent,State-funded special school,Visual Impairment,3,1,2
Shropshire,State-funded AP school,Autistic Spectrum Disorder,2,2,0
Shropshire,State-funded AP school,Moderate Learning Difficulty,4,4,0
Shropshire,State-funded AP school,Other Difficulty/Disability,1,1,0
Shropshire,State-funded AP school,"Social, Emotional and Mental Health",21,16,5
Shropshire,State-funded AP school,Specific Learning Difficulty,5,5,0
Shropshire,State-funded AP school,"Speech, Language and Communications needs",3,3,0
Shropshire,State-funded primary,Autistic Spectrum Disorder,164,117,47
Shropshire,State-funded primary,Hearing Impairment,68,38,30
Shropshire,State-funded primary,Moderate Learning Difficulty,654,401,253
Shropshire,State-funded primary,Multi- Sensory Impairment,11,8,3
Shropshire,State-funded primary,Other Difficulty/Disability,117,72,45
Shropshire,State-funded primary,Physical Disability,83,50,33
Shropshire,State-funded primary,Profound & Multiple Learning Difficulty,13,10,3
Shropshire,State-funded primary,SEN support but no specialist assessment of type of need,154,94,60
Shropshire,State-funded primary,Severe Learning Difficulty,29,17,12
Shropshire,State-funded primary,"Social, Emotional and Mental Health",610,466,144
Shropshire,State-funded primary,Specific Learning Difficulty,543,318,225
Shropshire,State-funded primary,"Speech, Language and Communications needs",945,682,263
Shropshire,State-funded primary,Visual Impairment,28,18,10
Shropshire,State-funded secondary,Autistic Spectrum Disorder,179,137,42
Shropshire,State-funded secondary,Hearing Impairment,42,22,20
Shropshire,State-funded secondary,Moderate Learning Difficulty,519,311,208
Shropshire,State-funded secondary,Multi- Sensory Impairment,8,5,3
Shropshire,State-funded secondary,Other Difficulty/Disability,72,49,23
Shropshire,State-funded secondary,Physical Disability,46,27,19
Shropshire,State-funded secondary,Profound & Multiple Learning Difficulty,1,0,1
Shropshire,State-funded secondary,SEN support but no specialist assessment of type of need,233,147,86
Shropshire,State-funded secondary,Severe Learning Difficulty,10,3,7
Shropshire,State-funded secondary,"Social, Emotional and Mental Health",467,313,152
Shropshire,State-funded secondary,Specific Learning Difficulty,553,313,239
Shropshire,State-funded secondary,"Speech, Language and Communications needs",251,176,75
Shropshire,State-funded secondary,Visual Impairment,30,17,13
Shropshire,State-funded special school,Autistic Spectrum Disorder,44,36,8
Shropshire,State-funded special school,Moderate Learning Difficulty,51,38,13
Shropshire,State-funded special school,Other Difficulty/Disability,40,31,9
Shropshire,State-funded special school,Profound & Multiple Learning Difficulty,27,15,12
Shropshire,State-funded special school,Severe Learning Difficulty,256,192,64
Shropshire,State-funded special school,"Social, Emotional and Mental Health",65,52,13
Shropshire,State-funded special school,Specific Learning Difficulty,3,2,1
Shropshire,State-funded special school,"Speech, Language and Communications needs",15,11,4
Birmingham,State-funded AP school,Autistic Spectrum Disorder,15,12,3
Birmingham,State-funded AP school,"Social, Emotional and Mental Health",340,261,79
Birmingham,State-funded AP school,Specific Learning Difficulty,1,1,0
Birmingham,State-funded AP school,"Speech, Language and Communications needs",1,1,0
Birmingham,State-funded nursery,Autistic Spectrum Disorder,29,19,10
Birmingham,State-funded nursery,Hearing Impairment,17,11,6
Birmingham,State-funded nursery,Moderate Learning Difficulty,14,9,5
Birmingham,State-funded nursery,Other Difficulty/Disability,20,15,5
Birmingham,State-funded nursery,Physical Disability,24,13,11
Birmingham,State-funded nursery,Profound & Multiple Learning Difficulty,8,6,2
Birmingham,State-funded nursery,SEN support but no specialist assessment of type of need,12,10,2
Birmingham,State-funded nursery,Severe Learning Difficulty,2,1,1
Birmingham,State-funded nursery,"Social, Emotional and Mental Health",29,22,7
Birmingham,State-funded nursery,Specific Learning Difficulty,2,1,1
Birmingham,State-funded nursery,"Speech, Language and Communications needs",427,292,135
Birmingham,State-funded nursery,Visual Impairment,6,5,1
Birmingham,State-funded primary,Autistic Spectrum Disorder,2329,1761,568
Birmingham,State-funded primary,Hearing Impairment,261,114,147
Birmingham,State-funded primary,Moderate Learning Difficulty,5534,3257,2277
Birmingham,State-funded primary,Multi- Sensory Impairment,23,18,5
Birmingham,State-funded primary,Other Difficulty/Disability,286,195,91
Birmingham,State-funded primary,Physical Disability,475,240,235
Birmingham,State-funded primary,Profound & Multiple Learning Difficulty,22,12,10
Birmingham,State-funded primary,SEN support but no specialist assessment of type of need,547,331,216
Birmingham,State-funded primary,Severe Learning Difficulty,72,46,26
Birmingham,State-funded primary,"Social, Emotional and Mental Health",2440,1749,691
Birmingham,State-funded primary,Specific Learning Difficulty,623,365,258
Birmingham,State-funded primary,"Speech, Language and Communications needs",6309,4385,1924
Birmingham,State-funded primary,Visual Impairment,162,96,66
Birmingham,State-funded secondary,Autistic Spectrum Disorder,1850,1343,507
Birmingham,State-funded secondary,Hearing Impairment,338,160,178
Birmingham,State-funded secondary,Moderate Learning Difficulty,3731,2074,1657
Birmingham,State-funded secondary,Multi- Sensory Impairment,11,7,4
Birmingham,State-funded secondary,Other Difficulty/Disability,368,233,135
Birmingham,State-funded secondary,Physical Disability,398,220,178
Birmingham,State-funded secondary,Profound & Multiple Learning Difficulty,11,6,5
Birmingham,State-funded secondary,SEN support but no specialist assessment of type of need,221,137,84
Birmingham,State-funded secondary,Severe Learning Difficulty,37,11,26
Birmingham,State-funded secondary,"Social, Emotional and Mental Health",2510,1535,975
Birmingham,State-funded secondary,Specific Learning Difficulty,1057,570,487
Birmingham,State-funded secondary,"Speech, Language and Communications needs",1784,1119,665
Birmingham,State-funded secondary,Visual Impairment,199,112,87
Birmingham,State-funded special school,Autistic Spectrum Disorder,2135,1675,460
Birmingham,State-funded special school,Hearing Impairment,158,96,62
Birmingham,State-funded special school,Moderate Learning Difficulty,377,231,146
Birmingham,State-funded special school,Multi- Sensory Impairment,7,5,2
Birmingham,State-funded special school,Other Difficulty/Disability,71,43,28
Birmingham,State-funded special school,Physical Disability,233,139,94
Birmingham,State-funded special school,Profound & Multiple Learning Difficulty,285,149,136
Birmingham,State-funded special school,SEN support but no specialist assessment of type of need,2,0,2
Birmingham,State-funded special school,Severe Learning Difficulty,539,337,202
Birmingham,State-funded special school,"Social, Emotional and Mental Health",445,375,69
Birmingham,State-funded special school,Specific Learning Difficulty,54,27,27
Birmingham,State-funded special school,"Speech, Language and Communications needs",330,228,102
Birmingham,State-funded special school,Visual Impairment,94,57,37
Coventry,State-funded AP school,Autistic Spectrum Disorder,1,1,0
Coventry,State-funded AP school,Moderate Learning Difficulty,2,1,1
Coventry,State-funded AP school,Other Difficulty/Disability,1,1,0
Coventry,State-funded AP school,SEN support but no specialist assessment of type of need,2,1,1
Coventry,State-funded AP school,"Social, Emotional and Mental Health",24,16,8
Coventry,State-funded AP school,Specific Learning Difficulty,1,1,0
Coventry,State-funded AP school,"Speech, Language and Communications needs",2,2,0
Coventry,State-funded nursery,Moderate Learning Difficulty,2,1,1
Coventry,State-funded nursery,Physical Disability,1,0,1
Coventry,State-funded nursery,"Social, Emotional and Mental Health",2,2,0
Coventry,State-funded nursery,"Speech, Language and Communications needs",39,22,17
Coventry,State-funded primary,Autistic Spectrum Disorder,476,351,125
Coventry,State-funded primary,Hearing Impairment,68,42,26
Coventry,State-funded primary,Moderate Learning Difficulty,1342,781,561
Coventry,State-funded primary,Multi- Sensory Impairment,20,12,8
Coventry,State-funded primary,Other Difficulty/Disability,113,55,58
Coventry,State-funded primary,Physical Disability,84,52,32
Coventry,State-funded primary,Profound & Multiple Learning Difficulty,7,5,2
Coventry,State-funded primary,SEN support but no specialist assessment of type of need,211,132,79
Coventry,State-funded primary,Severe Learning Difficulty,36,30,6
Coventry,State-funded primary,"Social, Emotional and Mental Health",915,638,277
Coventry,State-funded primary,Specific Learning Difficulty,212,122,90
Coventry,State-funded primary,"Speech, Language and Communications needs",2372,1637,735
Coventry,State-funded primary,Visual Impairment,50,28,22
Coventry,State-funded secondary,Autistic Spectrum Disorder,866,610,256
Coventry,State-funded secondary,Hearing Impairment,85,47,38
Coventry,State-funded secondary,Moderate Learning Difficulty,921,517,404
Coventry,State-funded secondary,Multi- Sensory Impairment,4,2,2
Coventry,State-funded secondary,Other Difficulty/Disability,87,42,45
Coventry,State-funded secondary,Physical Disability,75,40,35
Coventry,State-funded secondary,SEN support but no specialist assessment of type of need,273,163,110
Coventry,State-funded secondary,Severe Learning Difficulty,31,22,9
Coventry,State-funded secondary,"Social, Emotional and Mental Health",679,434,245
Coventry,State-funded secondary,Specific Learning Difficulty,624,328,296
Coventry,State-funded secondary,"Speech, Language and Communications needs",607,377,230
Coventry,State-funded secondary,Visual Impairment,50,24,26
Coventry,State-funded special school,Autistic Spectrum Disorder,422,340,82
Coventry,State-funded special school,Hearing Impairment,2,2,0
Coventry,State-funded special school,Moderate Learning Difficulty,168,114,54
Coventry,State-funded special school,Multi- Sensory Impairment,1,1,0
Coventry,State-funded special school,Other Difficulty/Disability,13,6,7
Coventry,State-funded special school,Physical Disability,8,5,3
Coventry,State-funded special school,Profound & Multiple Learning Difficulty,69,32,37
Coventry,State-funded special school,Severe Learning Difficulty,224,148,76
Coventry,State-funded special school,"Social, Emotional and Mental Health",152,140,12
Coventry,State-funded special school,Specific Learning Difficulty,19,12,7
Coventry,State-funded special school,"Speech, Language and Communications needs",138,102,36
Coventry,State-funded special school,Visual Impairment,2,1,1
Dudley,State-funded AP school,Moderate Learning Difficulty,1,1,0
Dudley,State-funded AP school,"Social, Emotional and Mental Health",13,7,6
Dudley,State-funded nursery,Autistic Spectrum Disorder,1,1,0
Dudley,State-funded nursery,Moderate Learning Difficulty,5,4,1
Dudley,State-funded nursery,Physical Disability,2,2,0
Dudley,State-funded nursery,Severe Learning Difficulty,4,4,0
Dudley,State-funded nursery,"Social, Emotional and Mental Health",16,9,7
Dudley,State-funded nursery,"Speech, Language and Communications needs",44,33,11
Dudley,State-funded primary,Autistic Spectrum Disorder,161,118,43
Dudley,State-funded primary,Hearing Impairment,75,39,36
Dudley,State-funded primary,Moderate Learning Difficulty,967,559,408
Dudley,State-funded primary,Multi- Sensory Impairment,10,7,3
Dudley,State-funded primary,Other Difficulty/Disability,130,83,47
Dudley,State-funded primary,Physical Disability,133,72,61
Dudley,State-funded primary,Profound & Multiple Learning Difficulty,3,3,0
Dudley,State-funded primary,SEN support but no specialist assessment of type of need,206,121,85
Dudley,State-funded primary,Severe Learning Difficulty,12,6,6
Dudley,State-funded primary,"Social, Emotional and Mental Health",855,620,235
Dudley,State-funded primary,Specific Learning Difficulty,254,131,123
Dudley,State-funded primary,"Speech, Language and Communications needs",1956,1365,591
Dudley,State-funded primary,Visual Impairment,50,23,27
Dudley,State-funded secondary,Autistic Spectrum Disorder,216,174,42
Dudley,State-funded secondary,Hearing Impairment,85,46,39
Dudley,State-funded secondary,Moderate Learning Difficulty,943,549,394
Dudley,State-funded secondary,Multi- Sensory Impairment,6,4,2
Dudley,State-funded secondary,Other Difficulty/Disability,75,40,35
Dudley,State-funded secondary,Physical Disability,125,67,58
Dudley,State-funded secondary,SEN support but no specialist assessment of type of need,60,35,25
Dudley,State-funded secondary,"Social, Emotional and Mental Health",618,430,188
Dudley,State-funded secondary,Specific Learning Difficulty,490,268,222
Dudley,State-funded secondary,"Speech, Language and Communications needs",282,175,107
Dudley,State-funded secondary,Visual Impairment,52,31,21
Dudley,State-funded special school,Autistic Spectrum Disorder,221,172,49
Dudley,State-funded special school,Hearing Impairment,3,1,2
Dudley,State-funded special school,Moderate Learning Difficulty,173,123,50
Dudley,State-funded special school,Multi- Sensory Impairment,5,2,3
Dudley,State-funded special school,Other Difficulty/Disability,8,6,2
Dudley,State-funded special school,Physical Disability,28,16,12
Dudley,State-funded special school,Profound & Multiple Learning Difficulty,24,15,9
Dudley,State-funded special school,Severe Learning Difficulty,96,62,34
Dudley,State-funded special school,"Social, Emotional and Mental Health",71,58,13
Dudley,State-funded special school,Specific Learning Difficulty,14,9,5
Dudley,State-funded special school,"Speech, Language and Communications needs",294,221,73
Dudley,State-funded special school,Visual Impairment,3,1,2
Sandwell,State-funded AP school,Moderate Learning Difficulty,4,4,0
Sandwell,State-funded AP school,Severe Learning Difficulty,2,2,0
Sandwell,State-funded AP school,"Social, Emotional and Mental Health",67,51,16
Sandwell,State-funded AP school,Specific Learning Difficulty,1,1,0
Sandwell,State-funded AP school,"Speech, Language and Communications needs",1,1,0
Sandwell,State-funded primary,Autistic Spectrum Disorder,334,252,82
Sandwell,State-funded primary,Hearing Impairment,108,60,48
Sandwell,State-funded primary,Moderate Learning Difficulty,1324,804,520
Sandwell,State-funded primary,Multi- Sensory Impairment,10,5,5
Sandwell,State-funded primary,Other Difficulty/Disability,139,85,54
Sandwell,State-funded primary,Physical Disability,148,85,63
Sandwell,State-funded primary,Profound & Multiple Learning Difficulty,8,5,3
Sandwell,State-funded primary,SEN support but no specialist assessment of type of need,336,191,145
Sandwell,State-funded primary,Severe Learning Difficulty,18,9,9
Sandwell,State-funded primary,"Social, Emotional and Mental Health",1032,744,288
Sandwell,State-funded primary,Specific Learning Difficulty,111,61,50
Sandwell,State-funded primary,"Speech, Language and Communications needs",2184,1581,603
Sandwell,State-funded primary,Visual Impairment,76,47,29
Sandwell,State-funded secondary,Autistic Spectrum Disorder,257,199,58
Sandwell,State-funded secondary,Hearing Impairment,82,42,40
Sandwell,State-funded secondary,Moderate Learning Difficulty,1022,619,403
Sandwell,State-funded secondary,Other Difficulty/Disability,80,49,31
Sandwell,State-funded secondary,Physical Disability,117,78,39
Sandwell,State-funded secondary,Profound & Multiple Learning Difficulty,1,0,1
Sandwell,State-funded secondary,SEN support but no specialist assessment of type of need,235,130,105
Sandwell,State-funded secondary,Severe Learning Difficulty,4,1,3
Sandwell,State-funded secondary,"Social, Emotional and Mental Health",1029,704,325
Sandwell,State-funded secondary,Specific Learning Difficulty,304,172,132
Sandwell,State-funded secondary,"Speech, Language and Communications needs",471,330,141
Sandwell,State-funded secondary,Visual Impairment,51,22,29
Sandwell,State-funded special school,Autistic Spectrum Disorder,194,147,47
Sandwell,State-funded special school,Hearing Impairment,2,1,1
Sandwell,State-funded special school,Moderate Learning Difficulty,69,41,28
Sandwell,State-funded special school,Multi- Sensory Impairment,1,1,0
Sandwell,State-funded special school,Other Difficulty/Disability,7,2,5
Sandwell,State-funded special school,Physical Disability,18,15,3
Sandwell,State-funded special school,Profound & Multiple Learning Difficulty,104,75,29
Sandwell,State-funded special school,Severe Learning Difficulty,184,122,62
Sandwell,State-funded special school,"Social, Emotional and Mental Health",112,95,17
Sandwell,State-funded special school,Specific Learning Difficulty,5,4,1
Sandwell,State-funded special school,"Speech, Language and Communications needs",90,68,22
Sandwell,State-funded special school,Visual Impairment,1,1,0
Solihull,State-funded AP school,Autistic Spectrum Disorder,12,9,3
Solihull,State-funded AP school,Hearing Impairment,1,0,1
Solihull,State-funded AP school,Moderate Learning Difficulty,4,3,1
Solihull,State-funded AP school,Other Difficulty/Disability,3,3,0
Solihull,State-funded AP school,SEN support but no specialist assessment of type of need,2,2,0
Solihull,State-funded AP school,"Social, Emotional and Mental Health",35,26,9
Solihull,State-funded AP school,Specific Learning Difficulty,5,4,1
Solihull,State-funded AP school,"Speech, Language and Communications needs",1,1,0
Solihull,State-funded primary,Autistic Spectrum Disorder,379,294,85
Solihull,State-funded primary,Hearing Impairment,69,27,42
Solihull,State-funded primary,Moderate Learning Difficulty,375,208,167
Solihull,State-funded primary,Multi- Sensory Impairment,11,7,4
Solihull,State-funded primary,Other Difficulty/Disability,59,38,21
Solihull,State-funded primary,Physical Disability,104,64,40
Solihull,State-funded primary,Profound & Multiple Learning Difficulty,1,0,1
Solihull,State-funded primary,SEN support but no specialist assessment of type of need,123,88,35
Solihull,State-funded primary,Severe Learning Difficulty,5,3,2
Solihull,State-funded primary,"Social, Emotional and Mental Health",727,493,234
Solihull,State-funded primary,Specific Learning Difficulty,363,200,163
Solihull,State-funded primary,"Speech, Language and Communications needs",968,671,297
Solihull,State-funded primary,Visual Impairment,38,26,12
Solihull,State-funded secondary,Autistic Spectrum Disorder,750,534,216
Solihull,State-funded secondary,Hearing Impairment,69,33,36
Solihull,State-funded secondary,Moderate Learning Difficulty,489,255,234
Solihull,State-funded secondary,Multi- Sensory Impairment,8,5,3
Solihull,State-funded secondary,Other Difficulty/Disability,111,65,46
Solihull,State-funded secondary,Physical Disability,72,45,27
Solihull,State-funded secondary,SEN support but no specialist assessment of type of need,57,29,28
Solihull,State-funded secondary,Severe Learning Difficulty,3,2,1
Solihull,State-funded secondary,"Social, Emotional and Mental Health",648,429,219
Solihull,State-funded secondary,Specific Learning Difficulty,620,353,267
Solihull,State-funded secondary,"Speech, Language and Communications needs",251,160,91
Solihull,State-funded secondary,Visual Impairment,38,18,20
Solihull,State-funded special school,Autistic Spectrum Disorder,277,219,58
Solihull,State-funded special school,Hearing Impairment,6,2,4
Solihull,State-funded special school,Moderate Learning Difficulty,107,64,43
Solihull,State-funded special school,Multi- Sensory Impairment,2,0,2
Solihull,State-funded special school,Other Difficulty/Disability,89,52,37
Solihull,State-funded special school,Physical Disability,17,9,8
Solihull,State-funded special school,Profound & Multiple Learning Difficulty,28,19,9
Solihull,State-funded special school,SEN support but no specialist assessment of type of need,2,1,1
Solihull,State-funded special school,Severe Learning Difficulty,80,60,20
Solihull,State-funded special school,"Social, Emotional and Mental Health",58,45,13
Solihull,State-funded special school,Specific Learning Difficulty,16,13,3
Solihull,State-funded special school,"Speech, Language and Communications needs",75,56,19
Walsall,State-funded AP school,Autistic Spectrum Disorder,26,18,8
Walsall,State-funded AP school,Hearing Impairment,1,1,0
Walsall,State-funded AP school,Moderate Learning Difficulty,8,7,1
Walsall,State-funded AP school,Physical Disability,2,1,1
Walsall,State-funded AP school,SEN support but no specialist assessment of type of need,1,0,1
Walsall,State-funded AP school,"Social, Emotional and Mental Health",46,31,15
Walsall,State-funded AP school,Specific Learning Difficulty,2,2,0
Walsall,State-funded AP school,"Speech, Language and Communications needs",11,7,4
Walsall,State-funded nursery,Autistic Spectrum Disorder,1,1,0
Walsall,State-funded nursery,Hearing Impairment,4,4,0
Walsall,State-funded nursery,Moderate Learning Difficulty,6,6,0
Walsall,State-funded nursery,Other Difficulty/Disability,8,6,2
Walsall,State-funded nursery,Physical Disability,8,7,1
Walsall,State-funded nursery,Profound & Multiple Learning Difficulty,4,2,2
Walsall,State-funded nursery,Severe Learning Difficulty,5,5,0
Walsall,State-funded nursery,"Social, Emotional and Mental Health",1,1,0
Walsall,State-funded nursery,"Speech, Language and Communications needs",92,62,30
Walsall,State-funded nursery,Visual Impairment,2,2,0
Walsall,State-funded primary,Autistic Spectrum Disorder,224,175,49
Walsall,State-funded primary,Hearing Impairment,59,31,28
Walsall,State-funded primary,Moderate Learning Difficulty,1318,803,515
Walsall,State-funded primary,Multi- Sensory Impairment,9,7,2
Walsall,State-funded primary,Other Difficulty/Disability,182,105,77
Walsall,State-funded primary,Physical Disability,73,48,25
Walsall,State-funded primary,Profound & Multiple Learning Difficulty,6,4,2
Walsall,State-funded primary,SEN support but no specialist assessment of type of need,215,136,79
Walsall,State-funded primary,Severe Learning Difficulty,59,44,15
Walsall,State-funded primary,"Social, Emotional and Mental Health",748,553,195
Walsall,State-funded primary,Specific Learning Difficulty,192,108,84
Walsall,State-funded primary,"Speech, Language and Communications needs",1809,1287,522
Walsall,State-funded primary,Visual Impairment,52,24,28
Walsall,State-funded secondary,Autistic Spectrum Disorder,388,262,126
Walsall,State-funded secondary,Hearing Impairment,63,33,30
Walsall,State-funded secondary,Moderate Learning Difficulty,938,529,409
Walsall,State-funded secondary,Multi- Sensory Impairment,1,1,0
Walsall,State-funded secondary,Other Difficulty/Disability,70,48,22
Walsall,State-funded secondary,Physical Disability,78,47,31
Walsall,State-funded secondary,Profound & Multiple Learning Difficulty,1,1,0
Walsall,State-funded secondary,SEN support but no specialist assessment of type of need,57,29,28
Walsall,State-funded secondary,Severe Learning Difficulty,8,6,2
Walsall,State-funded secondary,"Social, Emotional and Mental Health",709,425,284
Walsall,State-funded secondary,Specific Learning Difficulty,427,240,187
Walsall,State-funded secondary,"Speech, Language and Communications needs",420,295,125
Walsall,State-funded secondary,Visual Impairment,49,28,21
Walsall,State-funded special school,Autistic Spectrum Disorder,219,184,35
Walsall,State-funded special school,Hearing Impairment,1,0,1
Walsall,State-funded special school,Moderate Learning Difficulty,142,97,45
Walsall,State-funded special school,Multi- Sensory Impairment,1,0,1
Walsall,State-funded special school,Other Difficulty/Disability,6,4,2
Walsall,State-funded special school,Physical Disability,4,2,2
Walsall,State-funded special school,Profound & Multiple Learning Difficulty,73,39,34
Walsall,State-funded special school,Severe Learning Difficulty,236,185,51
Walsall,State-funded special school,"Social, Emotional and Mental Health",126,104,22
Walsall,State-funded special school,Specific Learning Difficulty,3,3,0
Walsall,State-funded special school,"Speech, Language and Communications needs",73,46,27
Wolverhampton,State-funded AP school,Autistic Spectrum Disorder,9,7,2
Wolverhampton,State-funded AP school,Moderate Learning Difficulty,3,2,1
Wolverhampton,State-funded AP school,Other Difficulty/Disability,8,5,3
Wolverhampton,State-funded AP school,Physical Disability,2,0,2
Wolverhampton,State-funded AP school,"Social, Emotional and Mental Health",99,67,32
Wolverhampton,State-funded AP school,Specific Learning Difficulty,1,1,0
Wolverhampton,State-funded AP school,"Speech, Language and Communications needs",6,5,1
Wolverhampton,State-funded nursery,Autistic Spectrum Disorder,18,10,8
Wolverhampton,State-funded nursery,Hearing Impairment,3,3,0
Wolverhampton,State-funded nursery,Moderate Learning Difficulty,4,3,1
Wolverhampton,State-funded nursery,Other Difficulty/Disability,5,2,3
Wolverhampton,State-funded nursery,Physical Disability,3,0,3
Wolverhampton,State-funded nursery,Profound & Multiple Learning Difficulty,1,1,0
Wolverhampton,State-funded nursery,SEN support but no specialist assessment of type of need,2,2,0
Wolverhampton,State-funded nursery,Severe Learning Difficulty,8,6,2
Wolverhampton,State-funded nursery,"Social, Emotional and Mental Health",8,6,2
Wolverhampton,State-funded nursery,Specific Learning Difficulty,2,2,0
Wolverhampton,State-funded nursery,"Speech, Language and Communications needs",85,60,25
Wolverhampton,State-funded primary,Autistic Spectrum Disorder,168,126,42
Wolverhampton,State-funded primary,Hearing Impairment,60,24,36
Wolverhampton,State-funded primary,Moderate Learning Difficulty,958,574,384
Wolverhampton,State-funded primary,Multi- Sensory Impairment,33,24,9
Wolverhampton,State-funded primary,Other Difficulty/Disability,50,38,12
Wolverhampton,State-funded primary,Physical Disability,75,42,33
Wolverhampton,State-funded primary,Profound & Multiple Learning Difficulty,2,1,1
Wolverhampton,State-funded primary,SEN support but no specialist assessment of type of need,121,69,52
Wolverhampton,State-funded primary,Severe Learning Difficulty,48,39,9
Wolverhampton,State-funded primary,"Social, Emotional and Mental Health",580,419,161
Wolverhampton,State-funded primary,Specific Learning Difficulty,420,245,175
Wolverhampton,State-funded primary,"Speech, Language and Communications needs",1451,1040,411
Wolverhampton,State-funded primary,Visual Impairment,34,17,17
Wolverhampton,State-funded secondary,Autistic Spectrum Disorder,167,134,33
Wolverhampton,State-funded secondary,Hearing Impairment,85,41,44
Wolverhampton,State-funded secondary,Moderate Learning Difficulty,1026,600,426
Wolverhampton,State-funded secondary,Multi- Sensory Impairment,15,10,5
Wolverhampton,State-funded secondary,Other Difficulty/Disability,170,106,64
Wolverhampton,State-funded secondary,Physical Disability,87,36,51
Wolverhampton,State-funded secondary,Profound & Multiple Learning Difficulty,20,15,5
Wolverhampton,State-funded secondary,SEN support but no specialist assessment of type of need,208,132,76
Wolverhampton,State-funded secondary,Severe Learning Difficulty,8,5,3
Wolverhampton,State-funded secondary,"Social, Emotional and Mental Health",786,460,326
Wolverhampton,State-funded secondary,Specific Learning Difficulty,741,414,327
Wolverhampton,State-funded secondary,"Speech, Language and Communications needs",246,173,73
Wolverhampton,State-funded secondary,Visual Impairment,45,26,19
Wolverhampton,State-funded special school,Autistic Spectrum Disorder,295,234,61
Wolverhampton,State-funded special school,Hearing Impairment,2,2,0
Wolverhampton,State-funded special school,Moderate Learning Difficulty,80,49,31
Wolverhampton,State-funded special school,Multi- Sensory Impairment,1,1,0
Wolverhampton,State-funded special school,Other Difficulty/Disability,97,72,25
Wolverhampton,State-funded special school,Physical Disability,65,37,28
Wolverhampton,State-funded special school,Profound & Multiple Learning Difficulty,59,31,28
Wolverhampton,State-funded special school,Severe Learning Difficulty,187,117,70
Wolverhampton,State-funded special school,"Social, Emotional and Mental Health",114,95,19
Wolverhampton,State-funded special school,Specific Learning Difficulty,13,10,3
Wolverhampton,State-funded special school,"Speech, Language and Communications needs",97,83,14
Staffordshire,State-funded AP school,Autistic Spectrum Disorder,4,4,0
Staffordshire,State-funded AP school,Moderate Learning Difficulty,18,16,2
Staffordshire,State-funded AP school,Other Difficulty/Disability,4,3,1
Staffordshire,State-funded AP school,Physical Disability,1,1,0
Staffordshire,State-funded AP school,SEN support but no specialist assessment of type of need,28,22,6
Staffordshire,State-funded AP school,"Social, Emotional and Mental Health",95,67,28
Staffordshire,State-funded AP school,Specific Learning Difficulty,6,3,3
Staffordshire,State-funded AP school,"Speech, Language and Communications needs",7,7,0
Staffordshire,State-funded nursery,"Speech, Language and Communications needs",1,0,1
Staffordshire,State-funded primary,Autistic Spectrum Disorder,631,482,149
Staffordshire,State-funded primary,Hearing Impairment,129,76,53
Staffordshire,State-funded primary,Moderate Learning Difficulty,2402,1441,961
Staffordshire,State-funded primary,Multi- Sensory Impairment,35,23,12
Staffordshire,State-funded primary,Other Difficulty/Disability,249,152,97
Staffordshire,State-funded primary,Physical Disability,237,146,91
Staffordshire,State-funded primary,Profound & Multiple Learning Difficulty,22,12,10
Staffordshire,State-funded primary,SEN support but no specialist assessment of type of need,397,243,154
Staffordshire,State-funded primary,Severe Learning Difficulty,48,34,14
Staffordshire,State-funded primary,"Social, Emotional and Mental Health",1327,976,351
Staffordshire,State-funded primary,Specific Learning Difficulty,946,552,394
Staffordshire,State-funded primary,"Speech, Language and Communications needs",2385,1680,705
Staffordshire,State-funded primary,Visual Impairment,75,45,30
Staffordshire,State-funded secondary,Autistic Spectrum Disorder,1040,754,286
Staffordshire,State-funded secondary,Hearing Impairment,178,84,94
Staffordshire,State-funded secondary,Moderate Learning Difficulty,2063,1286,777
Staffordshire,State-funded secondary,Multi- Sensory Impairment,51,37,14
Staffordshire,State-funded secondary,Other Difficulty/Disability,471,284,187
Staffordshire,State-funded secondary,Physical Disability,246,144,102
Staffordshire,State-funded secondary,Profound & Multiple Learning Difficulty,5,3,2
Staffordshire,State-funded secondary,SEN support but no specialist assessment of type of need,202,110,92
Staffordshire,State-funded secondary,Severe Learning Difficulty,23,12,11
Staffordshire,State-funded secondary,"Social, Emotional and Mental Health",1500,917,583
Staffordshire,State-funded secondary,Specific Learning Difficulty,1306,769,537
Staffordshire,State-funded secondary,"Speech, Language and Communications needs",531,375,156
Staffordshire,State-funded secondary,Visual Impairment,89,46,43
Staffordshire,State-funded special school,Autistic Spectrum Disorder,879,712,167
Staffordshire,State-funded special school,Hearing Impairment,21,12,9
Staffordshire,State-funded special school,Moderate Learning Difficulty,385,237,148
Staffordshire,State-funded special school,Multi- Sensory Impairment,8,5,3
Staffordshire,State-funded special school,Other Difficulty/Disability,40,23,17
Staffordshire,State-funded special school,Physical Disability,185,101,84
Staffordshire,State-funded special school,Profound & Multiple Learning Difficulty,91,63,28
Staffordshire,State-funded special school,SEN support but no specialist assessment of type of need,1,1,0
Staffordshire,State-funded special school,Severe Learning Difficulty,380,229,151
Staffordshire,State-funded special school,"Social, Emotional and Mental Health",374,327,47
Staffordshire,State-funded special school,Specific Learning Difficulty,109,67,42
Staffordshire,State-funded special school,"Speech, Language and Communications needs",414,301,113
Staffordshire,State-funded special school,Visual Impairment,13,6,7
Warwickshire,State-funded nursery,Autistic Spectrum Disorder,8,4,4
Warwickshire,State-funded nursery,Moderate Learning Difficulty,1,0,1
Warwickshire,State-funded nursery,Other Difficulty/Disability,2,1,1
Warwickshire,State-funded nursery,Physical Disability,4,1,3
Warwickshire,State-funded nursery,Severe Learning Difficulty,2,1,1
Warwickshire,State-funded nursery,"Social, Emotional and Mental Health",19,14,5
Warwickshire,State-funded nursery,Specific Learning Difficulty,4,3,1
Warwickshire,State-funded nursery,"Speech, Language and Communications needs",46,29,17
Warwickshire,State-funded primary,Autistic Spectrum Disorder,767,572,195
Warwickshire,State-funded primary,Hearing Impairment,83,39,44
Warwickshire,State-funded primary,Moderate Learning Difficulty,1607,948,659
Warwickshire,State-funded primary,Multi- Sensory Impairment,24,16,8
Warwickshire,State-funded primary,Other Difficulty/Disability,203,116,87
Warwickshire,State-funded primary,Physical Disability,237,144,93
Warwickshire,State-funded primary,Profound & Multiple Learning Difficulty,14,7,7
Warwickshire,State-funded primary,SEN support but no specialist assessment of type of need,220,143,77
Warwickshire,State-funded primary,Severe Learning Difficulty,53,41,12
Warwickshire,State-funded primary,"Social, Emotional and Mental Health",1551,1118,433
Warwickshire,State-funded primary,Specific Learning Difficulty,399,229,170
Warwickshire,State-funded primary,"Speech, Language and Communications needs",2104,1431,673
Warwickshire,State-funded primary,Visual Impairment,74,45,29
Warwickshire,State-funded secondary,Autistic Spectrum Disorder,910,600,310
Warwickshire,State-funded secondary,Hearing Impairment,78,39,39
Warwickshire,State-funded secondary,Moderate Learning Difficulty,1476,868,608
Warwickshire,State-funded secondary,Multi- Sensory Impairment,89,67,22
Warwickshire,State-funded secondary,Other Difficulty/Disability,314,189,125
Warwickshire,State-funded secondary,Physical Disability,143,71,72
Warwickshire,State-funded secondary,Profound & Multiple Learning Difficulty,4,0,4
Warwickshire,State-funded secondary,SEN support but no specialist assessment of type of need,93,59,34
Warwickshire,State-funded secondary,Severe Learning Difficulty,18,11,7
Warwickshire,State-funded secondary,"Social, Emotional and Mental Health",1406,829,577
Warwickshire,State-funded secondary,Specific Learning Difficulty,937,540,397
Warwickshire,State-funded secondary,"Speech, Language and Communications needs",390,265,125
Warwickshire,State-funded secondary,Visual Impairment,69,36,33
Warwickshire,State-funded special school,Autistic Spectrum Disorder,439,334,105
Warwickshire,State-funded special school,Hearing Impairment,8,4,4
Warwickshire,State-funded special school,Moderate Learning Difficulty,173,126,47
Warwickshire,State-funded special school,Multi- Sensory Impairment,2,1,1
Warwickshire,State-funded special school,Other Difficulty/Disability,30,21,9
Warwickshire,State-funded special school,Physical Disability,46,33,13
Warwickshire,State-funded special school,Profound & Multiple Learning Difficulty,79,39,40
Warwickshire,State-funded special school,Severe Learning Difficulty,511,385,126
Warwickshire,State-funded special school,"Social, Emotional and Mental Health",201,158,43
Warwickshire,State-funded special school,Specific Learning Difficulty,28,22,6
Warwickshire,State-funded special school,"Speech, Language and Communications needs",188,122,66
Warwickshire,State-funded special school,Visual Impairment,18,9,9
Worcestershire,Non-maintained special school,Visual Impairment,70,37,33
Worcestershire,State-funded AP school,Autistic Spectrum Disorder,5,3,2
Worcestershire,State-funded AP school,Moderate Learning Difficulty,13,9,4
Worcestershire,State-funded AP school,Other Difficulty/Disability,5,5,0
Worcestershire,State-funded AP school,"Social, Emotional and Mental Health",86,63,23
Worcestershire,State-funded AP school,Specific Learning Difficulty,7,6,1
Worcestershire,State-funded AP school,"Speech, Language and Communications needs",8,4,4
Worcestershire,State-funded primary,Autistic Spectrum Disorder,508,389,119
Worcestershire,State-funded primary,Hearing Impairment,66,31,35
Worcestershire,State-funded primary,Moderate Learning Difficulty,849,473,376
Worcestershire,State-funded primary,Multi- Sensory Impairment,19,13,6
Worcestershire,State-funded primary,Other Difficulty/Disability,163,101,62
Worcestershire,State-funded primary,Physical Disability,134,75,59
Worcestershire,State-funded primary,Profound & Multiple Learning Difficulty,5,5,0
Worcestershire,State-funded primary,SEN support but no specialist assessment of type of need,267,155,112
Worcestershire,State-funded primary,Severe Learning Difficulty,36,27,9
Worcestershire,State-funded primary,"Social, Emotional and Mental Health",921,644,277
Worcestershire,State-funded primary,Specific Learning Difficulty,589,349,240
Worcestershire,State-funded primary,"Speech, Language and Communications needs",3683,2456,1227
Worcestershire,State-funded primary,Visual Impairment,66,38,28
Worcestershire,State-funded secondary,Autistic Spectrum Disorder,706,512,194
Worcestershire,State-funded secondary,Hearing Impairment,79,36,43
Worcestershire,State-funded secondary,Moderate Learning Difficulty,959,549,410
Worcestershire,State-funded secondary,Multi- Sensory Impairment,10,6,4
Worcestershire,State-funded secondary,Other Difficulty/Disability,181,110,71
Worcestershire,State-funded secondary,Physical Disability,124,76,48
Worcestershire,State-funded secondary,SEN support but no specialist assessment of type of need,108,59,49
Worcestershire,State-funded secondary,Severe Learning Difficulty,14,11,3
Worcestershire,State-funded secondary,"Social, Emotional and Mental Health",1279,868,411
Worcestershire,State-funded secondary,Specific Learning Difficulty,1097,628,469
Worcestershire,State-funded secondary,"Speech, Language and Communications needs",1146,764,382
Worcestershire,State-funded secondary,Visual Impairment,77,41,36
Worcestershire,State-funded special school,Autistic Spectrum Disorder,310,250,60
Worcestershire,State-funded special school,Hearing Impairment,1,1,0
Worcestershire,State-funded special school,Moderate Learning Difficulty,193,129,64
Worcestershire,State-funded special school,Multi- Sensory Impairment,3,0,3
Worcestershire,State-funded special school,Other Difficulty/Disability,253,182,71
Worcestershire,State-funded special school,Physical Disability,121,67,54
Worcestershire,State-funded special school,Profound & Multiple Learning Difficulty,70,46,24
Worcestershire,State-funded special school,SEN support but no specialist assessment of type of need,24,13,11
Worcestershire,State-funded special school,Severe Learning Difficulty,251,170,81
Worcestershire,State-funded special school,"Social, Emotional and Mental Health",179,157,22
Worcestershire,State-funded special school,Specific Learning Difficulty,42,31,11
Worcestershire,State-funded special school,"Speech, Language and Communications needs",243,169,74
Worcestershire,State-funded special school,Visual Impairment,6,3,3
Peterborough,State-funded AP school,Autistic Spectrum Disorder,3,3,0
Peterborough,State-funded AP school,Moderate Learning Difficulty,1,0,1
Peterborough,State-funded AP school,"Social, Emotional and Mental Health",25,23,2
Peterborough,State-funded AP school,Specific Learning Difficulty,1,0,1
Peterborough,State-funded AP school,"Speech, Language and Communications needs",1,1,0
Peterborough,State-funded nursery,Autistic Spectrum Disorder,2,2,0
Peterborough,State-funded nursery,Other Difficulty/Disability,4,2,2
Peterborough,State-funded nursery,Physical Disability,4,2,2
Peterborough,State-funded nursery,"Speech, Language and Communications needs",11,8,3
Peterborough,State-funded primary,Autistic Spectrum Disorder,469,365,104
Peterborough,State-funded primary,Hearing Impairment,80,37,43
Peterborough,State-funded primary,Moderate Learning Difficulty,269,160,109
Peterborough,State-funded primary,Multi- Sensory Impairment,11,7,4
Peterborough,State-funded primary,Other Difficulty/Disability,74,42,32
Peterborough,State-funded primary,Physical Disability,79,36,43
Peterborough,State-funded primary,Profound & Multiple Learning Difficulty,6,4,2
Peterborough,State-funded primary,SEN support but no specialist assessment of type of need,131,80,51
Peterborough,State-funded primary,Severe Learning Difficulty,3,3,0
Peterborough,State-funded primary,"Social, Emotional and Mental Health",543,392,151
Peterborough,State-funded primary,Specific Learning Difficulty,411,228,183
Peterborough,State-funded primary,"Speech, Language and Communications needs",1092,760,332
Peterborough,State-funded primary,Visual Impairment,25,14,11
Peterborough,State-funded secondary,Autistic Spectrum Disorder,346,259,87
Peterborough,State-funded secondary,Hearing Impairment,62,36,26
Peterborough,State-funded secondary,Moderate Learning Difficulty,210,127,83
Peterborough,State-funded secondary,Multi- Sensory Impairment,9,6,3
Peterborough,State-funded secondary,Other Difficulty/Disability,81,50,31
Peterborough,State-funded secondary,Physical Disability,49,25,24
Peterborough,State-funded secondary,Profound & Multiple Learning Difficulty,1,1,0
Peterborough,State-funded secondary,SEN support but no specialist assessment of type of need,51,35,16
Peterborough,State-funded secondary,Severe Learning Difficulty,8,5,3
Peterborough,State-funded secondary,"Social, Emotional and Mental Health",387,262,125
Peterborough,State-funded secondary,Specific Learning Difficulty,491,281,210
Peterborough,State-funded secondary,"Speech, Language and Communications needs",276,184,92
Peterborough,State-funded secondary,Visual Impairment,29,15,14
Peterborough,State-funded special school,Autistic Spectrum Disorder,244,199,45
Peterborough,State-funded special school,Hearing Impairment,1,0,1
Peterborough,State-funded special school,Moderate Learning Difficulty,83,47,36
Peterborough,State-funded special school,Multi- Sensory Impairment,2,0,2
Peterborough,State-funded special school,Other Difficulty/Disability,3,3,0
Peterborough,State-funded special school,Physical Disability,17,4,13
Peterborough,State-funded special school,Profound & Multiple Learning Difficulty,62,31,31
Peterborough,State-funded special school,Severe Learning Difficulty,150,111,39
Peterborough,State-funded special school,"Social, Emotional and Mental Health",71,64,7
Peterborough,State-funded special school,Specific Learning Difficulty,15,9,6
Peterborough,State-funded special school,"Speech, Language and Communications needs",43,30,13
Peterborough,State-funded special school,Visual Impairment,1,1,0
Luton,State-funded AP school,Moderate Learning Difficulty,2,1,1
Luton,State-funded AP school,SEN support but no specialist assessment of type of need,53,36,17
Luton,State-funded AP school,"Social, Emotional and Mental Health",5,4,1
Luton,State-funded nursery,Autistic Spectrum Disorder,28,22,6
Luton,State-funded nursery,Hearing Impairment,4,2,2
Luton,State-funded nursery,Moderate Learning Difficulty,9,6,3
Luton,State-funded nursery,Other Difficulty/Disability,4,3,1
Luton,State-funded nursery,Physical Disability,5,2,3
Luton,State-funded nursery,Profound & Multiple Learning Difficulty,1,1,0
Luton,State-funded nursery,Severe Learning Difficulty,14,7,7
Luton,State-funded nursery,"Social, Emotional and Mental Health",4,3,1
Luton,State-funded nursery,Specific Learning Difficulty,2,1,1
Luton,State-funded nursery,"Speech, Language and Communications needs",112,83,29
Luton,State-funded primary,Autistic Spectrum Disorder,396,308,88
Luton,State-funded primary,Hearing Impairment,55,38,17
Luton,State-funded primary,Moderate Learning Difficulty,793,487,306
Luton,State-funded primary,Multi- Sensory Impairment,3,3,0
Luton,State-funded primary,Other Difficulty/Disability,120,77,43
Luton,State-funded primary,Physical Disability,82,49,33
Luton,State-funded primary,Profound & Multiple Learning Difficulty,3,3,0
Luton,State-funded primary,SEN support but no specialist assessment of type of need,217,131,86
Luton,State-funded primary,Severe Learning Difficulty,34,24,10
Luton,State-funded primary,"Social, Emotional and Mental Health",561,397,164
Luton,State-funded primary,Specific Learning Difficulty,193,121,72
Luton,State-funded primary,"Speech, Language and Communications needs",1486,1054,432
Luton,State-funded primary,Visual Impairment,52,23,29
Luton,State-funded secondary,Autistic Spectrum Disorder,197,152,45
Luton,State-funded secondary,Hearing Impairment,19,11,8
Luton,State-funded secondary,Moderate Learning Difficulty,442,241,201
Luton,State-funded secondary,Multi- Sensory Impairment,3,1,2
Luton,State-funded secondary,Other Difficulty/Disability,136,89,47
Luton,State-funded secondary,Physical Disability,70,45,25
Luton,State-funded secondary,Profound & Multiple Learning Difficulty,5,4,1
Luton,State-funded secondary,SEN support but no specialist assessment of type of need,105,45,60
Luton,State-funded secondary,Severe Learning Difficulty,17,11,6
Luton,State-funded secondary,"Social, Emotional and Mental Health",421,274,147
Luton,State-funded secondary,Specific Learning Difficulty,345,208,137
Luton,State-funded secondary,"Speech, Language and Communications needs",343,223,120
Luton,State-funded secondary,Visual Impairment,31,21,10
Luton,State-funded special school,Autistic Spectrum Disorder,82,58,24
Luton,State-funded special school,Hearing Impairment,1,1,0
Luton,State-funded special school,Moderate Learning Difficulty,5,4,1
Luton,State-funded special school,Other Difficulty/Disability,4,2,2
Luton,State-funded special school,Physical Disability,7,5,2
Luton,State-funded special school,Profound & Multiple Learning Difficulty,115,66,49
Luton,State-funded special school,Severe Learning Difficulty,539,398,141
Luton,State-funded special school,"Social, Emotional and Mental Health",3,1,2
Luton,State-funded special school,Specific Learning Difficulty,13,8,5
Luton,State-funded special school,"Speech, Language and Communications needs",14,11,3
Luton,State-funded special school,Visual Impairment,1,1,0
Southend-on-Sea,State-funded AP school,Autistic Spectrum Disorder,1,1,0
Southend-on-Sea,State-funded AP school,"Social, Emotional and Mental Health",53,38,15
Southend-on-Sea,State-funded AP school,"Speech, Language and Communications needs",2,2,0
Southend-on-Sea,State-funded primary,Autistic Spectrum Disorder,238,186,52
Southend-on-Sea,State-funded primary,Hearing Impairment,16,8,8
Southend-on-Sea,State-funded primary,Moderate Learning Difficulty,180,104,76
Southend-on-Sea,State-funded primary,Multi- Sensory Impairment,6,5,1
Southend-on-Sea,State-funded primary,Other Difficulty/Disability,35,24,11
Southend-on-Sea,State-funded primary,Physical Disability,43,27,16
Southend-on-Sea,State-funded primary,Profound & Multiple Learning Difficulty,1,0,1
Southend-on-Sea,State-funded primary,SEN support but no specialist assessment of type of need,60,44,16
Southend-on-Sea,State-funded primary,Severe Learning Difficulty,6,5,1
Southend-on-Sea,State-funded primary,"Social, Emotional and Mental Health",425,299,126
Southend-on-Sea,State-funded primary,Specific Learning Difficulty,472,279,193
Southend-on-Sea,State-funded primary,"Speech, Language and Communications needs",714,497,217
Southend-on-Sea,State-funded primary,Visual Impairment,13,10,3
Southend-on-Sea,State-funded secondary,Autistic Spectrum Disorder,187,135,52
Southend-on-Sea,State-funded secondary,Hearing Impairment,20,6,14
Southend-on-Sea,State-funded secondary,Moderate Learning Difficulty,110,70,40
Southend-on-Sea,State-funded secondary,Multi- Sensory Impairment,4,0,4
Southend-on-Sea,State-funded secondary,Other Difficulty/Disability,35,21,14
Southend-on-Sea,State-funded secondary,Physical Disability,46,29,17
Southend-on-Sea,State-funded secondary,SEN support but no specialist assessment of type of need,58,26,32
Southend-on-Sea,State-funded secondary,Severe Learning Difficulty,1,0,1
Southend-on-Sea,State-funded secondary,"Social, Emotional and Mental Health",409,272,137
Southend-on-Sea,State-funded secondary,Specific Learning Difficulty,382,223,159
Southend-on-Sea,State-funded secondary,"Speech, Language and Communications needs",205,144,61
Southend-on-Sea,State-funded secondary,Visual Impairment,12,7,5
Southend-on-Sea,State-funded special school,Autistic Spectrum Disorder,215,180,35
Southend-on-Sea,State-funded special school,Moderate Learning Difficulty,80,54,26
Southend-on-Sea,State-funded special school,Other Difficulty/Disability,9,4,5
Southend-on-Sea,State-funded special school,Physical Disability,1,1,0
Southend-on-Sea,State-funded special school,Profound & Multiple Learning Difficulty,26,15,11
Southend-on-Sea,State-funded special school,Severe Learning Difficulty,187,116,71
Southend-on-Sea,State-funded special school,"Social, Emotional and Mental Health",79,71,8
Southend-on-Sea,State-funded special school,Specific Learning Difficulty,17,10,7
Southend-on-Sea,State-funded special school,"Speech, Language and Communications needs",31,23,8
Thurrock,State-funded AP school,Autistic Spectrum Disorder,1,1,0
Thurrock,State-funded AP school,"Social, Emotional and Mental Health",34,27,7
Thurrock,State-funded AP school,Specific Learning Difficulty,1,1,0
Thurrock,State-funded primary,Autistic Spectrum Disorder,276,212,64
Thurrock,State-funded primary,Hearing Impairment,40,21,19
Thurrock,State-funded primary,Moderate Learning Difficulty,515,305,210
Thurrock,State-funded primary,Multi- Sensory Impairment,6,5,1
Thurrock,State-funded primary,Other Difficulty/Disability,72,39,33
Thurrock,State-funded primary,Physical Disability,64,36,28
Thurrock,State-funded primary,Profound & Multiple Learning Difficulty,1,0,1
Thurrock,State-funded primary,SEN support but no specialist assessment of type of need,262,160,102
Thurrock,State-funded primary,Severe Learning Difficulty,9,6,3
Thurrock,State-funded primary,"Social, Emotional and Mental Health",504,380,124
Thurrock,State-funded primary,Specific Learning Difficulty,109,64,45
Thurrock,State-funded primary,"Speech, Language and Communications needs",997,716,281
Thurrock,State-funded primary,Visual Impairment,18,10,8
Thurrock,State-funded secondary,Autistic Spectrum Disorder,186,142,44
Thurrock,State-funded secondary,Hearing Impairment,32,16,16
Thurrock,State-funded secondary,Moderate Learning Difficulty,395,233,162
Thurrock,State-funded secondary,Multi- Sensory Impairment,15,9,6
Thurrock,State-funded secondary,Other Difficulty/Disability,79,55,24
Thurrock,State-funded secondary,Physical Disability,38,25,13
Thurrock,State-funded secondary,SEN support but no specialist assessment of type of need,45,26,19
Thurrock,State-funded secondary,Severe Learning Difficulty,6,3,3
Thurrock,State-funded secondary,"Social, Emotional and Mental Health",465,332,133
Thurrock,State-funded secondary,Specific Learning Difficulty,204,119,85
Thurrock,State-funded secondary,"Speech, Language and Communications needs",195,129,66
Thurrock,State-funded secondary,Visual Impairment,15,12,3
Thurrock,State-funded special school,Autistic Spectrum Disorder,203,169,34
Thurrock,State-funded special school,Hearing Impairment,1,1,0
Thurrock,State-funded special school,Moderate Learning Difficulty,97,60,37
Thurrock,State-funded special school,Multi- Sensory Impairment,1,0,1
Thurrock,State-funded special school,Other Difficulty/Disability,7,3,4
Thurrock,State-funded special school,Physical Disability,22,7,15
Thurrock,State-funded special school,Profound & Multiple Learning Difficulty,22,7,15
Thurrock,State-funded special school,Severe Learning Difficulty,51,34,17
Thurrock,State-funded special school,"Social, Emotional and Mental Health",19,17,2
Thurrock,State-funded special school,Specific Learning Difficulty,2,1,1
Thurrock,State-funded special school,"Speech, Language and Communications needs",71,50,21
Thurrock,State-funded special school,Visual Impairment,2,1,1
Bedford,State-funded AP school,Moderate Learning Difficulty,1,1,0
Bedford,State-funded AP school,Other Difficulty/Disability,1,0,1
Bedford,State-funded AP school,"Social, Emotional and Mental Health",32,20,12
Bedford,State-funded AP school,Specific Learning Difficulty,2,2,0
Bedford,State-funded AP school,"Speech, Language and Communications needs",4,4,0
Bedford,State-funded nursery,Autistic Spectrum Disorder,1,0,1
Bedford,State-funded nursery,Other Difficulty/Disability,1,1,0
Bedford,State-funded nursery,Physical Disability,1,0,1
Bedford,State-funded nursery,"Speech, Language and Communications needs",24,18,6
Bedford,State-funded primary,Autistic Spectrum Disorder,239,172,67
Bedford,State-funded primary,Hearing Impairment,35,22,13
Bedford,State-funded primary,Moderate Learning Difficulty,485,286,199
Bedford,State-funded primary,Multi- Sensory Impairment,4,2,2
Bedford,State-funded primary,Other Difficulty/Disability,86,47,39
Bedford,State-funded primary,Physical Disability,35,23,12
Bedford,State-funded primary,SEN support but no specialist assessment of type of need,66,36,30
Bedford,State-funded primary,Severe Learning Difficulty,12,8,4
Bedford,State-funded primary,"Social, Emotional and Mental Health",394,289,105
Bedford,State-funded primary,Specific Learning Difficulty,291,155,136
Bedford,State-funded primary,"Speech, Language and Communications needs",825,596,229
Bedford,State-funded primary,Visual Impairment,9,6,3
Bedford,State-funded secondary,Autistic Spectrum Disorder,274,195,79
Bedford,State-funded secondary,Hearing Impairment,32,15,17
Bedford,State-funded secondary,Moderate Learning Difficulty,275,170,105
Bedford,State-funded secondary,Multi- Sensory Impairment,4,1,3
Bedford,State-funded secondary,Other Difficulty/Disability,29,19,10
Bedford,State-funded secondary,Physical Disability,41,25,16
Bedford,State-funded secondary,SEN support but no specialist assessment of type of need,13,6,7
Bedford,State-funded secondary,Severe Learning Difficulty,7,6,1
Bedford,State-funded secondary,"Social, Emotional and Mental Health",355,248,107
Bedford,State-funded secondary,Specific Learning Difficulty,426,242,184
Bedford,State-funded secondary,"Speech, Language and Communications needs",119,81,38
Bedford,State-funded secondary,Visual Impairment,23,14,9
Bedford,State-funded special school,Autistic Spectrum Disorder,119,98,21
Bedford,State-funded special school,Hearing Impairment,2,1,1
Bedford,State-funded special school,Moderate Learning Difficulty,74,43,31
Bedford,State-funded special school,Multi- Sensory Impairment,2,2,0
Bedford,State-funded special school,Other Difficulty/Disability,11,8,3
Bedford,State-funded special school,Physical Disability,39,23,16
Bedford,State-funded special school,Profound & Multiple Learning Difficulty,28,14,14
Bedford,State-funded special school,Severe Learning Difficulty,98,70,28
Bedford,State-funded special school,"Social, Emotional and Mental Health",4,3,1
Bedford,State-funded special school,Specific Learning Difficulty,13,3,10
Bedford,State-funded special school,"Speech, Language and Communications needs",17,11,6
Bedford,State-funded special school,Visual Impairment,3,2,1
Central Bedfordshire,State-funded AP school,Autistic Spectrum Disorder,2,2,0
Central Bedfordshire,State-funded AP school,Moderate Learning Difficulty,6,4,2
Central Bedfordshire,State-funded AP school,SEN support but no specialist assessment of type of need,1,0,1
Central Bedfordshire,State-funded AP school,"Social, Emotional and Mental Health",42,29,13
Central Bedfordshire,State-funded AP school,Specific Learning Difficulty,2,2,0
Central Bedfordshire,State-funded AP school,"Speech, Language and Communications needs",6,6,0
Central Bedfordshire,State-funded nursery,Physical Disability,2,2,0
Central Bedfordshire,State-funded nursery,"Social, Emotional and Mental Health",2,1,1
Central Bedfordshire,State-funded nursery,"Speech, Language and Communications needs",15,5,10
Central Bedfordshire,State-funded primary,Autistic Spectrum Disorder,442,328,114
Central Bedfordshire,State-funded primary,Hearing Impairment,56,33,23
Central Bedfordshire,State-funded primary,Moderate Learning Difficulty,547,301,246
Central Bedfordshire,State-funded primary,Multi- Sensory Impairment,20,16,4
Central Bedfordshire,State-funded primary,Other Difficulty/Disability,9,5,4
Central Bedfordshire,State-funded primary,Physical Disability,99,58,41
Central Bedfordshire,State-funded primary,Profound & Multiple Learning Difficulty,7,6,1
Central Bedfordshire,State-funded primary,SEN support but no specialist assessment of type of need,45,26,19
Central Bedfordshire,State-funded primary,Severe Learning Difficulty,5,3,2
Central Bedfordshire,State-funded primary,"Social, Emotional and Mental Health",813,595,218
Central Bedfordshire,State-funded primary,Specific Learning Difficulty,351,201,150
Central Bedfordshire,State-funded primary,"Speech, Language and Communications needs",1141,823,318
Central Bedfordshire,State-funded primary,Visual Impairment,21,14,7
Central Bedfordshire,State-funded secondary,Autistic Spectrum Disorder,642,478,164
Central Bedfordshire,State-funded secondary,Hearing Impairment,59,33,26
Central Bedfordshire,State-funded secondary,Moderate Learning Difficulty,579,330,249
Central Bedfordshire,State-funded secondary,Multi- Sensory Impairment,8,8,0
Central Bedfordshire,State-funded secondary,Other Difficulty/Disability,41,25,16
Central Bedfordshire,State-funded secondary,Physical Disability,111,70,41
Central Bedfordshire,State-funded secondary,Profound & Multiple Learning Difficulty,3,2,1
Central Bedfordshire,State-funded secondary,SEN support but no specialist assessment of type of need,27,21,6
Central Bedfordshire,State-funded secondary,Severe Learning Difficulty,1,1,0
Central Bedfordshire,State-funded secondary,"Social, Emotional and Mental Health",1053,671,382
Central Bedfordshire,State-funded secondary,Specific Learning Difficulty,766,411,355
Central Bedfordshire,State-funded secondary,"Speech, Language and Communications needs",272,186,86
Central Bedfordshire,State-funded secondary,Visual Impairment,40,18,22
Central Bedfordshire,State-funded special school,Autistic Spectrum Disorder,270,210,57
Central Bedfordshire,State-funded special school,Hearing Impairment,1,1,0
Central Bedfordshire,State-funded special school,Moderate Learning Difficulty,88,58,30
Central Bedfordshire,State-funded special school,Multi- Sensory Impairment,10,4,6
Central Bedfordshire,State-funded special school,Other Difficulty/Disability,21,11,10
Central Bedfordshire,State-funded special school,Physical Disability,8,4,4
Central Bedfordshire,State-funded special school,Profound & Multiple Learning Difficulty,23,16,7
Central Bedfordshire,State-funded special school,Severe Learning Difficulty,155,102,53
Central Bedfordshire,State-funded special school,"Social, Emotional and Mental Health",144,122,22
Central Bedfordshire,State-funded special school,Specific Learning Difficulty,20,13,7
Central Bedfordshire,State-funded special school,"Speech, Language and Communications needs",92,58,34
Central Bedfordshire,State-funded special school,Visual Impairment,4,1,3
Cambridgeshire,State-funded AP school,"Social, Emotional and Mental Health",1,1,0
Cambridgeshire,State-funded nursery,Autistic Spectrum Disorder,24,20,4
Cambridgeshire,State-funded nursery,Hearing Impairment,2,2,0
Cambridgeshire,State-funded nursery,Moderate Learning Difficulty,1,1,0
Cambridgeshire,State-funded nursery,Other Difficulty/Disability,2,2,0
Cambridgeshire,State-funded nursery,Physical Disability,1,1,0
Cambridgeshire,State-funded nursery,Profound & Multiple Learning Difficulty,3,1,2
Cambridgeshire,State-funded nursery,SEN support but no specialist assessment of type of need,2,0,2
Cambridgeshire,State-funded nursery,"Social, Emotional and Mental Health",2,2,0
Cambridgeshire,State-funded nursery,Specific Learning Difficulty,1,0,1
Cambridgeshire,State-funded nursery,"Speech, Language and Communications needs",30,17,13
Cambridgeshire,State-funded primary,Autistic Spectrum Disorder,786,590,196
Cambridgeshire,State-funded primary,Hearing Impairment,121,67,54
Cambridgeshire,State-funded primary,Moderate Learning Difficulty,1586,908,678
Cambridgeshire,State-funded primary,Multi- Sensory Impairment,30,18,12
Cambridgeshire,State-funded primary,Other Difficulty/Disability,357,224,133
Cambridgeshire,State-funded primary,Physical Disability,196,101,95
Cambridgeshire,State-funded primary,Profound & Multiple Learning Difficulty,23,15,8
Cambridgeshire,State-funded primary,SEN support but no specialist assessment of type of need,688,416,272
Cambridgeshire,State-funded primary,Severe Learning Difficulty,56,41,15
Cambridgeshire,State-funded primary,"Social, Emotional and Mental Health",1549,1102,447
Cambridgeshire,State-funded primary,Specific Learning Difficulty,965,583,382
Cambridgeshire,State-funded primary,"Speech, Language and Communications needs",2029,1402,627
Cambridgeshire,State-funded primary,Visual Impairment,48,25,23
Cambridgeshire,State-funded secondary,Autistic Spectrum Disorder,607,446,161
Cambridgeshire,State-funded secondary,Hearing Impairment,96,48,48
Cambridgeshire,State-funded secondary,Moderate Learning Difficulty,816,456,360
Cambridgeshire,State-funded secondary,Multi- Sensory Impairment,11,8,3
Cambridgeshire,State-funded secondary,Other Difficulty/Disability,168,103,65
Cambridgeshire,State-funded secondary,Physical Disability,143,82,61
Cambridgeshire,State-funded secondary,Profound & Multiple Learning Difficulty,6,4,2
Cambridgeshire,State-funded secondary,SEN support but no specialist assessment of type of need,191,112,79
Cambridgeshire,State-funded secondary,Severe Learning Difficulty,29,19,10
Cambridgeshire,State-funded secondary,"Social, Emotional and Mental Health",1301,819,482
Cambridgeshire,State-funded secondary,Specific Learning Difficulty,1303,702,601
Cambridgeshire,State-funded secondary,"Speech, Language and Communications needs",507,341,166
Cambridgeshire,State-funded secondary,Visual Impairment,51,30,21
Cambridgeshire,State-funded special school,Autistic Spectrum Disorder,332,256,76
Cambridgeshire,State-funded special school,Hearing Impairment,2,2,0
Cambridgeshire,State-funded special school,Moderate Learning Difficulty,264,181,83
Cambridgeshire,State-funded special school,Multi- Sensory Impairment,2,1,1
Cambridgeshire,State-funded special school,Other Difficulty/Disability,13,8,5
Cambridgeshire,State-funded special school,Physical Disability,12,6,6
Cambridgeshire,State-funded special school,Profound & Multiple Learning Difficulty,96,46,50
Cambridgeshire,State-funded special school,Severe Learning Difficulty,522,357,165
Cambridgeshire,State-funded special school,"Social, Emotional and Mental Health",301,262,39
Cambridgeshire,State-funded special school,Specific Learning Difficulty,68,42,26
Cambridgeshire,State-funded special school,"Speech, Language and Communications needs",67,48,19
Cambridgeshire,State-funded special school,Visual Impairment,3,2,1
Essex,Non-maintained special school,Autistic Spectrum Disorder,20,18,2
Essex,Non-maintained special school,Moderate Learning Difficulty,2,0,2
Essex,Non-maintained special school,Other Difficulty/Disability,3,1,2
Essex,Non-maintained special school,Profound & Multiple Learning Difficulty,2,2,0
Essex,Non-maintained special school,Severe Learning Difficulty,19,14,5
Essex,Non-maintained special school,"Social, Emotional and Mental Health",2,2,0
Essex,Non-maintained special school,Specific Learning Difficulty,45,32,13
Essex,Non-maintained special school,"Speech, Language and Communications needs",5,4,1
Essex,Non-maintained special school,Visual Impairment,1,1,0
Essex,State-funded AP school,Autistic Spectrum Disorder,9,7,2
Essex,State-funded AP school,Other Difficulty/Disability,1,1,0
Essex,State-funded AP school,SEN support but no specialist assessment of type of need,1,1,0
Essex,State-funded AP school,"Social, Emotional and Mental Health",174,120,54
Essex,State-funded AP school,Specific Learning Difficulty,2,1,1
Essex,State-funded AP school,"Speech, Language and Communications needs",5,3,2
Essex,State-funded nursery,Autistic Spectrum Disorder,10,6,4
Essex,State-funded nursery,Moderate Learning Difficulty,1,0,1
Essex,State-funded nursery,Other Difficulty/Disability,1,1,0
Essex,State-funded nursery,Physical Disability,1,0,1
Essex,State-funded nursery,"Social, Emotional and Mental Health",3,3,0
Essex,State-funded nursery,Specific Learning Difficulty,1,1,0
Essex,State-funded nursery,"Speech, Language and Communications needs",56,43,13
Essex,State-funded primary,Autistic Spectrum Disorder,2722,2052,670
Essex,State-funded primary,Hearing Impairment,315,164,151
Essex,State-funded primary,Moderate Learning Difficulty,2785,1627,1158
Essex,State-funded primary,Multi- Sensory Impairment,67,44,23
Essex,State-funded primary,Other Difficulty/Disability,539,333,206
Essex,State-funded primary,Physical Disability,440,254,186
Essex,State-funded primary,Profound & Multiple Learning Difficulty,49,34,15
Essex,State-funded primary,SEN support but no specialist assessment of type of need,637,393,244
Essex,State-funded primary,Severe Learning Difficulty,102,70,32
Essex,State-funded primary,"Social, Emotional and Mental Health",3502,2553,949
Essex,State-funded primary,Specific Learning Difficulty,1440,855,585
Essex,State-funded primary,"Speech, Language and Communications needs",4909,3473,1436
Essex,State-funded primary,Visual Impairment,157,88,69
Essex,State-funded secondary,Autistic Spectrum Disorder,2125,1494,631
Essex,State-funded secondary,Hearing Impairment,218,110,108
Essex,State-funded secondary,Moderate Learning Difficulty,2398,1445,953
Essex,State-funded secondary,Multi- Sensory Impairment,49,27,22
Essex,State-funded secondary,Other Difficulty/Disability,495,299,196
Essex,State-funded secondary,Physical Disability,361,204,157
Essex,State-funded secondary,Profound & Multiple Learning Difficulty,26,17,9
Essex,State-funded secondary,SEN support but no specialist assessment of type of need,211,135,76
Essex,State-funded secondary,Severe Learning Difficulty,39,30,9
Essex,State-funded secondary,"Social, Emotional and Mental Health",3570,2370,1200
Essex,State-funded secondary,Specific Learning Difficulty,1928,1094,834
Essex,State-funded secondary,"Speech, Language and Communications needs",1330,874,456
Essex,State-funded secondary,Visual Impairment,173,106,67
Essex,State-funded special school,Autistic Spectrum Disorder,952,748,204
Essex,State-funded special school,Hearing Impairment,11,7,4
Essex,State-funded special school,Moderate Learning Difficulty,618,399,219
Essex,State-funded special school,Multi- Sensory Impairment,12,8,4
Essex,State-funded special school,Other Difficulty/Disability,40,24,16
Essex,State-funded special school,Physical Disability,99,54,45
Essex,State-funded special school,Profound & Multiple Learning Difficulty,144,72,72
Essex,State-funded special school,Severe Learning Difficulty,1028,732,296
Essex,State-funded special school,"Social, Emotional and Mental Health",299,272,27
Essex,State-funded special school,Specific Learning Difficulty,53,34,19
Essex,State-funded special school,"Speech, Language and Communications needs",247,158,89
Essex,State-funded special school,Visual Impairment,7,6,1
Hertfordshire,Non-maintained special school,Autistic Spectrum Disorder,3,3,0
Hertfordshire,Non-maintained special school,Moderate Learning Difficulty,6,4,2
Hertfordshire,Non-maintained special school,Other Difficulty/Disability,5,4,1
Hertfordshire,Non-maintained special school,Profound & Multiple Learning Difficulty,4,4,0
Hertfordshire,Non-maintained special school,Severe Learning Difficulty,16,11,5
Hertfordshire,Non-maintained special school,"Social, Emotional and Mental Health",1,1,0
Hertfordshire,Non-maintained special school,Specific Learning Difficulty,1,1,0
Hertfordshire,Non-maintained special school,"Speech, Language and Communications needs",1,1,0
Hertfordshire,State-funded AP school,Autistic Spectrum Disorder,33,18,15
Hertfordshire,State-funded AP school,Moderate Learning Difficulty,3,2,1
Hertfordshire,State-funded AP school,Other Difficulty/Disability,2,0,2
Hertfordshire,State-funded AP school,"Social, Emotional and Mental Health",41,27,14
Hertfordshire,State-funded AP school,"Speech, Language and Communications needs",3,2,1
Hertfordshire,State-funded nursery,Autistic Spectrum Disorder,46,36,10
Hertfordshire,State-funded nursery,Hearing Impairment,3,2,1
Hertfordshire,State-funded nursery,Moderate Learning Difficulty,7,6,1
Hertfordshire,State-funded nursery,Other Difficulty/Disability,8,2,6
Hertfordshire,State-funded nursery,Physical Disability,3,1,2
Hertfordshire,State-funded nursery,Profound & Multiple Learning Difficulty,1,1,0
Hertfordshire,State-funded nursery,"Social, Emotional and Mental Health",10,10,0
Hertfordshire,State-funded nursery,Specific Learning Difficulty,3,3,0
Hertfordshire,State-funded nursery,"Speech, Language and Communications needs",132,89,43
Hertfordshire,State-funded nursery,Visual Impairment,1,0,1
Hertfordshire,State-funded primary,Autistic Spectrum Disorder,2070,1539,531
Hertfordshire,State-funded primary,Hearing Impairment,238,110,128
Hertfordshire,State-funded primary,Moderate Learning Difficulty,1391,796,595
Hertfordshire,State-funded primary,Multi- Sensory Impairment,45,34,11
Hertfordshire,State-funded primary,Other Difficulty/Disability,583,382,201
Hertfordshire,State-funded primary,Physical Disability,367,226,141
Hertfordshire,State-funded primary,Profound & Multiple Learning Difficulty,17,10,7
Hertfordshire,State-funded primary,SEN support but no specialist assessment of type of need,1304,839,465
Hertfordshire,State-funded primary,Severe Learning Difficulty,47,38,9
Hertfordshire,State-funded primary,"Social, Emotional and Mental Health",3574,2534,1040
Hertfordshire,State-funded primary,Specific Learning Difficulty,2048,1156,892
Hertfordshire,State-funded primary,"Speech, Language and Communications needs",4098,2810,1288
Hertfordshire,State-funded primary,Visual Impairment,137,83,54
Hertfordshire,State-funded secondary,Autistic Spectrum Disorder,2062,1420,642
Hertfordshire,State-funded secondary,Hearing Impairment,287,157,130
Hertfordshire,State-funded secondary,Moderate Learning Difficulty,1477,845,632
Hertfordshire,State-funded secondary,Multi- Sensory Impairment,28,19,9
Hertfordshire,State-funded secondary,Other Difficulty/Disability,741,452,289
Hertfordshire,State-funded secondary,Physical Disability,395,232,163
Hertfordshire,State-funded secondary,Profound & Multiple Learning Difficulty,6,1,5
Hertfordshire,State-funded secondary,SEN support but no specialist assessment of type of need,557,301,256
Hertfordshire,State-funded secondary,Severe Learning Difficulty,31,21,10
Hertfordshire,State-funded secondary,"Social, Emotional and Mental Health",3205,2026,1179
Hertfordshire,State-funded secondary,Specific Learning Difficulty,3476,1964,1512
Hertfordshire,State-funded secondary,"Speech, Language and Communications needs",1178,828,350
Hertfordshire,State-funded secondary,Visual Impairment,164,102,62
Hertfordshire,State-funded special school,Autistic Spectrum Disorder,613,503,110
Hertfordshire,State-funded special school,Hearing Impairment,195,109,86
Hertfordshire,State-funded special school,Moderate Learning Difficulty,341,207,134
Hertfordshire,State-funded special school,Multi- Sensory Impairment,4,3,1
Hertfordshire,State-funded special school,Other Difficulty/Disability,65,36,29
Hertfordshire,State-funded special school,Physical Disability,156,95,61
Hertfordshire,State-funded special school,Profound & Multiple Learning Difficulty,75,31,44
Hertfordshire,State-funded special school,Severe Learning Difficulty,612,417,195
Hertfordshire,State-funded special school,"Social, Emotional and Mental Health",511,446,65
Hertfordshire,State-funded special school,Specific Learning Difficulty,53,31,22
Hertfordshire,State-funded special school,"Speech, Language and Communications needs",179,132,47
Hertfordshire,State-funded special school,Visual Impairment,6,4,2
Norfolk,State-funded AP school,Autistic Spectrum Disorder,14,12,2
Norfolk,State-funded AP school,Moderate Learning Difficulty,5,4,1
Norfolk,State-funded AP school,Other Difficulty/Disability,1,1,0
Norfolk,State-funded AP school,"Social, Emotional and Mental Health",260,208,52
Norfolk,State-funded AP school,Specific Learning Difficulty,3,2,1
Norfolk,State-funded AP school,"Speech, Language and Communications needs",7,6,1
Norfolk,State-funded primary,Autistic Spectrum Disorder,763,611,152
Norfolk,State-funded primary,Hearing Impairment,129,74,55
Norfolk,State-funded primary,Moderate Learning Difficulty,1931,1140,791
Norfolk,State-funded primary,Multi- Sensory Impairment,50,30,20
Norfolk,State-funded primary,Other Difficulty/Disability,262,158,104
Norfolk,State-funded primary,Physical Disability,329,188,141
Norfolk,State-funded primary,Profound & Multiple Learning Difficulty,20,14,6
Norfolk,State-funded primary,SEN support but no specialist assessment of type of need,1064,657,407
Norfolk,State-funded primary,Severe Learning Difficulty,44,31,13
Norfolk,State-funded primary,"Social, Emotional and Mental Health",2546,1793,753
Norfolk,State-funded primary,Specific Learning Difficulty,947,543,404
Norfolk,State-funded primary,"Speech, Language and Communications needs",3390,2364,1026
Norfolk,State-funded primary,Visual Impairment,92,52,40
Norfolk,State-funded secondary,Autistic Spectrum Disorder,811,586,225
Norfolk,State-funded secondary,Hearing Impairment,141,76,65
Norfolk,State-funded secondary,Moderate Learning Difficulty,857,506,351
Norfolk,State-funded secondary,Multi- Sensory Impairment,33,19,14
Norfolk,State-funded secondary,Other Difficulty/Disability,569,356,213
Norfolk,State-funded secondary,Physical Disability,258,130,128
Norfolk,State-funded secondary,Profound & Multiple Learning Difficulty,8,4,4
Norfolk,State-funded secondary,SEN support but no specialist assessment of type of need,318,192,126
Norfolk,State-funded secondary,Severe Learning Difficulty,17,12,5
Norfolk,State-funded secondary,"Social, Emotional and Mental Health",2174,1308,866
Norfolk,State-funded secondary,Specific Learning Difficulty,1909,1068,841
Norfolk,State-funded secondary,"Speech, Language and Communications needs",627,428,199
Norfolk,State-funded secondary,Visual Impairment,95,53,42
Norfolk,State-funded special school,Autistic Spectrum Disorder,640,496,144
Norfolk,State-funded special school,Hearing Impairment,17,12,5
Norfolk,State-funded special school,Moderate Learning Difficulty,219,126,93
Norfolk,State-funded special school,Multi- Sensory Impairment,13,6,7
Norfolk,State-funded special school,Other Difficulty/Disability,50,27,23
Norfolk,State-funded special school,Physical Disability,115,66,49
Norfolk,State-funded special school,Profound & Multiple Learning Difficulty,69,39,30
Norfolk,State-funded special school,Severe Learning Difficulty,283,209,74
Norfolk,State-funded special school,"Social, Emotional and Mental Health",256,221,35
Norfolk,State-funded special school,Specific Learning Difficulty,60,40,20
Norfolk,State-funded special school,"Speech, Language and Communications needs",204,137,67
Norfolk,State-funded special school,Visual Impairment,13,5,8
Suffolk,State-funded AP school,Autistic Spectrum Disorder,3,3,0
Suffolk,State-funded AP school,Hearing Impairment,1,0,1
Suffolk,State-funded AP school,Moderate Learning Difficulty,1,1,0
Suffolk,State-funded AP school,Other Difficulty/Disability,1,1,0
Suffolk,State-funded AP school,"Social, Emotional and Mental Health",44,35,9
Suffolk,State-funded AP school,"Speech, Language and Communications needs",3,3,0
Suffolk,State-funded nursery,Specific Learning Difficulty,2,1,1
Suffolk,State-funded nursery,"Speech, Language and Communications needs",9,8,1
Suffolk,State-funded primary,Autistic Spectrum Disorder,1036,795,241
Suffolk,State-funded primary,Hearing Impairment,143,80,63
Suffolk,State-funded primary,Moderate Learning Difficulty,1005,610,395
Suffolk,State-funded primary,Multi- Sensory Impairment,25,14,11
Suffolk,State-funded primary,Other Difficulty/Disability,419,236,183
Suffolk,State-funded primary,Physical Disability,235,133,102
Suffolk,State-funded primary,Profound & Multiple Learning Difficulty,22,10,12
Suffolk,State-funded primary,SEN support but no specialist assessment of type of need,652,386,266
Suffolk,State-funded primary,Severe Learning Difficulty,59,35,24
Suffolk,State-funded primary,"Social, Emotional and Mental Health",1483,1074,409
Suffolk,State-funded primary,Specific Learning Difficulty,954,557,397
Suffolk,State-funded primary,"Speech, Language and Communications needs",2788,1926,862
Suffolk,State-funded primary,Visual Impairment,77,42,35
Suffolk,State-funded secondary,Autistic Spectrum Disorder,1018,771,247
Suffolk,State-funded secondary,Hearing Impairment,128,74,54
Suffolk,State-funded secondary,Moderate Learning Difficulty,743,454,289
Suffolk,State-funded secondary,Multi- Sensory Impairment,36,18,18
Suffolk,State-funded secondary,Other Difficulty/Disability,724,412,312
Suffolk,State-funded secondary,Physical Disability,197,120,77
Suffolk,State-funded secondary,Profound & Multiple Learning Difficulty,7,4,3
Suffolk,State-funded secondary,SEN support but no specialist assessment of type of need,267,151,116
Suffolk,State-funded secondary,Severe Learning Difficulty,19,10,9
Suffolk,State-funded secondary,"Social, Emotional and Mental Health",1576,947,629
Suffolk,State-funded secondary,Specific Learning Difficulty,1657,923,734
Suffolk,State-funded secondary,"Speech, Language and Communications needs",676,457,219
Suffolk,State-funded secondary,Visual Impairment,100,40,60
Suffolk,State-funded special school,Autistic Spectrum Disorder,341,273,68
Suffolk,State-funded special school,Hearing Impairment,9,6,3
Suffolk,State-funded special school,Moderate Learning Difficulty,166,94,72
Suffolk,State-funded special school,Multi- Sensory Impairment,7,6,1
Suffolk,State-funded special school,Other Difficulty/Disability,30,14,16
Suffolk,State-funded special school,Physical Disability,65,33,32
Suffolk,State-funded special school,Profound & Multiple Learning Difficulty,53,29,24
Suffolk,State-funded special school,Severe Learning Difficulty,420,287,133
Suffolk,State-funded special school,"Social, Emotional and Mental Health",139,115,24
Suffolk,State-funded special school,Specific Learning Difficulty,47,30,17
Suffolk,State-funded special school,"Speech, Language and Communications needs",224,147,77
Suffolk,State-funded special school,Visual Impairment,3,2,1
City of London,State-funded primary,Autistic Spectrum Disorder,9,9,0
City of London,State-funded primary,Hearing Impairment,2,2,0
City of London,State-funded primary,Moderate Learning Difficulty,4,2,2
City of London,State-funded primary,Multi- Sensory Impairment,2,2,0
City of London,State-funded primary,Other Difficulty/Disability,1,1,0
City of London,State-funded primary,SEN support but no specialist assessment of type of need,7,6,1
City of London,State-funded primary,"Social, Emotional and Mental Health",9,5,4
City of London,State-funded primary,Specific Learning Difficulty,2,1,1
City of London,State-funded primary,"Speech, Language and Communications needs",31,17,14
Barking and Dagenham,State-funded AP school,Autistic Spectrum Disorder,1,1,0
Barking and Dagenham,State-funded AP school,Moderate Learning Difficulty,1,1,0
Barking and Dagenham,State-funded AP school,Other Difficulty/Disability,3,3,0
Barking and Dagenham,State-funded AP school,"Social, Emotional and Mental Health",11,7,4
Barking and Dagenham,State-funded primary,Autistic Spectrum Disorder,750,576,174
Barking and Dagenham,State-funded primary,Hearing Impairment,67,35,32
Barking and Dagenham,State-funded primary,Moderate Learning Difficulty,490,303,187
Barking and Dagenham,State-funded primary,Multi- Sensory Impairment,3,1,2
Barking and Dagenham,State-funded primary,Other Difficulty/Disability,54,30,24
Barking and Dagenham,State-funded primary,Physical Disability,64,39,25
Barking and Dagenham,State-funded primary,Profound & Multiple Learning Difficulty,6,5,1
Barking and Dagenham,State-funded primary,SEN support but no specialist assessment of type of need,124,81,43
Barking and Dagenham,State-funded primary,Severe Learning Difficulty,20,16,4
Barking and Dagenham,State-funded primary,"Social, Emotional and Mental Health",518,374,144
Barking and Dagenham,State-funded primary,Specific Learning Difficulty,74,37,37
Barking and Dagenham,State-funded primary,"Speech, Language and Communications needs",1894,1325,569
Barking and Dagenham,State-funded primary,Visual Impairment,21,13,8
Barking and Dagenham,State-funded secondary,Autistic Spectrum Disorder,340,286,54
Barking and Dagenham,State-funded secondary,Hearing Impairment,44,28,16
Barking and Dagenham,State-funded secondary,Moderate Learning Difficulty,555,363,192
Barking and Dagenham,State-funded secondary,Multi- Sensory Impairment,1,1,0
Barking and Dagenham,State-funded secondary,Other Difficulty/Disability,31,17,14
Barking and Dagenham,State-funded secondary,Physical Disability,52,25,27
Barking and Dagenham,State-funded secondary,Profound & Multiple Learning Difficulty,2,2,0
Barking and Dagenham,State-funded secondary,SEN support but no specialist assessment of type of need,40,25,15
Barking and Dagenham,State-funded secondary,Severe Learning Difficulty,13,8,5
Barking and Dagenham,State-funded secondary,"Social, Emotional and Mental Health",582,426,156
Barking and Dagenham,State-funded secondary,Specific Learning Difficulty,245,137,108
Barking and Dagenham,State-funded secondary,"Speech, Language and Communications needs",565,399,166
Barking and Dagenham,State-funded secondary,Visual Impairment,30,18,12
Barking and Dagenham,State-funded special school,Autistic Spectrum Disorder,118,91,27
Barking and Dagenham,State-funded special school,Hearing Impairment,3,3,0
Barking and Dagenham,State-funded special school,Moderate Learning Difficulty,3,3,0
Barking and Dagenham,State-funded special school,Other Difficulty/Disability,9,5,4
Barking and Dagenham,State-funded special school,Physical Disability,1,1,0
Barking and Dagenham,State-funded special school,Profound & Multiple Learning Difficulty,93,48,45
Barking and Dagenham,State-funded special school,Severe Learning Difficulty,203,163,40
Barking and Dagenham,State-funded special school,"Social, Emotional and Mental Health",45,39,6
Barking and Dagenham,State-funded special school,Specific Learning Difficulty,9,7,2
Barking and Dagenham,State-funded special school,"Speech, Language and Communications needs",23,20,3
Barking and Dagenham,State-funded special school,Visual Impairment,4,2,2
Barnet,State-funded AP school,"Social, Emotional and Mental Health",37,24,13
Barnet,State-funded nursery,Autistic Spectrum Disorder,20,11,9
Barnet,State-funded nursery,Other Difficulty/Disability,2,2,0
Barnet,State-funded nursery,"Social, Emotional and Mental Health",1,1,0
Barnet,State-funded nursery,"Speech, Language and Communications needs",11,8,3
Barnet,State-funded primary,Autistic Spectrum Disorder,821,610,211
Barnet,State-funded primary,Hearing Impairment,83,43,40
Barnet,State-funded primary,Moderate Learning Difficulty,333,194,139
Barnet,State-funded primary,Multi- Sensory Impairment,23,17,6
Barnet,State-funded primary,Other Difficulty/Disability,147,93,54
Barnet,State-funded primary,Physical Disability,106,57,49
Barnet,State-funded primary,Profound & Multiple Learning Difficulty,6,4,2
Barnet,State-funded primary,SEN support but no specialist assessment of type of need,313,186,127
Barnet,State-funded primary,Severe Learning Difficulty,34,20,14
Barnet,State-funded primary,"Social, Emotional and Mental Health",847,577,270
Barnet,State-funded primary,Specific Learning Difficulty,503,290,213
Barnet,State-funded primary,"Speech, Language and Communications needs",1548,1079,469
Barnet,State-funded primary,Visual Impairment,28,14,14
Barnet,State-funded secondary,Autistic Spectrum Disorder,474,377,97
Barnet,State-funded secondary,Hearing Impairment,77,37,40
Barnet,State-funded secondary,Moderate Learning Difficulty,538,312,226
Barnet,State-funded secondary,Multi- Sensory Impairment,11,7,4
Barnet,State-funded secondary,Other Difficulty/Disability,169,99,70
Barnet,State-funded secondary,Physical Disability,116,63,53
Barnet,State-funded secondary,Profound & Multiple Learning Difficulty,4,1,3
Barnet,State-funded secondary,SEN support but no specialist assessment of type of need,79,46,33
Barnet,State-funded secondary,Severe Learning Difficulty,17,14,3
Barnet,State-funded secondary,"Social, Emotional and Mental Health",912,538,374
Barnet,State-funded secondary,Specific Learning Difficulty,584,326,258
Barnet,State-funded secondary,"Speech, Language and Communications needs",442,308,134
Barnet,State-funded secondary,Visual Impairment,38,19,19
Barnet,State-funded special school,Autistic Spectrum Disorder,367,286,81
Barnet,State-funded special school,Hearing Impairment,4,4,0
Barnet,State-funded special school,Moderate Learning Difficulty,45,25,20
Barnet,State-funded special school,Multi- Sensory Impairment,2,1,1
Barnet,State-funded special school,Other Difficulty/Disability,29,19,10
Barnet,State-funded special school,Physical Disability,24,12,12
Barnet,State-funded special school,Profound & Multiple Learning Difficulty,71,41,30
Barnet,State-funded special school,Severe Learning Difficulty,93,51,42
Barnet,State-funded special school,"Social, Emotional and Mental Health",50,42,8
Barnet,State-funded special school,Specific Learning Difficulty,7,2,5
Barnet,State-funded special school,"Speech, Language and Communications needs",61,42,19
Barnet,State-funded special school,Visual Impairment,2,2,0
Bexley,State-funded AP school,"Social, Emotional and Mental Health",17,9,8
Bexley,State-funded primary,Autistic Spectrum Disorder,503,380,123
Bexley,State-funded primary,Hearing Impairment,61,29,32
Bexley,State-funded primary,Moderate Learning Difficulty,85,49,36
Bexley,State-funded primary,Multi- Sensory Impairment,3,1,2
Bexley,State-funded primary,Other Difficulty/Disability,115,70,45
Bexley,State-funded primary,Physical Disability,90,58,32
Bexley,State-funded primary,Profound & Multiple Learning Difficulty,10,7,3
Bexley,State-funded primary,SEN support but no specialist assessment of type of need,213,137,76
Bexley,State-funded primary,Severe Learning Difficulty,7,4,3
Bexley,State-funded primary,"Social, Emotional and Mental Health",540,363,177
Bexley,State-funded primary,Specific Learning Difficulty,171,77,94
Bexley,State-funded primary,"Speech, Language and Communications needs",1490,1051,439
Bexley,State-funded primary,Visual Impairment,23,13,10
Bexley,State-funded secondary,Autistic Spectrum Disorder,478,346,132
Bexley,State-funded secondary,Hearing Impairment,57,29,28
Bexley,State-funded secondary,Moderate Learning Difficulty,103,61,42
Bexley,State-funded secondary,Multi- Sensory Impairment,6,5,1
Bexley,State-funded secondary,Other Difficulty/Disability,105,66,39
Bexley,State-funded secondary,Physical Disability,59,32,27
Bexley,State-funded secondary,Profound & Multiple Learning Difficulty,2,0,2
Bexley,State-funded secondary,SEN support but no specialist assessment of type of need,86,51,35
Bexley,State-funded secondary,Severe Learning Difficulty,2,1,1
Bexley,State-funded secondary,"Social, Emotional and Mental Health",603,399,204
Bexley,State-funded secondary,Specific Learning Difficulty,420,218,202
Bexley,State-funded secondary,"Speech, Language and Communications needs",473,325,148
Bexley,State-funded secondary,Visual Impairment,30,18,12
Bexley,State-funded special school,Autistic Spectrum Disorder,416,343,73
Bexley,State-funded special school,Hearing Impairment,1,0,1
Bexley,State-funded special school,Moderate Learning Difficulty,58,33,25
Bexley,State-funded special school,Other Difficulty/Disability,4,1,3
Bexley,State-funded special school,Physical Disability,1,1,0
Bexley,State-funded special school,Profound & Multiple Learning Difficulty,27,13,14
Bexley,State-funded special school,Severe Learning Difficulty,118,83,35
Bexley,State-funded special school,"Social, Emotional and Mental Health",90,72,18
Bexley,State-funded special school,Specific Learning Difficulty,1,0,1
Bexley,State-funded special school,"Speech, Language and Communications needs",18,10,8
Bexley,State-funded special school,Visual Impairment,2,1,1
Brent,State-funded AP school,Autistic Spectrum Disorder,1,1,0
Brent,State-funded AP school,Other Difficulty/Disability,1,1,0
Brent,State-funded AP school,"Social, Emotional and Mental Health",39,28,11
Brent,State-funded nursery,Autistic Spectrum Disorder,14,10,4
Brent,State-funded nursery,Hearing Impairment,3,1,2
Brent,State-funded nursery,Other Difficulty/Disability,8,6,2
Brent,State-funded nursery,Physical Disability,3,1,2
Brent,State-funded nursery,Profound & Multiple Learning Difficulty,1,0,1
Brent,State-funded nursery,SEN support but no specialist assessment of type of need,1,1,0
Brent,State-funded nursery,"Social, Emotional and Mental Health",4,4,0
Brent,State-funded nursery,Specific Learning Difficulty,1,1,0
Brent,State-funded nursery,"Speech, Language and Communications needs",73,51,22
Brent,State-funded primary,Autistic Spectrum Disorder,390,294,96
Brent,State-funded primary,Hearing Impairment,63,30,33
Brent,State-funded primary,Moderate Learning Difficulty,548,317,231
Brent,State-funded primary,Multi- Sensory Impairment,14,12,2
Brent,State-funded primary,Other Difficulty/Disability,154,89,65
Brent,State-funded primary,Physical Disability,68,35,33
Brent,State-funded primary,Profound & Multiple Learning Difficulty,10,7,3
Brent,State-funded primary,SEN support but no specialist assessment of type of need,153,90,63
Brent,State-funded primary,Severe Learning Difficulty,9,8,1
Brent,State-funded primary,"Social, Emotional and Mental Health",620,418,202
Brent,State-funded primary,Specific Learning Difficulty,185,106,79
Brent,State-funded primary,"Speech, Language and Communications needs",1627,1139,488
Brent,State-funded primary,Visual Impairment,31,10,21
Brent,State-funded secondary,Autistic Spectrum Disorder,246,192,54
Brent,State-funded secondary,Hearing Impairment,60,39,21
Brent,State-funded secondary,Moderate Learning Difficulty,427,264,163
Brent,State-funded secondary,Multi- Sensory Impairment,10,9,1
Brent,State-funded secondary,Other Difficulty/Disability,201,128,73
Brent,State-funded secondary,Physical Disability,46,26,20
Brent,State-funded secondary,Profound & Multiple Learning Difficulty,2,2,0
Brent,State-funded secondary,SEN support but no specialist assessment of type of need,130,70,60
Brent,State-funded secondary,Severe Learning Difficulty,20,11,9
Brent,State-funded secondary,"Social, Emotional and Mental Health",558,356,202
Brent,State-funded secondary,Specific Learning Difficulty,292,164,128
Brent,State-funded secondary,"Speech, Language and Communications needs",420,309,111
Brent,State-funded secondary,Visual Impairment,32,17,15
Brent,State-funded special school,Autistic Spectrum Disorder,496,398,98
Brent,State-funded special school,Moderate Learning Difficulty,20,8,12
Brent,State-funded special school,Other Difficulty/Disability,53,33,20
Brent,State-funded special school,Physical Disability,7,5,2
Brent,State-funded special school,Profound & Multiple Learning Difficulty,91,54,37
Brent,State-funded special school,Severe Learning Difficulty,111,69,42
Brent,State-funded special school,"Social, Emotional and Mental Health",5,5,0
Brent,State-funded special school,Specific Learning Difficulty,17,6,11
Brent,State-funded special school,"Speech, Language and Communications needs",32,22,10
Brent,State-funded special school,Visual Impairment,4,1,3
Bromley,State-funded AP school,"Social, Emotional and Mental Health",55,37,18
Bromley,State-funded primary,Autistic Spectrum Disorder,365,257,108
Bromley,State-funded primary,Hearing Impairment,63,33,30
Bromley,State-funded primary,Moderate Learning Difficulty,225,131,94
Bromley,State-funded primary,Multi- Sensory Impairment,8,4,4
Bromley,State-funded primary,Other Difficulty/Disability,185,105,80
Bromley,State-funded primary,Physical Disability,89,56,33
Bromley,State-funded primary,Profound & Multiple Learning Difficulty,21,17,4
Bromley,State-funded primary,SEN support but no specialist assessment of type of need,194,122,72
Bromley,State-funded primary,Severe Learning Difficulty,31,21,10
Bromley,State-funded primary,"Social, Emotional and Mental Health",789,533,256
Bromley,State-funded primary,Specific Learning Difficulty,464,249,215
Bromley,State-funded primary,"Speech, Language and Communications needs",1922,1331,591
Bromley,State-funded primary,Visual Impairment,49,31,18
Bromley,State-funded secondary,Autistic Spectrum Disorder,409,298,111
Bromley,State-funded secondary,Hearing Impairment,74,38,36
Bromley,State-funded secondary,Moderate Learning Difficulty,275,201,74
Bromley,State-funded secondary,Multi- Sensory Impairment,3,0,3
Bromley,State-funded secondary,Other Difficulty/Disability,253,115,138
Bromley,State-funded secondary,Physical Disability,92,61,31
Bromley,State-funded secondary,Profound & Multiple Learning Difficulty,2,1,1
Bromley,State-funded secondary,SEN support but no specialist assessment of type of need,86,39,47
Bromley,State-funded secondary,Severe Learning Difficulty,3,1,2
Bromley,State-funded secondary,"Social, Emotional and Mental Health",1032,647,385
Bromley,State-funded secondary,Specific Learning Difficulty,883,459,424
Bromley,State-funded secondary,"Speech, Language and Communications needs",494,301,193
Bromley,State-funded secondary,Visual Impairment,47,32,15
Bromley,State-funded special school,Autistic Spectrum Disorder,91,75,16
Bromley,State-funded special school,Hearing Impairment,4,0,4
Bromley,State-funded special school,Moderate Learning Difficulty,124,69,55
Bromley,State-funded special school,Other Difficulty/Disability,6,2,4
Bromley,State-funded special school,Physical Disability,9,6,3
Bromley,State-funded special school,Profound & Multiple Learning Difficulty,113,76,37
Bromley,State-funded special school,Severe Learning Difficulty,287,197,90
Bromley,State-funded special school,"Social, Emotional and Mental Health",172,149,23
Bromley,State-funded special school,Specific Learning Difficulty,23,11,12
Bromley,State-funded special school,"Speech, Language and Communications needs",34,19,15
Bromley,State-funded special school,Visual Impairment,5,5,0
Camden,State-funded AP school,Autistic Spectrum Disorder,10,10,0
Camden,State-funded AP school,Moderate Learning Difficulty,1,0,1
Camden,State-funded AP school,Multi- Sensory Impairment,1,1,0
Camden,State-funded AP school,Other Difficulty/Disability,2,2,0
Camden,State-funded AP school,Profound & Multiple Learning Difficulty,1,0,1
Camden,State-funded AP school,SEN support but no specialist assessment of type of need,1,1,0
Camden,State-funded AP school,"Social, Emotional and Mental Health",34,23,11
Camden,State-funded AP school,Specific Learning Difficulty,1,0,1
Camden,State-funded AP school,"Speech, Language and Communications needs",5,5,0
Camden,State-funded nursery,Autistic Spectrum Disorder,22,15,7
Camden,State-funded nursery,Other Difficulty/Disability,1,1,0
Camden,State-funded nursery,Physical Disability,1,0,1
Camden,State-funded nursery,Profound & Multiple Learning Difficulty,1,0,1
Camden,State-funded primary,Autistic Spectrum Disorder,320,236,84
Camden,State-funded primary,Hearing Impairment,22,8,14
Camden,State-funded primary,Moderate Learning Difficulty,120,61,59
Camden,State-funded primary,Multi- Sensory Impairment,14,11,3
Camden,State-funded primary,Other Difficulty/Disability,97,55,42
Camden,State-funded primary,Physical Disability,42,27,15
Camden,State-funded primary,Profound & Multiple Learning Difficulty,1,0,1
Camden,State-funded primary,SEN support but no specialist assessment of type of need,99,60,39
Camden,State-funded primary,Severe Learning Difficulty,10,7,3
Camden,State-funded primary,"Social, Emotional and Mental Health",323,212,111
Camden,State-funded primary,Specific Learning Difficulty,169,76,93
Camden,State-funded primary,"Speech, Language and Communications needs",795,533,262
Camden,State-funded primary,Visual Impairment,8,6,2
Camden,State-funded secondary,Autistic Spectrum Disorder,155,118,37
Camden,State-funded secondary,Hearing Impairment,12,5,7
Camden,State-funded secondary,Moderate Learning Difficulty,91,49,42
Camden,State-funded secondary,Multi- Sensory Impairment,11,8,3
Camden,State-funded secondary,Other Difficulty/Disability,61,40,21
Camden,State-funded secondary,Physical Disability,42,18,24
Camden,State-funded secondary,Profound & Multiple Learning Difficulty,1,1,0
Camden,State-funded secondary,SEN support but no specialist assessment of type of need,172,97,75
Camden,State-funded secondary,Severe Learning Difficulty,7,4,3
Camden,State-funded secondary,"Social, Emotional and Mental Health",477,272,205
Camden,State-funded secondary,Specific Learning Difficulty,364,164,200
Camden,State-funded secondary,"Speech, Language and Communications needs",281,195,86
Camden,State-funded secondary,Visual Impairment,8,5,3
Camden,State-funded special school,Autistic Spectrum Disorder,164,130,34
Camden,State-funded special school,Hearing Impairment,38,15,23
Camden,State-funded special school,Moderate Learning Difficulty,8,5,3
Camden,State-funded special school,Physical Disability,4,3,1
Camden,State-funded special school,Profound & Multiple Learning Difficulty,34,21,13
Camden,State-funded special school,Severe Learning Difficulty,54,40,14
Camden,State-funded special school,"Social, Emotional and Mental Health",31,26,5
Camden,State-funded special school,Specific Learning Difficulty,5,4,1
Camden,State-funded special school,"Speech, Language and Communications needs",2,1,1
Croydon,State-funded AP school,Autistic Spectrum Disorder,4,3,1
Croydon,State-funded AP school,Moderate Learning Difficulty,1,1,0
Croydon,State-funded AP school,Other Difficulty/Disability,2,1,1
Croydon,State-funded AP school,"Social, Emotional and Mental Health",72,35,37
Croydon,State-funded AP school,Specific Learning Difficulty,3,3,0
Croydon,State-funded AP school,"Speech, Language and Communications needs",7,2,5
Croydon,State-funded nursery,Autistic Spectrum Disorder,5,2,3
Croydon,State-funded nursery,Other Difficulty/Disability,11,8,3
Croydon,State-funded nursery,Physical Disability,1,1,0
Croydon,State-funded nursery,"Social, Emotional and Mental Health",3,2,1
Croydon,State-funded nursery,Specific Learning Difficulty,1,0,1
Croydon,State-funded nursery,"Speech, Language and Communications needs",33,27,6
Croydon,State-funded primary,Autistic Spectrum Disorder,506,393,113
Croydon,State-funded primary,Hearing Impairment,86,40,46
Croydon,State-funded primary,Moderate Learning Difficulty,418,229,189
Croydon,State-funded primary,Multi- Sensory Impairment,22,13,9
Croydon,State-funded primary,Other Difficulty/Disability,218,132,86
Croydon,State-funded primary,Physical Disability,98,52,46
Croydon,State-funded primary,Profound & Multiple Learning Difficulty,4,4,0
Croydon,State-funded primary,SEN support but no specialist assessment of type of need,302,199,103
Croydon,State-funded primary,Severe Learning Difficulty,17,8,9
Croydon,State-funded primary,"Social, Emotional and Mental Health",838,595,243
Croydon,State-funded primary,Specific Learning Difficulty,353,191,162
Croydon,State-funded primary,"Speech, Language and Communications needs",2067,1468,599
Croydon,State-funded primary,Visual Impairment,45,25,20
Croydon,State-funded secondary,Autistic Spectrum Disorder,477,344,133
Croydon,State-funded secondary,Hearing Impairment,77,32,45
Croydon,State-funded secondary,Moderate Learning Difficulty,357,216,141
Croydon,State-funded secondary,Multi- Sensory Impairment,5,2,3
Croydon,State-funded secondary,Other Difficulty/Disability,227,117,110
Croydon,State-funded secondary,Physical Disability,110,51,59
Croydon,State-funded secondary,Profound & Multiple Learning Difficulty,2,1,1
Croydon,State-funded secondary,SEN support but no specialist assessment of type of need,120,59,61
Croydon,State-funded secondary,Severe Learning Difficulty,8,5,3
Croydon,State-funded secondary,"Social, Emotional and Mental Health",963,581,382
Croydon,State-funded secondary,Specific Learning Difficulty,906,482,424
Croydon,State-funded secondary,"Speech, Language and Communications needs",822,544,278
Croydon,State-funded secondary,Visual Impairment,35,21,14
Croydon,State-funded special school,Autistic Spectrum Disorder,546,445,101
Croydon,State-funded special school,Hearing Impairment,3,1,2
Croydon,State-funded special school,Moderate Learning Difficulty,167,103,64
Croydon,State-funded special school,Other Difficulty/Disability,12,9,3
Croydon,State-funded special school,Physical Disability,1,1,0
Croydon,State-funded special school,Profound & Multiple Learning Difficulty,48,28,20
Croydon,State-funded special school,SEN support but no specialist assessment of type of need,5,5,0
Croydon,State-funded special school,Severe Learning Difficulty,244,156,88
Croydon,State-funded special school,"Social, Emotional and Mental Health",166,144,22
Croydon,State-funded special school,Specific Learning Difficulty,13,11,2
Croydon,State-funded special school,"Speech, Language and Communications needs",97,69,28
Croydon,State-funded special school,Visual Impairment,2,2,0
Ealing,State-funded AP school,Moderate Learning Difficulty,1,1,0
Ealing,State-funded AP school,Other Difficulty/Disability,1,1,0
Ealing,State-funded AP school,SEN support but no specialist assessment of type of need,3,3,0
Ealing,State-funded AP school,"Social, Emotional and Mental Health",54,37,17
Ealing,State-funded AP school,"Speech, Language and Communications needs",1,1,0
Ealing,State-funded nursery,Autistic Spectrum Disorder,9,8,1
Ealing,State-funded nursery,Moderate Learning Difficulty,3,2,1
Ealing,State-funded nursery,Other Difficulty/Disability,1,1,0
Ealing,State-funded nursery,Physical Disability,1,1,0
Ealing,State-funded nursery,Profound & Multiple Learning Difficulty,4,3,1
Ealing,State-funded nursery,Severe Learning Difficulty,1,0,1
Ealing,State-funded nursery,"Social, Emotional and Mental Health",3,2,1
Ealing,State-funded nursery,Specific Learning Difficulty,4,3,1
Ealing,State-funded nursery,"Speech, Language and Communications needs",97,69,28
Ealing,State-funded primary,Autistic Spectrum Disorder,381,297,84
Ealing,State-funded primary,Hearing Impairment,56,27,29
Ealing,State-funded primary,Moderate Learning Difficulty,393,243,150
Ealing,State-funded primary,Multi- Sensory Impairment,7,6,1
Ealing,State-funded primary,Other Difficulty/Disability,155,93,62
Ealing,State-funded primary,Physical Disability,71,46,25
Ealing,State-funded primary,Profound & Multiple Learning Difficulty,4,2,2
Ealing,State-funded primary,SEN support but no specialist assessment of type of need,231,148,83
Ealing,State-funded primary,Severe Learning Difficulty,20,13,7
Ealing,State-funded primary,"Social, Emotional and Mental Health",520,347,173
Ealing,State-funded primary,Specific Learning Difficulty,163,90,73
Ealing,State-funded primary,"Speech, Language and Communications needs",2434,1714,720
Ealing,State-funded primary,Visual Impairment,18,11,7
Ealing,State-funded secondary,Autistic Spectrum Disorder,283,249,34
Ealing,State-funded secondary,Hearing Impairment,45,25,20
Ealing,State-funded secondary,Moderate Learning Difficulty,504,268,236
Ealing,State-funded secondary,Multi- Sensory Impairment,6,4,2
Ealing,State-funded secondary,Other Difficulty/Disability,61,30,31
Ealing,State-funded secondary,Physical Disability,69,39,30
Ealing,State-funded secondary,SEN support but no specialist assessment of type of need,92,46,46
Ealing,State-funded secondary,Severe Learning Difficulty,2,1,1
Ealing,State-funded secondary,"Social, Emotional and Mental Health",583,368,215
Ealing,State-funded secondary,Specific Learning Difficulty,348,211,137
Ealing,State-funded secondary,"Speech, Language and Communications needs",739,509,230
Ealing,State-funded secondary,Visual Impairment,28,14,14
Ealing,State-funded special school,Autistic Spectrum Disorder,223,180,43
Ealing,State-funded special school,Hearing Impairment,2,1,1
Ealing,State-funded special school,Moderate Learning Difficulty,188,124,64
Ealing,State-funded special school,Multi- Sensory Impairment,2,2,0
Ealing,State-funded special school,Other Difficulty/Disability,1,1,0
Ealing,State-funded special school,Physical Disability,19,8,11
Ealing,State-funded special school,Profound & Multiple Learning Difficulty,83,46,37
Ealing,State-funded special school,Severe Learning Difficulty,387,284,103
Ealing,State-funded special school,"Social, Emotional and Mental Health",10,10,0
Ealing,State-funded special school,Specific Learning Difficulty,7,4,3
Ealing,State-funded special school,"Speech, Language and Communications needs",29,26,3
Enfield,State-funded AP school,"Social, Emotional and Mental Health",26,22,4
Enfield,State-funded AP school,Specific Learning Difficulty,1,1,0
Enfield,State-funded AP school,"Speech, Language and Communications needs",4,4,0
Enfield,State-funded primary,Autistic Spectrum Disorder,825,649,176
Enfield,State-funded primary,Hearing Impairment,65,36,29
Enfield,State-funded primary,Moderate Learning Difficulty,368,210,158
Enfield,State-funded primary,Multi- Sensory Impairment,3,1,2
Enfield,State-funded primary,Other Difficulty/Disability,82,45,37
Enfield,State-funded primary,Physical Disability,57,32,25
Enfield,State-funded primary,Profound & Multiple Learning Difficulty,4,3,1
Enfield,State-funded primary,SEN support but no specialist assessment of type of need,178,99,79
Enfield,State-funded primary,Severe Learning Difficulty,24,14,10
Enfield,State-funded primary,"Social, Emotional and Mental Health",769,528,241
Enfield,State-funded primary,Specific Learning Difficulty,342,193,149
Enfield,State-funded primary,"Speech, Language and Communications needs",1762,1268,494
Enfield,State-funded primary,Visual Impairment,28,16,12
Enfield,State-funded secondary,Autistic Spectrum Disorder,247,189,58
Enfield,State-funded secondary,Hearing Impairment,58,34,24
Enfield,State-funded secondary,Moderate Learning Difficulty,1000,548,452
Enfield,State-funded secondary,Multi- Sensory Impairment,2,2,0
Enfield,State-funded secondary,Other Difficulty/Disability,139,102,37
Enfield,State-funded secondary,Physical Disability,67,43,24
Enfield,State-funded secondary,Profound & Multiple Learning Difficulty,1,0,1
Enfield,State-funded secondary,SEN support but no specialist assessment of type of need,90,54,36
Enfield,State-funded secondary,Severe Learning Difficulty,8,4,4
Enfield,State-funded secondary,"Social, Emotional and Mental Health",742,425,317
Enfield,State-funded secondary,Specific Learning Difficulty,469,244,225
Enfield,State-funded secondary,"Speech, Language and Communications needs",648,421,227
Enfield,State-funded secondary,Visual Impairment,26,9,17
Enfield,State-funded special school,Autistic Spectrum Disorder,343,267,76
Enfield,State-funded special school,Hearing Impairment,1,1,0
Enfield,State-funded special school,Moderate Learning Difficulty,163,107,56
Enfield,State-funded special school,Multi- Sensory Impairment,3,1,2
Enfield,State-funded special school,Other Difficulty/Disability,9,5,4
Enfield,State-funded special school,Physical Disability,31,16,15
Enfield,State-funded special school,Profound & Multiple Learning Difficulty,53,30,23
Enfield,State-funded special school,Severe Learning Difficulty,93,57,36
Enfield,State-funded special school,"Social, Emotional and Mental Health",147,112,34
Enfield,State-funded special school,Specific Learning Difficulty,5,2,3
Enfield,State-funded special school,"Speech, Language and Communications needs",320,246,74
Enfield,State-funded special school,Visual Impairment,2,1,1
Greenwich,State-funded AP school,Autistic Spectrum Disorder,48,34,14
Greenwich,State-funded AP school,"Social, Emotional and Mental Health",109,62,47
Greenwich,State-funded AP school,Specific Learning Difficulty,8,5,3
Greenwich,State-funded nursery,Autistic Spectrum Disorder,1,1,0
Greenwich,State-funded nursery,Hearing Impairment,2,1,1
Greenwich,State-funded nursery,Moderate Learning Difficulty,1,1,0
Greenwich,State-funded nursery,Other Difficulty/Disability,9,8,1
Greenwich,State-funded nursery,Physical Disability,1,0,1
Greenwich,State-funded nursery,Profound & Multiple Learning Difficulty,1,0,1
Greenwich,State-funded nursery,"Social, Emotional and Mental Health",10,7,3
Greenwich,State-funded nursery,Specific Learning Difficulty,1,1,0
Greenwich,State-funded nursery,"Speech, Language and Communications needs",107,63,44
Greenwich,State-funded primary,Autistic Spectrum Disorder,642,490,152
Greenwich,State-funded primary,Hearing Impairment,54,30,24
Greenwich,State-funded primary,Moderate Learning Difficulty,279,151,128
Greenwich,State-funded primary,Multi- Sensory Impairment,10,7,3
Greenwich,State-funded primary,Other Difficulty/Disability,153,99,54
Greenwich,State-funded primary,Physical Disability,82,45,37
Greenwich,State-funded primary,Profound & Multiple Learning Difficulty,12,7,5
Greenwich,State-funded primary,SEN support but no specialist assessment of type of need,161,110,51
Greenwich,State-funded primary,Severe Learning Difficulty,10,4,6
Greenwich,State-funded primary,"Social, Emotional and Mental Health",656,465,191
Greenwich,State-funded primary,Specific Learning Difficulty,260,133,127
Greenwich,State-funded primary,"Speech, Language and Communications needs",2425,1653,772
Greenwich,State-funded primary,Visual Impairment,27,13,14
Greenwich,State-funded secondary,Autistic Spectrum Disorder,574,434,140
Greenwich,State-funded secondary,Hearing Impairment,48,25,23
Greenwich,State-funded secondary,Moderate Learning Difficulty,195,120,75
Greenwich,State-funded secondary,Multi- Sensory Impairment,3,3,0
Greenwich,State-funded secondary,Other Difficulty/Disability,191,124,67
Greenwich,State-funded secondary,Physical Disability,68,35,33
Greenwich,State-funded secondary,Profound & Multiple Learning Difficulty,26,21,5
Greenwich,State-funded secondary,SEN support but no specialist assessment of type of need,103,53,50
Greenwich,State-funded secondary,Severe Learning Difficulty,11,7,4
Greenwich,State-funded secondary,"Social, Emotional and Mental Health",689,436,253
Greenwich,State-funded secondary,Specific Learning Difficulty,659,302,357
Greenwich,State-funded secondary,"Speech, Language and Communications needs",545,371,174
Greenwich,State-funded secondary,Visual Impairment,29,21,8
Greenwich,State-funded special school,Autistic Spectrum Disorder,302,242,60
Greenwich,State-funded special school,Moderate Learning Difficulty,5,4,1
Greenwich,State-funded special school,Other Difficulty/Disability,40,19,21
Greenwich,State-funded special school,Physical Disability,7,4,3
Greenwich,State-funded special school,Profound & Multiple Learning Difficulty,75,46,29
Greenwich,State-funded special school,Severe Learning Difficulty,27,15,12
Greenwich,State-funded special school,"Social, Emotional and Mental Health",68,63,5
Greenwich,State-funded special school,Specific Learning Difficulty,8,5,3
Greenwich,State-funded special school,"Speech, Language and Communications needs",29,20,9
Greenwich,State-funded special school,Visual Impairment,3,1,2
Hackney,State-funded AP school,Autistic Spectrum Disorder,1,1,0
Hackney,State-funded AP school,SEN support but no specialist assessment of type of need,27,21,6
Hackney,State-funded AP school,"Social, Emotional and Mental Health",12,11,1
Hackney,State-funded AP school,"Speech, Language and Communications needs",2,2,0
Hackney,State-funded nursery,Autistic Spectrum Disorder,10,9,1
Hackney,State-funded nursery,Hearing Impairment,1,0,1
Hackney,State-funded nursery,Other Difficulty/Disability,2,2,0
Hackney,State-funded nursery,SEN support but no specialist assessment of type of need,1,0,1
Hackney,State-funded nursery,Severe Learning Difficulty,1,0,1
Hackney,State-funded nursery,Specific Learning Difficulty,1,1,0
Hackney,State-funded nursery,"Speech, Language and Communications needs",28,16,12
Hackney,State-funded primary,Autistic Spectrum Disorder,488,372,116
Hackney,State-funded primary,Hearing Impairment,32,11,21
Hackney,State-funded primary,Moderate Learning Difficulty,384,214,170
Hackney,State-funded primary,Multi- Sensory Impairment,3,3,0
Hackney,State-funded primary,Other Difficulty/Disability,124,77,47
Hackney,State-funded primary,Physical Disability,50,30,20
Hackney,State-funded primary,Profound & Multiple Learning Difficulty,13,7,6
Hackney,State-funded primary,SEN support but no specialist assessment of type of need,93,52,41
Hackney,State-funded primary,Severe Learning Difficulty,24,13,11
Hackney,State-funded primary,"Social, Emotional and Mental Health",533,371,162
Hackney,State-funded primary,Specific Learning Difficulty,164,82,82
Hackney,State-funded primary,"Speech, Language and Communications needs",1737,1175,562
Hackney,State-funded primary,Visual Impairment,11,4,7
Hackney,State-funded secondary,Autistic Spectrum Disorder,321,237,84
Hackney,State-funded secondary,Hearing Impairment,55,25,30
Hackney,State-funded secondary,Moderate Learning Difficulty,426,229,197
Hackney,State-funded secondary,Multi- Sensory Impairment,2,1,1
Hackney,State-funded secondary,Other Difficulty/Disability,189,116,73
Hackney,State-funded secondary,Physical Disability,32,15,17
Hackney,State-funded secondary,Profound & Multiple Learning Difficulty,3,2,1
Hackney,State-funded secondary,SEN support but no specialist assessment of type of need,74,28,46
Hackney,State-funded secondary,Severe Learning Difficulty,13,9,4
Hackney,State-funded secondary,"Social, Emotional and Mental Health",635,398,237
Hackney,State-funded secondary,Specific Learning Difficulty,281,143,138
Hackney,State-funded secondary,"Speech, Language and Communications needs",619,398,221
Hackney,State-funded secondary,Visual Impairment,20,11,9
Hackney,State-funded special school,Autistic Spectrum Disorder,278,232,46
Hackney,State-funded special school,Hearing Impairment,2,1,1
Hackney,State-funded special school,Moderate Learning Difficulty,26,18,8
Hackney,State-funded special school,Other Difficulty/Disability,2,2,0
Hackney,State-funded special school,Physical Disability,1,0,1
Hackney,State-funded special school,Profound & Multiple Learning Difficulty,48,29,19
Hackney,State-funded special school,Severe Learning Difficulty,45,25,20
Hackney,State-funded special school,"Social, Emotional and Mental Health",2,2,0
Hackney,State-funded special school,Specific Learning Difficulty,9,8,1
Hackney,State-funded special school,"Speech, Language and Communications needs",63,40,23
Hackney,State-funded special school,Visual Impairment,1,1,0
Hammersmith and Fulham,Non-maintained special school,Moderate Learning Difficulty,9,6,3
Hammersmith and Fulham,Non-maintained special school,Other Difficulty/Disability,1,0,1
Hammersmith and Fulham,Non-maintained special school,Profound & Multiple Learning Difficulty,1,0,1
Hammersmith and Fulham,Non-maintained special school,Severe Learning Difficulty,4,2,2
Hammersmith and Fulham,Non-maintained special school,Specific Learning Difficulty,2,0,2
Hammersmith and Fulham,Non-maintained special school,"Speech, Language and Communications needs",36,22,14
Hammersmith and Fulham,State-funded AP school,Autistic Spectrum Disorder,6,4,2
Hammersmith and Fulham,State-funded AP school,Severe Learning Difficulty,1,0,1
Hammersmith and Fulham,State-funded AP school,"Social, Emotional and Mental Health",51,33,18
Hammersmith and Fulham,State-funded AP school,Specific Learning Difficulty,2,1,1
Hammersmith and Fulham,State-funded AP school,"Speech, Language and Communications needs",2,2,0
Hammersmith and Fulham,State-funded nursery,Autistic Spectrum Disorder,10,4,6
Hammersmith and Fulham,State-funded nursery,Hearing Impairment,1,1,0
Hammersmith and Fulham,State-funded nursery,Moderate Learning Difficulty,1,0,1
Hammersmith and Fulham,State-funded nursery,Other Difficulty/Disability,1,1,0
Hammersmith and Fulham,State-funded nursery,Profound & Multiple Learning Difficulty,1,0,1
Hammersmith and Fulham,State-funded nursery,Severe Learning Difficulty,3,3,0
Hammersmith and Fulham,State-funded nursery,"Speech, Language and Communications needs",58,38,20
Hammersmith and Fulham,State-funded primary,Autistic Spectrum Disorder,244,185,59
Hammersmith and Fulham,State-funded primary,Hearing Impairment,17,9,8
Hammersmith and Fulham,State-funded primary,Moderate Learning Difficulty,130,64,66
Hammersmith and Fulham,State-funded primary,Multi- Sensory Impairment,2,1,1
Hammersmith and Fulham,State-funded primary,Other Difficulty/Disability,51,37,14
Hammersmith and Fulham,State-funded primary,Physical Disability,29,15,14
Hammersmith and Fulham,State-funded primary,Profound & Multiple Learning Difficulty,1,1,0
Hammersmith and Fulham,State-funded primary,SEN support but no specialist assessment of type of need,73,42,31
Hammersmith and Fulham,State-funded primary,Severe Learning Difficulty,6,4,2
Hammersmith and Fulham,State-funded primary,"Social, Emotional and Mental Health",214,136,78
Hammersmith and Fulham,State-funded primary,Specific Learning Difficulty,92,40,52
Hammersmith and Fulham,State-funded primary,"Speech, Language and Communications needs",703,476,227
Hammersmith and Fulham,State-funded primary,Visual Impairment,7,4,3
Hammersmith and Fulham,State-funded secondary,Autistic Spectrum Disorder,136,94,42
Hammersmith and Fulham,State-funded secondary,Hearing Impairment,26,15,11
Hammersmith and Fulham,State-funded secondary,Moderate Learning Difficulty,102,62,40
Hammersmith and Fulham,State-funded secondary,Multi- Sensory Impairment,5,2,3
Hammersmith and Fulham,State-funded secondary,Other Difficulty/Disability,59,27,32
Hammersmith and Fulham,State-funded secondary,Physical Disability,32,16,16
Hammersmith and Fulham,State-funded secondary,SEN support but no specialist assessment of type of need,58,20,38
Hammersmith and Fulham,State-funded secondary,Severe Learning Difficulty,7,2,5
Hammersmith and Fulham,State-funded secondary,"Social, Emotional and Mental Health",223,146,77
Hammersmith and Fulham,State-funded secondary,Specific Learning Difficulty,319,135,184
Hammersmith and Fulham,State-funded secondary,"Speech, Language and Communications needs",257,162,95
Hammersmith and Fulham,State-funded secondary,Visual Impairment,11,6,5
Hammersmith and Fulham,State-funded special school,Autistic Spectrum Disorder,314,259,55
Hammersmith and Fulham,State-funded special school,Hearing Impairment,4,2,2
Hammersmith and Fulham,State-funded special school,Moderate Learning Difficulty,52,34,18
Hammersmith and Fulham,State-funded special school,Other Difficulty/Disability,41,28,13
Hammersmith and Fulham,State-funded special school,Physical Disability,9,7,2
Hammersmith and Fulham,State-funded special school,Profound & Multiple Learning Difficulty,34,14,20
Hammersmith and Fulham,State-funded special school,Severe Learning Difficulty,27,16,11
Hammersmith and Fulham,State-funded special school,"Social, Emotional and Mental Health",28,23,5
Hammersmith and Fulham,State-funded special school,Specific Learning Difficulty,5,3,2
Hammersmith and Fulham,State-funded special school,"Speech, Language and Communications needs",47,32,15
Hammersmith and Fulham,State-funded special school,Visual Impairment,3,2,1
Haringey,Non-maintained special school,Autistic Spectrum Disorder,100,85,15
Haringey,State-funded AP school,Autistic Spectrum Disorder,1,1,0
Haringey,State-funded AP school,Hearing Impairment,1,1,0
Haringey,State-funded AP school,Moderate Learning Difficulty,1,1,0
Haringey,State-funded AP school,Other Difficulty/Disability,1,1,0
Haringey,State-funded AP school,SEN support but no specialist assessment of type of need,23,10,13
Haringey,State-funded AP school,"Social, Emotional and Mental Health",18,11,7
Haringey,State-funded AP school,Specific Learning Difficulty,4,3,1
Haringey,State-funded AP school,"Speech, Language and Communications needs",1,1,0
Haringey,State-funded nursery,Autistic Spectrum Disorder,6,4,2
Haringey,State-funded nursery,Hearing Impairment,2,0,2
Haringey,State-funded nursery,Other Difficulty/Disability,1,1,0
Haringey,State-funded nursery,Physical Disability,3,1,2
Haringey,State-funded nursery,"Social, Emotional and Mental Health",1,0,1
Haringey,State-funded nursery,Specific Learning Difficulty,1,0,1
Haringey,State-funded nursery,"Speech, Language and Communications needs",76,49,27
Haringey,State-funded primary,Autistic Spectrum Disorder,622,469,153
Haringey,State-funded primary,Hearing Impairment,35,16,19
Haringey,State-funded primary,Moderate Learning Difficulty,274,154,120
Haringey,State-funded primary,Multi- Sensory Impairment,7,7,0
Haringey,State-funded primary,Other Difficulty/Disability,94,60,34
Haringey,State-funded primary,Physical Disability,51,28,23
Haringey,State-funded primary,Profound & Multiple Learning Difficulty,4,1,3
Haringey,State-funded primary,SEN support but no specialist assessment of type of need,105,62,43
Haringey,State-funded primary,Severe Learning Difficulty,17,10,7
Haringey,State-funded primary,"Social, Emotional and Mental Health",406,285,121
Haringey,State-funded primary,Specific Learning Difficulty,313,187,126
Haringey,State-funded primary,"Speech, Language and Communications needs",1340,919,421
Haringey,State-funded primary,Visual Impairment,19,10,9
Haringey,State-funded secondary,Autistic Spectrum Disorder,287,209,78
Haringey,State-funded secondary,Hearing Impairment,38,21,17
Haringey,State-funded secondary,Moderate Learning Difficulty,353,203,150
Haringey,State-funded secondary,Multi- Sensory Impairment,5,4,1
Haringey,State-funded secondary,Other Difficulty/Disability,174,100,74
Haringey,State-funded secondary,Physical Disability,40,28,12
Haringey,State-funded secondary,Profound & Multiple Learning Difficulty,4,3,1
Haringey,State-funded secondary,SEN support but no specialist assessment of type of need,57,31,26
Haringey,State-funded secondary,Severe Learning Difficulty,6,4,2
Haringey,State-funded secondary,"Social, Emotional and Mental Health",496,291,205
Haringey,State-funded secondary,Specific Learning Difficulty,616,342,274
Haringey,State-funded secondary,"Speech, Language and Communications needs",456,326,130
Haringey,State-funded secondary,Visual Impairment,32,20,12
Haringey,State-funded special school,Autistic Spectrum Disorder,307,241,66
Haringey,State-funded special school,Hearing Impairment,65,30,35
Haringey,State-funded special school,Moderate Learning Difficulty,33,22,11
Haringey,State-funded special school,Other Difficulty/Disability,47,29,18
Haringey,State-funded special school,Physical Disability,15,10,5
Haringey,State-funded special school,Profound & Multiple Learning Difficulty,18,8,10
Haringey,State-funded special school,Severe Learning Difficulty,41,26,15
Haringey,State-funded special school,"Social, Emotional and Mental Health",10,7,3
Haringey,State-funded special school,Specific Learning Difficulty,27,14,13
Haringey,State-funded special school,"Speech, Language and Communications needs",16,14,2
Haringey,State-funded special school,Visual Impairment,2,1,1
Harrow,State-funded AP school,Autistic Spectrum Disorder,3,3,0
Harrow,State-funded AP school,Hearing Impairment,1,1,0
Harrow,State-funded AP school,Moderate Learning Difficulty,3,3,0
Harrow,State-funded AP school,Other Difficulty/Disability,3,1,2
Harrow,State-funded AP school,Physical Disability,3,2,1
Harrow,State-funded AP school,"Social, Emotional and Mental Health",21,19,2
Harrow,State-funded AP school,Specific Learning Difficulty,1,0,1
Harrow,State-funded AP school,"Speech, Language and Communications needs",2,2,0
Harrow,State-funded nursery,Multi- Sensory Impairment,1,0,1
Harrow,State-funded nursery,Profound & Multiple Learning Difficulty,2,2,0
Harrow,State-funded nursery,Specific Learning Difficulty,1,1,0
Harrow,State-funded primary,Autistic Spectrum Disorder,307,243,64
Harrow,State-funded primary,Hearing Impairment,63,34,29
Harrow,State-funded primary,Moderate Learning Difficulty,265,160,105
Harrow,State-funded primary,Multi- Sensory Impairment,13,4,9
Harrow,State-funded primary,Other Difficulty/Disability,83,58,25
Harrow,State-funded primary,Physical Disability,65,37,28
Harrow,State-funded primary,Profound & Multiple Learning Difficulty,3,1,2
Harrow,State-funded primary,SEN support but no specialist assessment of type of need,157,97,60
Harrow,State-funded primary,Severe Learning Difficulty,12,9,3
Harrow,State-funded primary,"Social, Emotional and Mental Health",332,220,112
Harrow,State-funded primary,Specific Learning Difficulty,127,70,57
Harrow,State-funded primary,"Speech, Language and Communications needs",1356,997,359
Harrow,State-funded primary,Visual Impairment,19,11,8
Harrow,State-funded secondary,Autistic Spectrum Disorder,232,171,61
Harrow,State-funded secondary,Hearing Impairment,53,30,23
Harrow,State-funded secondary,Moderate Learning Difficulty,352,209,143
Harrow,State-funded secondary,Multi- Sensory Impairment,3,3,0
Harrow,State-funded secondary,Other Difficulty/Disability,165,100,65
Harrow,State-funded secondary,Physical Disability,54,30,24
Harrow,State-funded secondary,SEN support but no specialist assessment of type of need,144,58,86
Harrow,State-funded secondary,Severe Learning Difficulty,5,3,2
Harrow,State-funded secondary,"Social, Emotional and Mental Health",418,271,147
Harrow,State-funded secondary,Specific Learning Difficulty,161,66,95
Harrow,State-funded secondary,"Speech, Language and Communications needs",382,261,121
Harrow,State-funded secondary,Visual Impairment,33,22,11
Harrow,State-funded special school,Autistic Spectrum Disorder,139,114,25
Harrow,State-funded special school,Hearing Impairment,1,1,0
Harrow,State-funded special school,Moderate Learning Difficulty,56,22,34
Harrow,State-funded special school,Multi- Sensory Impairment,2,0,2
Harrow,State-funded special school,Other Difficulty/Disability,15,8,7
Harrow,State-funded special school,Physical Disability,7,5,2
Harrow,State-funded special school,Profound & Multiple Learning Difficulty,45,25,20
Harrow,State-funded special school,Severe Learning Difficulty,177,125,52
Harrow,State-funded special school,Specific Learning Difficulty,6,6,0
Harrow,State-funded special school,"Speech, Language and Communications needs",55,37,18
Harrow,State-funded special school,Visual Impairment,3,1,2
Havering,State-funded AP school,Autistic Spectrum Disorder,1,1,0
Havering,State-funded AP school,Moderate Learning Difficulty,1,1,0
Havering,State-funded AP school,"Social, Emotional and Mental Health",6,4,2
Havering,State-funded AP school,"Speech, Language and Communications needs",1,1,0
Havering,State-funded primary,Autistic Spectrum Disorder,318,246,72
Havering,State-funded primary,Hearing Impairment,49,26,23
Havering,State-funded primary,Moderate Learning Difficulty,729,422,307
Havering,State-funded primary,Multi- Sensory Impairment,5,3,2
Havering,State-funded primary,Other Difficulty/Disability,54,38,16
Havering,State-funded primary,Physical Disability,50,30,20
Havering,State-funded primary,Profound & Multiple Learning Difficulty,9,6,3
Havering,State-funded primary,SEN support but no specialist assessment of type of need,21,10,11
Havering,State-funded primary,Severe Learning Difficulty,26,16,10
Havering,State-funded primary,"Social, Emotional and Mental Health",353,256,97
Havering,State-funded primary,Specific Learning Difficulty,148,94,54
Havering,State-funded primary,"Speech, Language and Communications needs",1208,869,339
Havering,State-funded primary,Visual Impairment,24,14,10
Havering,State-funded secondary,Autistic Spectrum Disorder,184,145,39
Havering,State-funded secondary,Hearing Impairment,32,17,15
Havering,State-funded secondary,Moderate Learning Difficulty,494,304,190
Havering,State-funded secondary,Multi- Sensory Impairment,6,4,2
Havering,State-funded secondary,Other Difficulty/Disability,103,57,46
Havering,State-funded secondary,Physical Disability,48,24,24
Havering,State-funded secondary,Profound & Multiple Learning Difficulty,2,0,2
Havering,State-funded secondary,SEN support but no specialist assessment of type of need,56,38,18
Havering,State-funded secondary,Severe Learning Difficulty,8,4,4
Havering,State-funded secondary,"Social, Emotional and Mental Health",517,308,209
Havering,State-funded secondary,Specific Learning Difficulty,144,92,52
Havering,State-funded secondary,"Speech, Language and Communications needs",317,220,97
Havering,State-funded secondary,Visual Impairment,16,6,10
Havering,State-funded special school,Autistic Spectrum Disorder,58,46,12
Havering,State-funded special school,Hearing Impairment,2,2,0
Havering,State-funded special school,Moderate Learning Difficulty,16,10,6
Havering,State-funded special school,Multi- Sensory Impairment,1,1,0
Havering,State-funded special school,Other Difficulty/Disability,7,3,4
Havering,State-funded special school,Physical Disability,8,7,1
Havering,State-funded special school,Profound & Multiple Learning Difficulty,48,26,22
Havering,State-funded special school,Severe Learning Difficulty,155,102,53
Havering,State-funded special school,"Social, Emotional and Mental Health",13,11,2
Havering,State-funded special school,Specific Learning Difficulty,16,7,9
Havering,State-funded special school,"Speech, Language and Communications needs",36,32,4
Havering,State-funded special school,Visual Impairment,4,1,3
Hillingdon,Non-maintained special school,Autistic Spectrum Disorder,42,35,7
Hillingdon,Non-maintained special school,Moderate Learning Difficulty,10,8,2
Hillingdon,Non-maintained special school,Other Difficulty/Disability,2,2,0
Hillingdon,Non-maintained special school,Severe Learning Difficulty,40,25,15
Hillingdon,Non-maintained special school,"Speech, Language and Communications needs",5,2,3
Hillingdon,State-funded AP school,Hearing Impairment,1,1,0
Hillingdon,State-funded AP school,Moderate Learning Difficulty,1,1,0
Hillingdon,State-funded AP school,SEN support but no specialist assessment of type of need,1,1,0
Hillingdon,State-funded AP school,"Social, Emotional and Mental Health",14,9,5
Hillingdon,State-funded nursery,Autistic Spectrum Disorder,6,4,2
Hillingdon,State-funded nursery,Hearing Impairment,1,0,1
Hillingdon,State-funded nursery,Physical Disability,1,0,1
Hillingdon,State-funded nursery,"Social, Emotional and Mental Health",2,2,0
Hillingdon,State-funded nursery,Specific Learning Difficulty,1,1,0
Hillingdon,State-funded nursery,"Speech, Language and Communications needs",7,5,2
Hillingdon,State-funded primary,Autistic Spectrum Disorder,850,616,234
Hillingdon,State-funded primary,Hearing Impairment,59,38,21
Hillingdon,State-funded primary,Moderate Learning Difficulty,217,138,79
Hillingdon,State-funded primary,Multi- Sensory Impairment,16,11,5
Hillingdon,State-funded primary,Other Difficulty/Disability,236,154,82
Hillingdon,State-funded primary,Physical Disability,94,60,34
Hillingdon,State-funded primary,Profound & Multiple Learning Difficulty,4,1,3
Hillingdon,State-funded primary,SEN support but no specialist assessment of type of need,265,155,110
Hillingdon,State-funded primary,Severe Learning Difficulty,15,13,2
Hillingdon,State-funded primary,"Social, Emotional and Mental Health",494,321,173
Hillingdon,State-funded primary,Specific Learning Difficulty,246,119,127
Hillingdon,State-funded primary,"Speech, Language and Communications needs",1943,1352,591
Hillingdon,State-funded primary,Visual Impairment,22,12,10
Hillingdon,State-funded secondary,Autistic Spectrum Disorder,550,395,155
Hillingdon,State-funded secondary,Hearing Impairment,81,42,39
Hillingdon,State-funded secondary,Moderate Learning Difficulty,241,143,98
Hillingdon,State-funded secondary,Multi- Sensory Impairment,1,1,0
Hillingdon,State-funded secondary,Other Difficulty/Disability,235,145,90
Hillingdon,State-funded secondary,Physical Disability,79,46,33
Hillingdon,State-funded secondary,Profound & Multiple Learning Difficulty,1,0,1
Hillingdon,State-funded secondary,SEN support but no specialist assessment of type of need,122,75,47
Hillingdon,State-funded secondary,Severe Learning Difficulty,6,1,5
Hillingdon,State-funded secondary,"Social, Emotional and Mental Health",378,218,160
Hillingdon,State-funded secondary,Specific Learning Difficulty,387,225,162
Hillingdon,State-funded secondary,"Speech, Language and Communications needs",539,345,194
Hillingdon,State-funded secondary,Visual Impairment,32,15,17
Hillingdon,State-funded special school,Autistic Spectrum Disorder,409,323,86
Hillingdon,State-funded special school,Hearing Impairment,2,1,1
Hillingdon,State-funded special school,Moderate Learning Difficulty,101,59,42
Hillingdon,State-funded special school,Multi- Sensory Impairment,2,1,1
Hillingdon,State-funded special school,Other Difficulty/Disability,60,39,21
Hillingdon,State-funded special school,Physical Disability,15,9,6
Hillingdon,State-funded special school,Profound & Multiple Learning Difficulty,37,19,18
Hillingdon,State-funded special school,Severe Learning Difficulty,159,110,49
Hillingdon,State-funded special school,"Social, Emotional and Mental Health",93,77,16
Hillingdon,State-funded special school,Specific Learning Difficulty,8,5,3
Hillingdon,State-funded special school,"Speech, Language and Communications needs",69,44,25
Hillingdon,State-funded special school,Visual Impairment,26,16,10
Hounslow,State-funded AP school,Autistic Spectrum Disorder,2,1,1
Hounslow,State-funded AP school,Moderate Learning Difficulty,1,1,0
Hounslow,State-funded AP school,SEN support but no specialist assessment of type of need,7,2,5
Hounslow,State-funded AP school,"Social, Emotional and Mental Health",88,61,27
Hounslow,State-funded AP school,Specific Learning Difficulty,2,2,0
Hounslow,State-funded AP school,"Speech, Language and Communications needs",1,1,0
Hounslow,State-funded primary,Autistic Spectrum Disorder,540,397,143
Hounslow,State-funded primary,Hearing Impairment,57,30,27
Hounslow,State-funded primary,Moderate Learning Difficulty,387,215,172
Hounslow,State-funded primary,Multi- Sensory Impairment,5,3,2
Hounslow,State-funded primary,Other Difficulty/Disability,101,66,35
Hounslow,State-funded primary,Physical Disability,84,49,35
Hounslow,State-funded primary,Profound & Multiple Learning Difficulty,8,6,2
Hounslow,State-funded primary,SEN support but no specialist assessment of type of need,260,159,101
Hounslow,State-funded primary,Severe Learning Difficulty,15,13,2
Hounslow,State-funded primary,"Social, Emotional and Mental Health",706,496,210
Hounslow,State-funded primary,Specific Learning Difficulty,207,111,96
Hounslow,State-funded primary,"Speech, Language and Communications needs",1851,1266,585
Hounslow,State-funded primary,Visual Impairment,27,19,8
Hounslow,State-funded secondary,Autistic Spectrum Disorder,272,204,68
Hounslow,State-funded secondary,Hearing Impairment,70,35,35
Hounslow,State-funded secondary,Moderate Learning Difficulty,331,204,127
Hounslow,State-funded secondary,Multi- Sensory Impairment,5,2,3
Hounslow,State-funded secondary,Other Difficulty/Disability,153,77,76
Hounslow,State-funded secondary,Physical Disability,110,62,48
Hounslow,State-funded secondary,Profound & Multiple Learning Difficulty,1,1,0
Hounslow,State-funded secondary,SEN support but no specialist assessment of type of need,65,40,25
Hounslow,State-funded secondary,Severe Learning Difficulty,2,0,2
Hounslow,State-funded secondary,"Social, Emotional and Mental Health",831,455,376
Hounslow,State-funded secondary,Specific Learning Difficulty,422,225,197
Hounslow,State-funded secondary,"Speech, Language and Communications needs",618,449,169
Hounslow,State-funded secondary,Visual Impairment,29,18,11
Hounslow,State-funded special school,Autistic Spectrum Disorder,541,445,96
Hounslow,State-funded special school,Moderate Learning Difficulty,101,62,39
Hounslow,State-funded special school,Other Difficulty/Disability,6,2,4
Hounslow,State-funded special school,Physical Disability,5,5,0
Hounslow,State-funded special school,Profound & Multiple Learning Difficulty,43,27,16
Hounslow,State-funded special school,Severe Learning Difficulty,129,81,48
Hounslow,State-funded special school,"Social, Emotional and Mental Health",68,60,8
Hounslow,State-funded special school,Specific Learning Difficulty,4,1,3
Hounslow,State-funded special school,"Speech, Language and Communications needs",18,14,4
Hounslow,State-funded special school,Visual Impairment,1,1,0
Islington,State-funded AP school,Autistic Spectrum Disorder,3,3,0
Islington,State-funded AP school,Physical Disability,1,0,1
Islington,State-funded AP school,SEN support but no specialist assessment of type of need,2,0,2
Islington,State-funded AP school,"Social, Emotional and Mental Health",83,55,28
Islington,State-funded nursery,Autistic Spectrum Disorder,9,6,3
Islington,State-funded nursery,Moderate Learning Difficulty,1,1,0
Islington,State-funded nursery,Other Difficulty/Disability,2,2,0
Islington,State-funded nursery,Physical Disability,2,1,1
Islington,State-funded nursery,Profound & Multiple Learning Difficulty,1,1,0
Islington,State-funded nursery,Severe Learning Difficulty,2,0,2
Islington,State-funded nursery,"Speech, Language and Communications needs",19,13,6
Islington,State-funded primary,Autistic Spectrum Disorder,678,496,182
Islington,State-funded primary,Hearing Impairment,81,46,35
Islington,State-funded primary,Moderate Learning Difficulty,127,67,60
Islington,State-funded primary,Multi- Sensory Impairment,5,4,1
Islington,State-funded primary,Other Difficulty/Disability,134,71,63
Islington,State-funded primary,Physical Disability,35,19,16
Islington,State-funded primary,Profound & Multiple Learning Difficulty,4,1,3
Islington,State-funded primary,SEN support but no specialist assessment of type of need,81,47,34
Islington,State-funded primary,Severe Learning Difficulty,11,6,5
Islington,State-funded primary,"Social, Emotional and Mental Health",511,312,199
Islington,State-funded primary,Specific Learning Difficulty,199,112,87
Islington,State-funded primary,"Speech, Language and Communications needs",1024,671,353
Islington,State-funded primary,Visual Impairment,6,3,3
Islington,State-funded secondary,Autistic Spectrum Disorder,244,178,66
Islington,State-funded secondary,Hearing Impairment,32,16,16
Islington,State-funded secondary,Moderate Learning Difficulty,186,84,102
Islington,State-funded secondary,Multi- Sensory Impairment,2,1,1
Islington,State-funded secondary,Other Difficulty/Disability,146,89,57
Islington,State-funded secondary,Physical Disability,54,36,18
Islington,State-funded secondary,Profound & Multiple Learning Difficulty,1,1,0
Islington,State-funded secondary,SEN support but no specialist assessment of type of need,72,11,61
Islington,State-funded secondary,Severe Learning Difficulty,4,3,1
Islington,State-funded secondary,"Social, Emotional and Mental Health",477,283,194
Islington,State-funded secondary,Specific Learning Difficulty,288,153,135
Islington,State-funded secondary,"Speech, Language and Communications needs",306,226,80
Islington,State-funded secondary,Visual Impairment,12,7,5
Islington,State-funded special school,Autistic Spectrum Disorder,338,255,83
Islington,State-funded special school,Moderate Learning Difficulty,29,20,9
Islington,State-funded special school,Other Difficulty/Disability,7,3,4
Islington,State-funded special school,Physical Disability,2,2,0
Islington,State-funded special school,Profound & Multiple Learning Difficulty,53,25,28
Islington,State-funded special school,Severe Learning Difficulty,48,38,10
Islington,State-funded special school,"Social, Emotional and Mental Health",23,13,10
Islington,State-funded special school,Specific Learning Difficulty,50,30,20
Islington,State-funded special school,"Speech, Language and Communications needs",19,12,7
Islington,State-funded special school,Visual Impairment,2,1,1
Kensington and Chelsea,State-funded AP school,Autistic Spectrum Disorder,1,1,0
Kensington and Chelsea,State-funded AP school,Moderate Learning Difficulty,2,2,0
Kensington and Chelsea,State-funded AP school,SEN support but no specialist assessment of type of need,2,1,1
Kensington and Chelsea,State-funded AP school,"Social, Emotional and Mental Health",33,21,12
Kensington and Chelsea,State-funded AP school,Specific Learning Difficulty,4,3,1
Kensington and Chelsea,State-funded AP school,"Speech, Language and Communications needs",2,2,0
Kensington and Chelsea,State-funded nursery,Autistic Spectrum Disorder,11,8,3
Kensington and Chelsea,State-funded nursery,Other Difficulty/Disability,7,4,3
Kensington and Chelsea,State-funded nursery,"Speech, Language and Communications needs",48,31,17
Kensington and Chelsea,State-funded nursery,Visual Impairment,1,0,1
Kensington and Chelsea,State-funded primary,Autistic Spectrum Disorder,260,203,57
Kensington and Chelsea,State-funded primary,Hearing Impairment,12,8,4
Kensington and Chelsea,State-funded primary,Moderate Learning Difficulty,130,69,61
Kensington and Chelsea,State-funded primary,Multi- Sensory Impairment,4,3,1
Kensington and Chelsea,State-funded primary,Other Difficulty/Disability,40,24,16
Kensington and Chelsea,State-funded primary,Physical Disability,22,11,11
Kensington and Chelsea,State-funded primary,Profound & Multiple Learning Difficulty,2,2,0
Kensington and Chelsea,State-funded primary,SEN support but no specialist assessment of type of need,71,44,27
Kensington and Chelsea,State-funded primary,Severe Learning Difficulty,14,9,5
Kensington and Chelsea,State-funded primary,"Social, Emotional and Mental Health",152,109,43
Kensington and Chelsea,State-funded primary,Specific Learning Difficulty,107,67,40
Kensington and Chelsea,State-funded primary,"Speech, Language and Communications needs",391,269,122
Kensington and Chelsea,State-funded primary,Visual Impairment,7,5,2
Kensington and Chelsea,State-funded secondary,Autistic Spectrum Disorder,145,121,24
Kensington and Chelsea,State-funded secondary,Hearing Impairment,16,6,10
Kensington and Chelsea,State-funded secondary,Moderate Learning Difficulty,134,75,59
Kensington and Chelsea,State-funded secondary,Multi- Sensory Impairment,3,3,0
Kensington and Chelsea,State-funded secondary,Other Difficulty/Disability,135,101,34
Kensington and Chelsea,State-funded secondary,Physical Disability,22,15,7
Kensington and Chelsea,State-funded secondary,SEN support but no specialist assessment of type of need,61,30,31
Kensington and Chelsea,State-funded secondary,Severe Learning Difficulty,1,0,1
Kensington and Chelsea,State-funded secondary,"Social, Emotional and Mental Health",223,144,79
Kensington and Chelsea,State-funded secondary,Specific Learning Difficulty,115,63,52
Kensington and Chelsea,State-funded secondary,"Speech, Language and Communications needs",146,98,48
Kensington and Chelsea,State-funded secondary,Visual Impairment,9,8,1
Kensington and Chelsea,State-funded special school,Autistic Spectrum Disorder,132,104,28
Kensington and Chelsea,State-funded special school,Moderate Learning Difficulty,8,4,4
Kensington and Chelsea,State-funded special school,Other Difficulty/Disability,35,23,12
Kensington and Chelsea,State-funded special school,Physical Disability,1,1,0
Kensington and Chelsea,State-funded special school,Severe Learning Difficulty,6,4,2
Kensington and Chelsea,State-funded special school,"Speech, Language and Communications needs",13,7,6
Kingston upon Thames,State-funded AP school,Autistic Spectrum Disorder,22,17,5
Kingston upon Thames,State-funded AP school,Moderate Learning Difficulty,3,0,3
Kingston upon Thames,State-funded AP school,Other Difficulty/Disability,2,1,1
Kingston upon Thames,State-funded AP school,"Social, Emotional and Mental Health",41,26,15
Kingston upon Thames,State-funded AP school,Specific Learning Difficulty,6,3,3
Kingston upon Thames,State-funded AP school,"Speech, Language and Communications needs",8,5,3
Kingston upon Thames,State-funded AP school,Visual Impairment,1,1,0
Kingston upon Thames,State-funded nursery,Autistic Spectrum Disorder,32,26,6
Kingston upon Thames,State-funded nursery,Other Difficulty/Disability,3,2,1
Kingston upon Thames,State-funded nursery,Physical Disability,1,1,0
Kingston upon Thames,State-funded nursery,"Social, Emotional and Mental Health",1,1,0
Kingston upon Thames,State-funded nursery,"Speech, Language and Communications needs",9,5,4
Kingston upon Thames,State-funded primary,Autistic Spectrum Disorder,405,310,95
Kingston upon Thames,State-funded primary,Hearing Impairment,35,18,17
Kingston upon Thames,State-funded primary,Moderate Learning Difficulty,192,113,79
Kingston upon Thames,State-funded primary,Multi- Sensory Impairment,9,4,5
Kingston upon Thames,State-funded primary,Other Difficulty/Disability,55,28,27
Kingston upon Thames,State-funded primary,Physical Disability,42,23,19
Kingston upon Thames,State-funded primary,SEN support but no specialist assessment of type of need,116,74,42
Kingston upon Thames,State-funded primary,Severe Learning Difficulty,6,2,4
Kingston upon Thames,State-funded primary,"Social, Emotional and Mental Health",327,212,115
Kingston upon Thames,State-funded primary,Specific Learning Difficulty,231,121,110
Kingston upon Thames,State-funded primary,"Speech, Language and Communications needs",757,526,231
Kingston upon Thames,State-funded primary,Visual Impairment,8,4,4
Kingston upon Thames,State-funded secondary,Autistic Spectrum Disorder,287,205,82
Kingston upon Thames,State-funded secondary,Hearing Impairment,38,15,23
Kingston upon Thames,State-funded secondary,Moderate Learning Difficulty,102,45,57
Kingston upon Thames,State-funded secondary,Multi- Sensory Impairment,4,2,2
Kingston upon Thames,State-funded secondary,Other Difficulty/Disability,37,23,14
Kingston upon Thames,State-funded secondary,Physical Disability,39,24,15
Kingston upon Thames,State-funded secondary,SEN support but no specialist assessment of type of need,26,16,10
Kingston upon Thames,State-funded secondary,Severe Learning Difficulty,3,2,1
Kingston upon Thames,State-funded secondary,"Social, Emotional and Mental Health",304,245,59
Kingston upon Thames,State-funded secondary,Specific Learning Difficulty,385,231,154
Kingston upon Thames,State-funded secondary,"Speech, Language and Communications needs",151,95,56
Kingston upon Thames,State-funded secondary,Visual Impairment,16,9,7
Kingston upon Thames,State-funded special school,Autistic Spectrum Disorder,162,125,37
Kingston upon Thames,State-funded special school,Moderate Learning Difficulty,94,54,40
Kingston upon Thames,State-funded special school,Multi- Sensory Impairment,2,0,2
Kingston upon Thames,State-funded special school,Other Difficulty/Disability,4,0,4
Kingston upon Thames,State-funded special school,Physical Disability,31,22,9
Kingston upon Thames,State-funded special school,Profound & Multiple Learning Difficulty,75,43,32
Kingston upon Thames,State-funded special school,Severe Learning Difficulty,50,26,24
Kingston upon Thames,State-funded special school,"Social, Emotional and Mental Health",9,5,4
Kingston upon Thames,State-funded special school,Specific Learning Difficulty,6,2,4
Kingston upon Thames,State-funded special school,"Speech, Language and Communications needs",35,23,12
Lambeth,State-funded AP school,Autistic Spectrum Disorder,5,4,1
Lambeth,State-funded AP school,Other Difficulty/Disability,5,5,0
Lambeth,State-funded AP school,"Social, Emotional and Mental Health",20,19,1
Lambeth,State-funded AP school,Specific Learning Difficulty,1,1,0
Lambeth,State-funded AP school,"Speech, Language and Communications needs",6,3,3
Lambeth,State-funded nursery,Autistic Spectrum Disorder,14,11,3
Lambeth,State-funded nursery,Hearing Impairment,1,1,0
Lambeth,State-funded nursery,Moderate Learning Difficulty,1,1,0
Lambeth,State-funded nursery,Other Difficulty/Disability,2,1,1
Lambeth,State-funded nursery,Physical Disability,2,1,1
Lambeth,State-funded nursery,Profound & Multiple Learning Difficulty,3,0,3
Lambeth,State-funded nursery,"Social, Emotional and Mental Health",6,4,2
Lambeth,State-funded nursery,"Speech, Language and Communications needs",73,42,31
Lambeth,State-funded nursery,Visual Impairment,2,1,1
Lambeth,State-funded primary,Autistic Spectrum Disorder,527,396,131
Lambeth,State-funded primary,Hearing Impairment,37,15,22
Lambeth,State-funded primary,Moderate Learning Difficulty,224,124,100
Lambeth,State-funded primary,Multi- Sensory Impairment,12,5,7
Lambeth,State-funded primary,Other Difficulty/Disability,167,109,58
Lambeth,State-funded primary,Physical Disability,55,33,22
Lambeth,State-funded primary,Profound & Multiple Learning Difficulty,8,7,1
Lambeth,State-funded primary,SEN support but no specialist assessment of type of need,187,109,78
Lambeth,State-funded primary,Severe Learning Difficulty,10,9,1
Lambeth,State-funded primary,"Social, Emotional and Mental Health",607,408,199
Lambeth,State-funded primary,Specific Learning Difficulty,294,154,140
Lambeth,State-funded primary,"Speech, Language and Communications needs",1416,948,468
Lambeth,State-funded primary,Visual Impairment,17,9,8
Lambeth,State-funded secondary,Autistic Spectrum Disorder,335,261,74
Lambeth,State-funded secondary,Hearing Impairment,42,27,15
Lambeth,State-funded secondary,Moderate Learning Difficulty,221,132,89
Lambeth,State-funded secondary,Multi- Sensory Impairment,15,10,5
Lambeth,State-funded secondary,Other Difficulty/Disability,162,103,59
Lambeth,State-funded secondary,Physical Disability,60,38,22
Lambeth,State-funded secondary,Profound & Multiple Learning Difficulty,3,1,2
Lambeth,State-funded secondary,SEN support but no specialist assessment of type of need,93,38,55
Lambeth,State-funded secondary,Severe Learning Difficulty,2,1,1
Lambeth,State-funded secondary,"Social, Emotional and Mental Health",628,421,207
Lambeth,State-funded secondary,Specific Learning Difficulty,467,272,195
Lambeth,State-funded secondary,"Speech, Language and Communications needs",651,453,198
Lambeth,State-funded secondary,Visual Impairment,19,9,10
Lambeth,State-funded special school,Autistic Spectrum Disorder,365,291,74
Lambeth,State-funded special school,Moderate Learning Difficulty,34,27,7
Lambeth,State-funded special school,Other Difficulty/Disability,55,38,17
Lambeth,State-funded special school,Physical Disability,1,0,1
Lambeth,State-funded special school,Profound & Multiple Learning Difficulty,49,32,17
Lambeth,State-funded special school,Severe Learning Difficulty,122,79,43
Lambeth,State-funded special school,"Social, Emotional and Mental Health",24,16,8
Lambeth,State-funded special school,Specific Learning Difficulty,16,14,2
Lambeth,State-funded special school,"Speech, Language and Communications needs",29,23,6
Lambeth,State-funded special school,Visual Impairment,3,2,1
Lewisham,State-funded AP school,Other Difficulty/Disability,1,1,0
Lewisham,State-funded AP school,SEN support but no specialist assessment of type of need,2,1,1
Lewisham,State-funded AP school,"Social, Emotional and Mental Health",26,18,8
Lewisham,State-funded AP school,Specific Learning Difficulty,3,1,2
Lewisham,State-funded AP school,"Speech, Language and Communications needs",1,1,0
Lewisham,State-funded nursery,Autistic Spectrum Disorder,7,5,2
Lewisham,State-funded nursery,Hearing Impairment,1,0,1
Lewisham,State-funded nursery,Other Difficulty/Disability,1,1,0
Lewisham,State-funded nursery,Physical Disability,2,0,2
Lewisham,State-funded nursery,SEN support but no specialist assessment of type of need,3,2,1
Lewisham,State-funded nursery,"Speech, Language and Communications needs",38,30,8
Lewisham,State-funded nursery,Visual Impairment,2,1,1
Lewisham,State-funded primary,Autistic Spectrum Disorder,524,400,124
Lewisham,State-funded primary,Hearing Impairment,45,28,17
Lewisham,State-funded primary,Moderate Learning Difficulty,135,76,59
Lewisham,State-funded primary,Multi- Sensory Impairment,7,6,1
Lewisham,State-funded primary,Other Difficulty/Disability,113,67,46
Lewisham,State-funded primary,Physical Disability,61,38,23
Lewisham,State-funded primary,Profound & Multiple Learning Difficulty,8,5,3
Lewisham,State-funded primary,SEN support but no specialist assessment of type of need,330,192,138
Lewisham,State-funded primary,Severe Learning Difficulty,16,10,6
Lewisham,State-funded primary,"Social, Emotional and Mental Health",532,365,167
Lewisham,State-funded primary,Specific Learning Difficulty,416,213,203
Lewisham,State-funded primary,"Speech, Language and Communications needs",1905,1247,658
Lewisham,State-funded primary,Visual Impairment,21,12,9
Lewisham,State-funded secondary,Autistic Spectrum Disorder,397,274,123
Lewisham,State-funded secondary,Hearing Impairment,32,20,12
Lewisham,State-funded secondary,Moderate Learning Difficulty,111,76,35
Lewisham,State-funded secondary,Multi- Sensory Impairment,6,4,2
Lewisham,State-funded secondary,Other Difficulty/Disability,143,98,45
Lewisham,State-funded secondary,Physical Disability,38,22,16
Lewisham,State-funded secondary,Profound & Multiple Learning Difficulty,3,1,2
Lewisham,State-funded secondary,SEN support but no specialist assessment of type of need,122,50,72
Lewisham,State-funded secondary,Severe Learning Difficulty,13,8,5
Lewisham,State-funded secondary,"Social, Emotional and Mental Health",417,235,182
Lewisham,State-funded secondary,Specific Learning Difficulty,527,277,250
Lewisham,State-funded secondary,"Speech, Language and Communications needs",700,469,231
Lewisham,State-funded secondary,Visual Impairment,16,8,8
Lewisham,State-funded special school,Autistic Spectrum Disorder,392,315,77
Lewisham,State-funded special school,Hearing Impairment,2,2,0
Lewisham,State-funded special school,Moderate Learning Difficulty,8,6,2
Lewisham,State-funded special school,Physical Disability,4,2,2
Lewisham,State-funded special school,Profound & Multiple Learning Difficulty,8,2,6
Lewisham,State-funded special school,SEN support but no specialist assessment of type of need,2,2,0
Lewisham,State-funded special school,Severe Learning Difficulty,283,195,88
Lewisham,State-funded special school,"Social, Emotional and Mental Health",100,84,16
Lewisham,State-funded special school,Specific Learning Difficulty,6,5,1
Lewisham,State-funded special school,"Speech, Language and Communications needs",49,37,12
Lewisham,State-funded special school,Visual Impairment,1,0,1
Merton,State-funded AP school,"Social, Emotional and Mental Health",39,19,20
Merton,State-funded primary,Autistic Spectrum Disorder,275,209,66
Merton,State-funded primary,Hearing Impairment,27,19,8
Merton,State-funded primary,Moderate Learning Difficulty,177,100,77
Merton,State-funded primary,Multi- Sensory Impairment,9,6,3
Merton,State-funded primary,Other Difficulty/Disability,93,57,36
Merton,State-funded primary,Physical Disability,45,24,21
Merton,State-funded primary,SEN support but no specialist assessment of type of need,229,131,98
Merton,State-funded primary,Severe Learning Difficulty,5,3,2
Merton,State-funded primary,"Social, Emotional and Mental Health",480,333,147
Merton,State-funded primary,Specific Learning Difficulty,259,140,119
Merton,State-funded primary,"Speech, Language and Communications needs",1148,784,364
Merton,State-funded primary,Visual Impairment,12,5,7
Merton,State-funded secondary,Autistic Spectrum Disorder,228,166,62
Merton,State-funded secondary,Hearing Impairment,29,12,17
Merton,State-funded secondary,Moderate Learning Difficulty,91,58,33
Merton,State-funded secondary,Multi- Sensory Impairment,2,1,1
Merton,State-funded secondary,Other Difficulty/Disability,110,66,44
Merton,State-funded secondary,Physical Disability,25,17,8
Merton,State-funded secondary,Profound & Multiple Learning Difficulty,1,0,1
Merton,State-funded secondary,SEN support but no specialist assessment of type of need,47,18,29
Merton,State-funded secondary,Severe Learning Difficulty,2,1,1
Merton,State-funded secondary,"Social, Emotional and Mental Health",571,313,258
Merton,State-funded secondary,Specific Learning Difficulty,497,270,227
Merton,State-funded secondary,"Speech, Language and Communications needs",349,227,122
Merton,State-funded secondary,Visual Impairment,10,3,7
Merton,State-funded special school,Autistic Spectrum Disorder,90,67,23
Merton,State-funded special school,Moderate Learning Difficulty,67,34,33
Merton,State-funded special school,Other Difficulty/Disability,7,5,2
Merton,State-funded special school,Physical Disability,9,4,5
Merton,State-funded special school,Profound & Multiple Learning Difficulty,51,33,18
Merton,State-funded special school,Severe Learning Difficulty,101,71,30
Merton,State-funded special school,"Social, Emotional and Mental Health",72,49,23
Merton,State-funded special school,Specific Learning Difficulty,14,11,3
Merton,State-funded special school,"Speech, Language and Communications needs",87,56,31
Newham,State-funded AP school,Autistic Spectrum Disorder,8,7,1
Newham,State-funded AP school,Profound & Multiple Learning Difficulty,3,2,1
Newham,State-funded AP school,Severe Learning Difficulty,2,2,0
Newham,State-funded AP school,"Social, Emotional and Mental Health",80,60,20
Newham,State-funded AP school,Specific Learning Difficulty,2,2,0
Newham,State-funded AP school,"Speech, Language and Communications needs",3,3,0
Newham,State-funded nursery,Autistic Spectrum Disorder,36,24,12
Newham,State-funded nursery,Hearing Impairment,5,1,4
Newham,State-funded nursery,Other Difficulty/Disability,6,3,3
Newham,State-funded nursery,Physical Disability,4,2,2
Newham,State-funded nursery,Profound & Multiple Learning Difficulty,1,0,1
Newham,State-funded nursery,SEN support but no specialist assessment of type of need,7,3,4
Newham,State-funded nursery,Severe Learning Difficulty,3,2,1
Newham,State-funded nursery,"Social, Emotional and Mental Health",2,0,2
Newham,State-funded nursery,"Speech, Language and Communications needs",178,124,54
Newham,State-funded nursery,Visual Impairment,5,4,1
Newham,State-funded primary,Autistic Spectrum Disorder,1155,869,286
Newham,State-funded primary,Hearing Impairment,65,34,31
Newham,State-funded primary,Moderate Learning Difficulty,330,192,138
Newham,State-funded primary,Multi- Sensory Impairment,7,5,2
Newham,State-funded primary,Other Difficulty/Disability,90,53,37
Newham,State-funded primary,Physical Disability,58,26,32
Newham,State-funded primary,Profound & Multiple Learning Difficulty,90,48,42
Newham,State-funded primary,SEN support but no specialist assessment of type of need,235,156,79
Newham,State-funded primary,Severe Learning Difficulty,54,32,22
Newham,State-funded primary,"Social, Emotional and Mental Health",423,292,131
Newham,State-funded primary,Specific Learning Difficulty,184,102,82
Newham,State-funded primary,"Speech, Language and Communications needs",2126,1494,632
Newham,State-funded primary,Visual Impairment,36,22,14
Newham,State-funded secondary,Autistic Spectrum Disorder,553,453,100
Newham,State-funded secondary,Hearing Impairment,91,46,45
Newham,State-funded secondary,Moderate Learning Difficulty,364,201,163
Newham,State-funded secondary,Multi- Sensory Impairment,5,2,3
Newham,State-funded secondary,Other Difficulty/Disability,188,119,69
Newham,State-funded secondary,Physical Disability,92,44,48
Newham,State-funded secondary,Profound & Multiple Learning Difficulty,40,22,18
Newham,State-funded secondary,SEN support but no specialist assessment of type of need,92,58,34
Newham,State-funded secondary,Severe Learning Difficulty,34,17,17
Newham,State-funded secondary,"Social, Emotional and Mental Health",547,341,206
Newham,State-funded secondary,Specific Learning Difficulty,376,210,166
Newham,State-funded secondary,"Speech, Language and Communications needs",696,464,232
Newham,State-funded secondary,Visual Impairment,44,25,19
Newham,State-funded special school,Autistic Spectrum Disorder,88,67,21
Newham,State-funded special school,Moderate Learning Difficulty,2,2,0
Newham,State-funded special school,Other Difficulty/Disability,8,5,3
Newham,State-funded special school,Physical Disability,1,0,1
Newham,State-funded special school,Profound & Multiple Learning Difficulty,33,23,10
Newham,State-funded special school,Severe Learning Difficulty,14,10,4
Newham,State-funded special school,"Social, Emotional and Mental Health",72,58,14
Newham,State-funded special school,Specific Learning Difficulty,4,2,2
Newham,State-funded special school,"Speech, Language and Communications needs",5,5,0
Newham,State-funded special school,Visual Impairment,1,1,0
Redbridge,State-funded AP school,Autistic Spectrum Disorder,4,3,1
Redbridge,State-funded AP school,Moderate Learning Difficulty,1,1,0
Redbridge,State-funded AP school,SEN support but no specialist assessment of type of need,18,11,7
Redbridge,State-funded AP school,Severe Learning Difficulty,1,0,1
Redbridge,State-funded AP school,"Social, Emotional and Mental Health",18,12,6
Redbridge,State-funded AP school,Specific Learning Difficulty,4,2,2
Redbridge,State-funded AP school,"Speech, Language and Communications needs",3,2,1
Redbridge,State-funded primary,Autistic Spectrum Disorder,435,342,93
Redbridge,State-funded primary,Hearing Impairment,75,44,31
Redbridge,State-funded primary,Moderate Learning Difficulty,419,256,163
Redbridge,State-funded primary,Multi- Sensory Impairment,7,2,5
Redbridge,State-funded primary,Other Difficulty/Disability,42,29,13
Redbridge,State-funded primary,Physical Disability,94,65,29
Redbridge,State-funded primary,Profound & Multiple Learning Difficulty,8,6,2
Redbridge,State-funded primary,SEN support but no specialist assessment of type of need,103,65,38
Redbridge,State-funded primary,Severe Learning Difficulty,11,9,2
Redbridge,State-funded primary,"Social, Emotional and Mental Health",645,454,191
Redbridge,State-funded primary,Specific Learning Difficulty,243,124,119
Redbridge,State-funded primary,"Speech, Language and Communications needs",1688,1186,502
Redbridge,State-funded primary,Visual Impairment,28,12,16
Redbridge,State-funded secondary,Autistic Spectrum Disorder,281,207,74
Redbridge,State-funded secondary,Hearing Impairment,76,34,42
Redbridge,State-funded secondary,Moderate Learning Difficulty,728,439,289
Redbridge,State-funded secondary,Multi- Sensory Impairment,2,2,0
Redbridge,State-funded secondary,Other Difficulty/Disability,133,71,62
Redbridge,State-funded secondary,Physical Disability,96,52,44
Redbridge,State-funded secondary,Profound & Multiple Learning Difficulty,5,4,1
Redbridge,State-funded secondary,SEN support but no specialist assessment of type of need,81,51,30
Redbridge,State-funded secondary,Severe Learning Difficulty,11,10,1
Redbridge,State-funded secondary,"Social, Emotional and Mental Health",685,417,268
Redbridge,State-funded secondary,Specific Learning Difficulty,436,252,184
Redbridge,State-funded secondary,"Speech, Language and Communications needs",796,546,250
Redbridge,State-funded secondary,Visual Impairment,49,27,22
Redbridge,State-funded special school,Autistic Spectrum Disorder,260,213,47
Redbridge,State-funded special school,Hearing Impairment,1,1,0
Redbridge,State-funded special school,Moderate Learning Difficulty,18,12,6
Redbridge,State-funded special school,Multi- Sensory Impairment,1,0,1
Redbridge,State-funded special school,Other Difficulty/Disability,17,10,7
Redbridge,State-funded special school,Physical Disability,7,3,4
Redbridge,State-funded special school,Profound & Multiple Learning Difficulty,97,56,41
Redbridge,State-funded special school,SEN support but no specialist assessment of type of need,3,2,1
Redbridge,State-funded special school,Severe Learning Difficulty,63,39,24
Redbridge,State-funded special school,"Social, Emotional and Mental Health",61,57,4
Redbridge,State-funded special school,Specific Learning Difficulty,20,11,9
Redbridge,State-funded special school,"Speech, Language and Communications needs",103,82,21
Redbridge,State-funded special school,Visual Impairment,2,1,1
Richmond upon Thames,State-funded primary,Autistic Spectrum Disorder,412,324,88
Richmond upon Thames,State-funded primary,Hearing Impairment,13,8,5
Richmond upon Thames,State-funded primary,Moderate Learning Difficulty,89,60,29
Richmond upon Thames,State-funded primary,Multi- Sensory Impairment,6,5,1
Richmond upon Thames,State-funded primary,Other Difficulty/Disability,51,35,16
Richmond upon Thames,State-funded primary,Physical Disability,39,20,19
Richmond upon Thames,State-funded primary,Profound & Multiple Learning Difficulty,3,2,1
Richmond upon Thames,State-funded primary,SEN support but no specialist assessment of type of need,249,146,103
Richmond upon Thames,State-funded primary,Severe Learning Difficulty,2,1,1
Richmond upon Thames,State-funded primary,"Social, Emotional and Mental Health",357,240,117
Richmond upon Thames,State-funded primary,Specific Learning Difficulty,263,148,115
Richmond upon Thames,State-funded primary,"Speech, Language and Communications needs",511,367,144
Richmond upon Thames,State-funded primary,Visual Impairment,18,11,7
Richmond upon Thames,State-funded secondary,Autistic Spectrum Disorder,198,150,48
Richmond upon Thames,State-funded secondary,Hearing Impairment,20,8,12
Richmond upon Thames,State-funded secondary,Moderate Learning Difficulty,114,59,55
Richmond upon Thames,State-funded secondary,Multi- Sensory Impairment,19,12,7
Richmond upon Thames,State-funded secondary,Other Difficulty/Disability,48,28,20
Richmond upon Thames,State-funded secondary,Physical Disability,34,21,13
Richmond upon Thames,State-funded secondary,Profound & Multiple Learning Difficulty,2,2,0
Richmond upon Thames,State-funded secondary,SEN support but no specialist assessment of type of need,62,34,28
Richmond upon Thames,State-funded secondary,Severe Learning Difficulty,3,3,0
Richmond upon Thames,State-funded secondary,"Social, Emotional and Mental Health",501,322,179
Richmond upon Thames,State-funded secondary,Specific Learning Difficulty,554,316,238
Richmond upon Thames,State-funded secondary,"Speech, Language and Communications needs",203,147,56
Richmond upon Thames,State-funded secondary,Visual Impairment,17,8,9
Richmond upon Thames,State-funded special school,Autistic Spectrum Disorder,115,81,34
Richmond upon Thames,State-funded special school,Hearing Impairment,1,1,0
Richmond upon Thames,State-funded special school,Moderate Learning Difficulty,142,102,40
Richmond upon Thames,State-funded special school,Multi- Sensory Impairment,1,1,0
Richmond upon Thames,State-funded special school,Other Difficulty/Disability,2,0,2
Richmond upon Thames,State-funded special school,Physical Disability,2,2,0
Richmond upon Thames,State-funded special school,Profound & Multiple Learning Difficulty,2,2,0
Richmond upon Thames,State-funded special school,Severe Learning Difficulty,23,12,11
Richmond upon Thames,State-funded special school,"Social, Emotional and Mental Health",7,5,2
Richmond upon Thames,State-funded special school,Specific Learning Difficulty,7,4,3
Richmond upon Thames,State-funded special school,"Speech, Language and Communications needs",31,22,9
Southwark,State-funded AP school,"Social, Emotional and Mental Health",45,26,19
Southwark,State-funded nursery,Autistic Spectrum Disorder,35,23,12
Southwark,State-funded nursery,Moderate Learning Difficulty,4,3,1
Southwark,State-funded nursery,Other Difficulty/Disability,8,4,4
Southwark,State-funded nursery,Physical Disability,4,3,1
Southwark,State-funded nursery,Profound & Multiple Learning Difficulty,1,1,0
Southwark,State-funded nursery,SEN support but no specialist assessment of type of need,4,3,1
Southwark,State-funded nursery,"Social, Emotional and Mental Health",52,26,26
Southwark,State-funded nursery,Specific Learning Difficulty,1,1,0
Southwark,State-funded nursery,"Speech, Language and Communications needs",98,56,42
Southwark,State-funded primary,Autistic Spectrum Disorder,862,642,220
Southwark,State-funded primary,Hearing Impairment,52,26,26
Southwark,State-funded primary,Moderate Learning Difficulty,255,140,115
Southwark,State-funded primary,Multi- Sensory Impairment,3,2,1
Southwark,State-funded primary,Other Difficulty/Disability,94,69,25
Southwark,State-funded primary,Physical Disability,70,30,40
Southwark,State-funded primary,Profound & Multiple Learning Difficulty,9,4,5
Southwark,State-funded primary,SEN support but no specialist assessment of type of need,233,151,82
Southwark,State-funded primary,Severe Learning Difficulty,16,8,8
Southwark,State-funded primary,"Social, Emotional and Mental Health",513,349,164
Southwark,State-funded primary,Specific Learning Difficulty,360,201,159
Southwark,State-funded primary,"Speech, Language and Communications needs",1483,1045,438
Southwark,State-funded primary,Visual Impairment,22,14,8
Southwark,State-funded secondary,Autistic Spectrum Disorder,498,374,124
Southwark,State-funded secondary,Hearing Impairment,46,23,23
Southwark,State-funded secondary,Moderate Learning Difficulty,283,177,106
Southwark,State-funded secondary,Multi- Sensory Impairment,5,2,3
Southwark,State-funded secondary,Other Difficulty/Disability,384,187,197
Southwark,State-funded secondary,Physical Disability,55,42,13
Southwark,State-funded secondary,Profound & Multiple Learning Difficulty,3,2,1
Southwark,State-funded secondary,SEN support but no specialist assessment of type of need,115,65,50
Southwark,State-funded secondary,Severe Learning Difficulty,10,5,5
Southwark,State-funded secondary,"Social, Emotional and Mental Health",672,385,287
Southwark,State-funded secondary,Specific Learning Difficulty,623,312,311
Southwark,State-funded secondary,"Speech, Language and Communications needs",558,374,184
Southwark,State-funded secondary,Visual Impairment,31,18,13
Southwark,State-funded special school,Autistic Spectrum Disorder,349,275,74
Southwark,State-funded special school,Hearing Impairment,1,0,1
Southwark,State-funded special school,Moderate Learning Difficulty,11,9,2
Southwark,State-funded special school,Other Difficulty/Disability,22,13,9
Southwark,State-funded special school,Physical Disability,28,16,12
Southwark,State-funded special school,Profound & Multiple Learning Difficulty,50,29,21
Southwark,State-funded special school,Severe Learning Difficulty,106,75,31
Southwark,State-funded special school,"Social, Emotional and Mental Health",67,60,7
Southwark,State-funded special school,Specific Learning Difficulty,26,16,10
Southwark,State-funded special school,"Speech, Language and Communications needs",34,29,5
Southwark,State-funded special school,Visual Impairment,2,2,0
Sutton,State-funded AP school,Autistic Spectrum Disorder,1,1,0
Sutton,State-funded AP school,Other Difficulty/Disability,1,0,1
Sutton,State-funded AP school,SEN support but no specialist assessment of type of need,1,1,0
Sutton,State-funded AP school,"Social, Emotional and Mental Health",99,63,36
Sutton,State-funded AP school,"Speech, Language and Communications needs",6,3,3
Sutton,State-funded nursery,Autistic Spectrum Disorder,2,2,0
Sutton,State-funded nursery,"Speech, Language and Communications needs",24,18,6
Sutton,State-funded primary,Autistic Spectrum Disorder,454,346,108
Sutton,State-funded primary,Hearing Impairment,37,18,19
Sutton,State-funded primary,Moderate Learning Difficulty,229,128,101
Sutton,State-funded primary,Multi- Sensory Impairment,28,20,8
Sutton,State-funded primary,Other Difficulty/Disability,87,60,27
Sutton,State-funded primary,Physical Disability,47,26,21
Sutton,State-funded primary,Profound & Multiple Learning Difficulty,2,1,1
Sutton,State-funded primary,SEN support but no specialist assessment of type of need,94,56,38
Sutton,State-funded primary,Severe Learning Difficulty,12,7,5
Sutton,State-funded primary,"Social, Emotional and Mental Health",419,297,122
Sutton,State-funded primary,Specific Learning Difficulty,263,164,99
Sutton,State-funded primary,"Speech, Language and Communications needs",1027,693,334
Sutton,State-funded primary,Visual Impairment,29,18,11
Sutton,State-funded secondary,Autistic Spectrum Disorder,380,271,109
Sutton,State-funded secondary,Hearing Impairment,50,22,28
Sutton,State-funded secondary,Moderate Learning Difficulty,283,175,108
Sutton,State-funded secondary,Multi- Sensory Impairment,1,0,1
Sutton,State-funded secondary,Other Difficulty/Disability,103,34,69
Sutton,State-funded secondary,Physical Disability,49,20,29
Sutton,State-funded secondary,SEN support but no specialist assessment of type of need,38,24,14
Sutton,State-funded secondary,Severe Learning Difficulty,1,1,0
Sutton,State-funded secondary,"Social, Emotional and Mental Health",450,261,189
Sutton,State-funded secondary,Specific Learning Difficulty,456,177,279
Sutton,State-funded secondary,"Speech, Language and Communications needs",213,129,84
Sutton,State-funded secondary,Visual Impairment,27,11,16
Sutton,State-funded special school,Autistic Spectrum Disorder,293,239,54
Sutton,State-funded special school,Hearing Impairment,2,2,0
Sutton,State-funded special school,Moderate Learning Difficulty,116,84,32
Sutton,State-funded special school,Other Difficulty/Disability,10,5,5
Sutton,State-funded special school,Profound & Multiple Learning Difficulty,42,28,14
Sutton,State-funded special school,Severe Learning Difficulty,38,22,16
Sutton,State-funded special school,"Social, Emotional and Mental Health",79,70,9
Sutton,State-funded special school,Specific Learning Difficulty,16,11,5
Sutton,State-funded special school,"Speech, Language and Communications needs",46,27,19
Sutton,State-funded special school,Visual Impairment,1,1,0
Tower Hamlets,State-funded AP school,Autistic Spectrum Disorder,2,2,0
Tower Hamlets,State-funded AP school,Moderate Learning Difficulty,1,0,1
Tower Hamlets,State-funded AP school,Physical Disability,1,1,0
Tower Hamlets,State-funded AP school,"Social, Emotional and Mental Health",93,55,38
Tower Hamlets,State-funded AP school,Specific Learning Difficulty,3,3,0
Tower Hamlets,State-funded AP school,"Speech, Language and Communications needs",1,1,0
Tower Hamlets,State-funded nursery,Autistic Spectrum Disorder,1,0,1
Tower Hamlets,State-funded nursery,Hearing Impairment,8,2,6
Tower Hamlets,State-funded nursery,Moderate Learning Difficulty,2,1,1
Tower Hamlets,State-funded nursery,Physical Disability,2,0,2
Tower Hamlets,State-funded nursery,SEN support but no specialist assessment of type of need,1,1,0
Tower Hamlets,State-funded nursery,Severe Learning Difficulty,1,0,1
Tower Hamlets,State-funded nursery,"Speech, Language and Communications needs",56,41,15
Tower Hamlets,State-funded nursery,Visual Impairment,1,1,0
Tower Hamlets,State-funded primary,Autistic Spectrum Disorder,539,411,128
Tower Hamlets,State-funded primary,Hearing Impairment,93,49,44
Tower Hamlets,State-funded primary,Moderate Learning Difficulty,260,142,118
Tower Hamlets,State-funded primary,Multi- Sensory Impairment,9,5,4
Tower Hamlets,State-funded primary,Other Difficulty/Disability,99,55,44
Tower Hamlets,State-funded primary,Physical Disability,80,52,28
Tower Hamlets,State-funded primary,Profound & Multiple Learning Difficulty,19,12,7
Tower Hamlets,State-funded primary,SEN support but no specialist assessment of type of need,175,111,64
Tower Hamlets,State-funded primary,Severe Learning Difficulty,31,20,11
Tower Hamlets,State-funded primary,"Social, Emotional and Mental Health",701,467,234
Tower Hamlets,State-funded primary,Specific Learning Difficulty,188,116,72
Tower Hamlets,State-funded primary,"Speech, Language and Communications needs",2461,1698,763
Tower Hamlets,State-funded primary,Visual Impairment,33,15,18
Tower Hamlets,State-funded secondary,Autistic Spectrum Disorder,275,228,47
Tower Hamlets,State-funded secondary,Hearing Impairment,92,49,43
Tower Hamlets,State-funded secondary,Moderate Learning Difficulty,274,123,151
Tower Hamlets,State-funded secondary,Multi- Sensory Impairment,4,2,2
Tower Hamlets,State-funded secondary,Other Difficulty/Disability,87,45,42
Tower Hamlets,State-funded secondary,Physical Disability,64,40,24
Tower Hamlets,State-funded secondary,Profound & Multiple Learning Difficulty,5,3,2
Tower Hamlets,State-funded secondary,SEN support but no specialist assessment of type of need,154,104,50
Tower Hamlets,State-funded secondary,Severe Learning Difficulty,22,10,12
Tower Hamlets,State-funded secondary,"Social, Emotional and Mental Health",712,413,299
Tower Hamlets,State-funded secondary,Specific Learning Difficulty,313,171,142
Tower Hamlets,State-funded secondary,"Speech, Language and Communications needs",952,618,334
Tower Hamlets,State-funded secondary,Visual Impairment,36,20,16
Tower Hamlets,State-funded special school,Autistic Spectrum Disorder,434,358,76
Tower Hamlets,State-funded special school,Hearing Impairment,2,2,0
Tower Hamlets,State-funded special school,Moderate Learning Difficulty,4,2,2
Tower Hamlets,State-funded special school,Other Difficulty/Disability,1,0,1
Tower Hamlets,State-funded special school,Profound & Multiple Learning Difficulty,154,87,67
Tower Hamlets,State-funded special school,Severe Learning Difficulty,51,30,21
Tower Hamlets,State-funded special school,"Social, Emotional and Mental Health",84,83,1
Tower Hamlets,State-funded special school,Specific Learning Difficulty,14,13,1
Tower Hamlets,State-funded special school,"Speech, Language and Communications needs",23,17,6
Tower Hamlets,State-funded special school,Visual Impairment,1,1,0
Waltham Forest,State-funded AP school,Autistic Spectrum Disorder,2,1,1
Waltham Forest,State-funded AP school,Moderate Learning Difficulty,1,1,0
Waltham Forest,State-funded AP school,"Social, Emotional and Mental Health",19,16,3
Waltham Forest,State-funded nursery,Autistic Spectrum Disorder,7,5,2
Waltham Forest,State-funded nursery,Hearing Impairment,2,0,2
Waltham Forest,State-funded nursery,Other Difficulty/Disability,2,2,0
Waltham Forest,State-funded nursery,Physical Disability,1,0,1
Waltham Forest,State-funded nursery,Profound & Multiple Learning Difficulty,1,1,0
Waltham Forest,State-funded nursery,Specific Learning Difficulty,1,1,0
Waltham Forest,State-funded nursery,"Speech, Language and Communications needs",17,9,8
Waltham Forest,State-funded primary,Autistic Spectrum Disorder,552,430,122
Waltham Forest,State-funded primary,Hearing Impairment,64,30,34
Waltham Forest,State-funded primary,Moderate Learning Difficulty,298,177,121
Waltham Forest,State-funded primary,Multi- Sensory Impairment,7,3,4
Waltham Forest,State-funded primary,Other Difficulty/Disability,125,66,59
Waltham Forest,State-funded primary,Physical Disability,72,38,34
Waltham Forest,State-funded primary,Profound & Multiple Learning Difficulty,12,9,3
Waltham Forest,State-funded primary,SEN support but no specialist assessment of type of need,188,109,79
Waltham Forest,State-funded primary,Severe Learning Difficulty,24,16,8
Waltham Forest,State-funded primary,"Social, Emotional and Mental Health",524,338,186
Waltham Forest,State-funded primary,Specific Learning Difficulty,231,138,93
Waltham Forest,State-funded primary,"Speech, Language and Communications needs",1722,1180,542
Waltham Forest,State-funded primary,Visual Impairment,26,17,9
Waltham Forest,State-funded secondary,Autistic Spectrum Disorder,267,197,70
Waltham Forest,State-funded secondary,Hearing Impairment,61,28,33
Waltham Forest,State-funded secondary,Moderate Learning Difficulty,524,336,188
Waltham Forest,State-funded secondary,Other Difficulty/Disability,103,64,39
Waltham Forest,State-funded secondary,Physical Disability,51,34,17
Waltham Forest,State-funded secondary,Profound & Multiple Learning Difficulty,6,4,2
Waltham Forest,State-funded secondary,SEN support but no specialist assessment of type of need,105,60,45
Waltham Forest,State-funded secondary,Severe Learning Difficulty,15,11,4
Waltham Forest,State-funded secondary,"Social, Emotional and Mental Health",530,325,205
Waltham Forest,State-funded secondary,Specific Learning Difficulty,349,204,145
Waltham Forest,State-funded secondary,"Speech, Language and Communications needs",496,325,171
Waltham Forest,State-funded secondary,Visual Impairment,31,23,8
Waltham Forest,State-funded special school,Autistic Spectrum Disorder,363,281,82
Waltham Forest,State-funded special school,Hearing Impairment,2,1,1
Waltham Forest,State-funded special school,Moderate Learning Difficulty,20,13,7
Waltham Forest,State-funded special school,Multi- Sensory Impairment,8,5,3
Waltham Forest,State-funded special school,Other Difficulty/Disability,29,17,12
Waltham Forest,State-funded special school,Physical Disability,37,22,15
Waltham Forest,State-funded special school,Profound & Multiple Learning Difficulty,39,22,17
Waltham Forest,State-funded special school,Severe Learning Difficulty,72,45,27
Waltham Forest,State-funded special school,"Social, Emotional and Mental Health",35,28,7
Waltham Forest,State-funded special school,Specific Learning Difficulty,21,13,8
Waltham Forest,State-funded special school,"Speech, Language and Communications needs",41,27,14
Waltham Forest,State-funded special school,Visual Impairment,83,49,34
Wandsworth,State-funded AP school,Autistic Spectrum Disorder,3,2,1
Wandsworth,State-funded AP school,"Social, Emotional and Mental Health",49,28,21
Wandsworth,State-funded AP school,Specific Learning Difficulty,1,1,0
Wandsworth,State-funded nursery,Autistic Spectrum Disorder,4,4,0
Wandsworth,State-funded nursery,Hearing Impairment,1,1,0
Wandsworth,State-funded nursery,Other Difficulty/Disability,9,6,3
Wandsworth,State-funded nursery,Profound & Multiple Learning Difficulty,1,1,0
Wandsworth,State-funded nursery,"Social, Emotional and Mental Health",3,2,1
Wandsworth,State-funded nursery,"Speech, Language and Communications needs",23,16,7
Wandsworth,State-funded primary,Autistic Spectrum Disorder,307,241,66
Wandsworth,State-funded primary,Hearing Impairment,62,38,24
Wandsworth,State-funded primary,Moderate Learning Difficulty,203,119,84
Wandsworth,State-funded primary,Multi- Sensory Impairment,15,10,5
Wandsworth,State-funded primary,Other Difficulty/Disability,128,76,52
Wandsworth,State-funded primary,Physical Disability,83,48,35
Wandsworth,State-funded primary,Profound & Multiple Learning Difficulty,8,7,1
Wandsworth,State-funded primary,SEN support but no specialist assessment of type of need,207,118,89
Wandsworth,State-funded primary,Severe Learning Difficulty,9,9,0
Wandsworth,State-funded primary,"Social, Emotional and Mental Health",671,464,207
Wandsworth,State-funded primary,Specific Learning Difficulty,255,122,133
Wandsworth,State-funded primary,"Speech, Language and Communications needs",1422,968,454
Wandsworth,State-funded primary,Visual Impairment,20,11,9
Wandsworth,State-funded secondary,Autistic Spectrum Disorder,319,236,83
Wandsworth,State-funded secondary,Hearing Impairment,53,31,22
Wandsworth,State-funded secondary,Moderate Learning Difficulty,124,74,50
Wandsworth,State-funded secondary,Multi- Sensory Impairment,5,5,0
Wandsworth,State-funded secondary,Other Difficulty/Disability,145,82,63
Wandsworth,State-funded secondary,Physical Disability,68,39,29
Wandsworth,State-funded secondary,SEN support but no specialist assessment of type of need,98,27,71
Wandsworth,State-funded secondary,Severe Learning Difficulty,3,2,1
Wandsworth,State-funded secondary,"Social, Emotional and Mental Health",582,338,244
Wandsworth,State-funded secondary,Specific Learning Difficulty,428,243,185
Wandsworth,State-funded secondary,"Speech, Language and Communications needs",399,259,140
Wandsworth,State-funded secondary,Visual Impairment,20,8,12
Wandsworth,State-funded special school,Autistic Spectrum Disorder,217,174,43
Wandsworth,State-funded special school,Hearing Impairment,74,45,29
Wandsworth,State-funded special school,Moderate Learning Difficulty,202,150,52
Wandsworth,State-funded special school,Multi- Sensory Impairment,6,2,4
Wandsworth,State-funded special school,Other Difficulty/Disability,12,8,4
Wandsworth,State-funded special school,Physical Disability,14,5,9
Wandsworth,State-funded special school,Profound & Multiple Learning Difficulty,23,13,10
Wandsworth,State-funded special school,Severe Learning Difficulty,59,41,18
Wandsworth,State-funded special school,"Social, Emotional and Mental Health",120,120,0
Wandsworth,State-funded special school,Specific Learning Difficulty,4,1,3
Wandsworth,State-funded special school,"Speech, Language and Communications needs",45,29,16
Wandsworth,State-funded special school,Visual Impairment,113,67,46
Westminster,State-funded AP school,Moderate Learning Difficulty,1,0,1
Westminster,State-funded AP school,"Social, Emotional and Mental Health",54,42,12
Westminster,State-funded nursery,Autistic Spectrum Disorder,21,17,4
Westminster,State-funded nursery,Other Difficulty/Disability,2,2,0
Westminster,State-funded nursery,Physical Disability,4,2,2
Westminster,State-funded nursery,Profound & Multiple Learning Difficulty,1,1,0
Westminster,State-funded nursery,"Social, Emotional and Mental Health",3,2,1
Westminster,State-funded nursery,"Speech, Language and Communications needs",58,42,16
Westminster,State-funded primary,Autistic Spectrum Disorder,298,233,65
Westminster,State-funded primary,Hearing Impairment,24,14,10
Westminster,State-funded primary,Moderate Learning Difficulty,131,63,68
Westminster,State-funded primary,Multi- Sensory Impairment,8,5,3
Westminster,State-funded primary,Other Difficulty/Disability,35,21,14
Westminster,State-funded primary,Physical Disability,38,19,19
Westminster,State-funded primary,Profound & Multiple Learning Difficulty,5,4,1
Westminster,State-funded primary,SEN support but no specialist assessment of type of need,60,38,22
Westminster,State-funded primary,Severe Learning Difficulty,9,5,4
Westminster,State-funded primary,"Social, Emotional and Mental Health",187,110,77
Westminster,State-funded primary,Specific Learning Difficulty,57,29,28
Westminster,State-funded primary,"Speech, Language and Communications needs",600,417,183
Westminster,State-funded primary,Visual Impairment,7,5,2
Westminster,State-funded secondary,Autistic Spectrum Disorder,185,135,50
Westminster,State-funded secondary,Hearing Impairment,42,19,23
Westminster,State-funded secondary,Moderate Learning Difficulty,212,136,76
Westminster,State-funded secondary,Multi- Sensory Impairment,4,3,1
Westminster,State-funded secondary,Other Difficulty/Disability,85,44,41
Westminster,State-funded secondary,Physical Disability,42,20,22
Westminster,State-funded secondary,Profound & Multiple Learning Difficulty,2,0,2
Westminster,State-funded secondary,SEN support but no specialist assessment of type of need,18,9,9
Westminster,State-funded secondary,Severe Learning Difficulty,7,7,0
Westminster,State-funded secondary,"Social, Emotional and Mental Health",565,290,275
Westminster,State-funded secondary,Specific Learning Difficulty,217,82,135
Westminster,State-funded secondary,"Speech, Language and Communications needs",387,267,120
Westminster,State-funded secondary,Visual Impairment,17,8,9
Westminster,State-funded special school,Autistic Spectrum Disorder,116,86,30
Westminster,State-funded special school,Moderate Learning Difficulty,8,4,4
Westminster,State-funded special school,Other Difficulty/Disability,4,2,2
Westminster,State-funded special school,Profound & Multiple Learning Difficulty,26,14,12
Westminster,State-funded special school,Severe Learning Difficulty,39,17,22
Westminster,State-funded special school,"Social, Emotional and Mental Health",2,1,1
Westminster,State-funded special school,Specific Learning Difficulty,10,5,5
Westminster,State-funded special school,"Speech, Language and Communications needs",41,28,13
Medway,State-funded AP school,"Social, Emotional and Mental Health",32,20,12
Medway,State-funded primary,Autistic Spectrum Disorder,447,319,128
Medway,State-funded primary,Hearing Impairment,56,18,38
Medway,State-funded primary,Moderate Learning Difficulty,341,185,156
Medway,State-funded primary,Multi- Sensory Impairment,40,30,10
Medway,State-funded primary,Other Difficulty/Disability,197,131,66
Medway,State-funded primary,Physical Disability,103,56,47
Medway,State-funded primary,Profound & Multiple Learning Difficulty,4,3,1
Medway,State-funded primary,SEN support but no specialist assessment of type of need,248,153,95
Medway,State-funded primary,Severe Learning Difficulty,12,8,4
Medway,State-funded primary,"Social, Emotional and Mental Health",810,562,248
Medway,State-funded primary,Specific Learning Difficulty,263,161,102
Medway,State-funded primary,"Speech, Language and Communications needs",1852,1302,550
Medway,State-funded primary,Visual Impairment,36,21,15
Medway,State-funded secondary,Autistic Spectrum Disorder,474,364,110
Medway,State-funded secondary,Hearing Impairment,71,32,39
Medway,State-funded secondary,Moderate Learning Difficulty,324,150,174
Medway,State-funded secondary,Multi- Sensory Impairment,27,14,13
Medway,State-funded secondary,Other Difficulty/Disability,196,105,91
Medway,State-funded secondary,Physical Disability,70,26,44
Medway,State-funded secondary,SEN support but no specialist assessment of type of need,64,29,35
Medway,State-funded secondary,Severe Learning Difficulty,8,3,5
Medway,State-funded secondary,"Social, Emotional and Mental Health",826,584,242
Medway,State-funded secondary,Specific Learning Difficulty,534,266,268
Medway,State-funded secondary,"Speech, Language and Communications needs",412,273,139
Medway,State-funded secondary,Visual Impairment,48,27,21
Medway,State-funded special school,Autistic Spectrum Disorder,370,283,87
Medway,State-funded special school,Hearing Impairment,2,1,1
Medway,State-funded special school,Moderate Learning Difficulty,117,64,53
Medway,State-funded special school,Multi- Sensory Impairment,1,0,1
Medway,State-funded special school,Other Difficulty/Disability,26,17,9
Medway,State-funded special school,Physical Disability,24,11,13
Medway,State-funded special school,Profound & Multiple Learning Difficulty,43,26,17
Medway,State-funded special school,Severe Learning Difficulty,182,126,56
Medway,State-funded special school,"Social, Emotional and Mental Health",96,67,29
Medway,State-funded special school,Specific Learning Difficulty,48,25,23
Medway,State-funded special school,"Speech, Language and Communications needs",142,97,45
Medway,State-funded special school,Visual Impairment,1,1,0
Bracknell Forest,State-funded AP school,Autistic Spectrum Disorder,2,2,0
Bracknell Forest,State-funded AP school,Moderate Learning Difficulty,2,1,1
Bracknell Forest,State-funded AP school,"Social, Emotional and Mental Health",12,8,4
Bracknell Forest,State-funded AP school,Specific Learning Difficulty,4,4,0
Bracknell Forest,State-funded AP school,"Speech, Language and Communications needs",1,1,0
Bracknell Forest,State-funded primary,Autistic Spectrum Disorder,237,161,76
Bracknell Forest,State-funded primary,Hearing Impairment,14,11,3
Bracknell Forest,State-funded primary,Moderate Learning Difficulty,125,77,48
Bracknell Forest,State-funded primary,Multi- Sensory Impairment,9,7,2
Bracknell Forest,State-funded primary,Other Difficulty/Disability,33,27,6
Bracknell Forest,State-funded primary,Physical Disability,27,19,8
Bracknell Forest,State-funded primary,Profound & Multiple Learning Difficulty,3,2,1
Bracknell Forest,State-funded primary,SEN support but no specialist assessment of type of need,157,95,62
Bracknell Forest,State-funded primary,Severe Learning Difficulty,5,5,0
Bracknell Forest,State-funded primary,"Social, Emotional and Mental Health",308,216,92
Bracknell Forest,State-funded primary,Specific Learning Difficulty,172,100,72
Bracknell Forest,State-funded primary,"Speech, Language and Communications needs",371,265,106
Bracknell Forest,State-funded primary,Visual Impairment,6,4,2
Bracknell Forest,State-funded secondary,Autistic Spectrum Disorder,329,225,104
Bracknell Forest,State-funded secondary,Hearing Impairment,25,15,10
Bracknell Forest,State-funded secondary,Moderate Learning Difficulty,173,100,73
Bracknell Forest,State-funded secondary,Multi- Sensory Impairment,5,5,0
Bracknell Forest,State-funded secondary,Other Difficulty/Disability,100,56,44
Bracknell Forest,State-funded secondary,Physical Disability,14,8,6
Bracknell Forest,State-funded secondary,SEN support but no specialist assessment of type of need,29,20,9
Bracknell Forest,State-funded secondary,Severe Learning Difficulty,2,1,1
Bracknell Forest,State-funded secondary,"Social, Emotional and Mental Health",262,174,88
Bracknell Forest,State-funded secondary,Specific Learning Difficulty,267,143,124
Bracknell Forest,State-funded secondary,"Speech, Language and Communications needs",120,72,48
Bracknell Forest,State-funded secondary,Visual Impairment,11,4,7
Bracknell Forest,State-funded special school,Moderate Learning Difficulty,6,4,2
Bracknell Forest,State-funded special school,Profound & Multiple Learning Difficulty,4,3,1
Bracknell Forest,State-funded special school,Severe Learning Difficulty,188,139,49
West Berkshire,Non-maintained special school,Hearing Impairment,192,101,91
West Berkshire,Non-maintained special school,Multi- Sensory Impairment,10,7,3
West Berkshire,State-funded AP school,Autistic Spectrum Disorder,13,9,4
West Berkshire,State-funded AP school,Other Difficulty/Disability,2,1,1
West Berkshire,State-funded AP school,"Social, Emotional and Mental Health",20,17,3
West Berkshire,State-funded AP school,Specific Learning Difficulty,6,4,2
West Berkshire,State-funded nursery,Autistic Spectrum Disorder,2,2,0
West Berkshire,State-funded nursery,Hearing Impairment,2,1,1
West Berkshire,State-funded nursery,Other Difficulty/Disability,2,2,0
West Berkshire,State-funded nursery,"Social, Emotional and Mental Health",12,9,3
West Berkshire,State-funded nursery,Specific Learning Difficulty,1,0,1
West Berkshire,State-funded nursery,"Speech, Language and Communications needs",39,28,11
West Berkshire,State-funded primary,Autistic Spectrum Disorder,367,277,90
West Berkshire,State-funded primary,Hearing Impairment,41,21,20
West Berkshire,State-funded primary,Moderate Learning Difficulty,284,171,113
West Berkshire,State-funded primary,Multi- Sensory Impairment,5,2,3
West Berkshire,State-funded primary,Other Difficulty/Disability,60,36,24
West Berkshire,State-funded primary,Physical Disability,57,34,23
West Berkshire,State-funded primary,SEN support but no specialist assessment of type of need,22,17,5
West Berkshire,State-funded primary,Severe Learning Difficulty,40,19,21
West Berkshire,State-funded primary,"Social, Emotional and Mental Health",354,253,101
West Berkshire,State-funded primary,Specific Learning Difficulty,368,208,160
West Berkshire,State-funded primary,"Speech, Language and Communications needs",500,352,148
West Berkshire,State-funded primary,Visual Impairment,12,7,5
West Berkshire,State-funded secondary,Autistic Spectrum Disorder,410,299,111
West Berkshire,State-funded secondary,Hearing Impairment,56,28,28
West Berkshire,State-funded secondary,Moderate Learning Difficulty,60,36,24
West Berkshire,State-funded secondary,Multi- Sensory Impairment,9,5,4
West Berkshire,State-funded secondary,Other Difficulty/Disability,133,76,57
West Berkshire,State-funded secondary,Physical Disability,41,21,20
West Berkshire,State-funded secondary,Profound & Multiple Learning Difficulty,1,1,0
West Berkshire,State-funded secondary,SEN support but no specialist assessment of type of need,23,14,9
West Berkshire,State-funded secondary,Severe Learning Difficulty,6,5,1
West Berkshire,State-funded secondary,"Social, Emotional and Mental Health",315,197,118
West Berkshire,State-funded secondary,Specific Learning Difficulty,597,342,255
West Berkshire,State-funded secondary,"Speech, Language and Communications needs",178,119,59
West Berkshire,State-funded secondary,Visual Impairment,23,14,9
West Berkshire,State-funded special school,Autistic Spectrum Disorder,212,171,41
West Berkshire,State-funded special school,Moderate Learning Difficulty,86,53,33
West Berkshire,State-funded special school,Other Difficulty/Disability,2,1,1
West Berkshire,State-funded special school,Physical Disability,1,0,1
West Berkshire,State-funded special school,Profound & Multiple Learning Difficulty,36,18,18
West Berkshire,State-funded special school,Severe Learning Difficulty,47,26,21
West Berkshire,State-funded special school,"Social, Emotional and Mental Health",6,5,1
West Berkshire,State-funded special school,Specific Learning Difficulty,10,6,4
West Berkshire,State-funded special school,"Speech, Language and Communications needs",11,9,2
West Berkshire,State-funded special school,Visual Impairment,2,2,0
Reading,State-funded AP school,Autistic Spectrum Disorder,5,5,0
Reading,State-funded AP school,SEN support but no specialist assessment of type of need,1,1,0
Reading,State-funded AP school,"Social, Emotional and Mental Health",63,50,13
Reading,State-funded AP school,Specific Learning Difficulty,4,3,1
Reading,State-funded AP school,"Speech, Language and Communications needs",1,1,0
Reading,State-funded nursery,Autistic Spectrum Disorder,6,6,0
Reading,State-funded nursery,Moderate Learning Difficulty,2,2,0
Reading,State-funded nursery,Multi- Sensory Impairment,2,2,0
Reading,State-funded nursery,Other Difficulty/Disability,29,22,7
Reading,State-funded nursery,"Social, Emotional and Mental Health",5,3,2
Reading,State-funded nursery,"Speech, Language and Communications needs",44,29,15
Reading,State-funded primary,Autistic Spectrum Disorder,280,211,69
Reading,State-funded primary,Hearing Impairment,34,16,18
Reading,State-funded primary,Moderate Learning Difficulty,221,117,104
Reading,State-funded primary,Multi- Sensory Impairment,3,1,2
Reading,State-funded primary,Other Difficulty/Disability,94,64,30
Reading,State-funded primary,Physical Disability,51,28,23
Reading,State-funded primary,SEN support but no specialist assessment of type of need,159,109,50
Reading,State-funded primary,Severe Learning Difficulty,9,7,2
Reading,State-funded primary,"Social, Emotional and Mental Health",468,316,152
Reading,State-funded primary,Specific Learning Difficulty,194,111,83
Reading,State-funded primary,"Speech, Language and Communications needs",938,643,295
Reading,State-funded primary,Visual Impairment,16,5,11
Reading,State-funded secondary,Autistic Spectrum Disorder,253,175,78
Reading,State-funded secondary,Hearing Impairment,23,12,11
Reading,State-funded secondary,Moderate Learning Difficulty,94,50,44
Reading,State-funded secondary,Multi- Sensory Impairment,3,2,1
Reading,State-funded secondary,Other Difficulty/Disability,59,45,14
Reading,State-funded secondary,Physical Disability,26,11,15
Reading,State-funded secondary,SEN support but no specialist assessment of type of need,134,54,80
Reading,State-funded secondary,"Social, Emotional and Mental Health",308,174,134
Reading,State-funded secondary,Specific Learning Difficulty,209,117,92
Reading,State-funded secondary,"Speech, Language and Communications needs",110,76,34
Reading,State-funded secondary,Visual Impairment,19,10,9
Reading,State-funded special school,Autistic Spectrum Disorder,125,107,18
Reading,State-funded special school,Hearing Impairment,2,1,1
Reading,State-funded special school,Moderate Learning Difficulty,4,4,0
Reading,State-funded special school,Other Difficulty/Disability,3,2,1
Reading,State-funded special school,Physical Disability,5,4,1
Reading,State-funded special school,Profound & Multiple Learning Difficulty,20,10,10
Reading,State-funded special school,Severe Learning Difficulty,121,84,37
Reading,State-funded special school,"Social, Emotional and Mental Health",57,52,5
Reading,State-funded special school,Specific Learning Difficulty,2,2,0
Reading,State-funded special school,"Speech, Language and Communications needs",4,4,0
Slough,State-funded AP school,Autistic Spectrum Disorder,3,3,0
Slough,State-funded AP school,Moderate Learning Difficulty,2,2,0
Slough,State-funded AP school,"Social, Emotional and Mental Health",130,110,20
Slough,State-funded AP school,Specific Learning Difficulty,1,1,0
Slough,State-funded AP school,"Speech, Language and Communications needs",1,0,1
Slough,State-funded nursery,Autistic Spectrum Disorder,23,18,5
Slough,State-funded nursery,Hearing Impairment,1,1,0
Slough,State-funded nursery,Multi- Sensory Impairment,3,1,2
Slough,State-funded nursery,Profound & Multiple Learning Difficulty,1,0,1
Slough,State-funded nursery,SEN support but no specialist assessment of type of need,1,1,0
Slough,State-funded nursery,"Social, Emotional and Mental Health",1,1,0
Slough,State-funded nursery,"Speech, Language and Communications needs",70,51,19
Slough,State-funded nursery,Visual Impairment,2,1,1
Slough,State-funded primary,Autistic Spectrum Disorder,321,250,71
Slough,State-funded primary,Hearing Impairment,49,26,23
Slough,State-funded primary,Moderate Learning Difficulty,297,171,126
Slough,State-funded primary,Multi- Sensory Impairment,10,8,2
Slough,State-funded primary,Other Difficulty/Disability,48,29,19
Slough,State-funded primary,Physical Disability,60,36,24
Slough,State-funded primary,Profound & Multiple Learning Difficulty,7,4,3
Slough,State-funded primary,SEN support but no specialist assessment of type of need,105,69,36
Slough,State-funded primary,Severe Learning Difficulty,19,14,5
Slough,State-funded primary,"Social, Emotional and Mental Health",279,197,82
Slough,State-funded primary,Specific Learning Difficulty,149,90,59
Slough,State-funded primary,"Speech, Language and Communications needs",1232,875,357
Slough,State-funded primary,Visual Impairment,29,10,19
Slough,State-funded secondary,Autistic Spectrum Disorder,212,164,48
Slough,State-funded secondary,Hearing Impairment,47,25,22
Slough,State-funded secondary,Moderate Learning Difficulty,232,131,101
Slough,State-funded secondary,Multi- Sensory Impairment,4,3,1
Slough,State-funded secondary,Other Difficulty/Disability,103,65,38
Slough,State-funded secondary,Physical Disability,42,34,8
Slough,State-funded secondary,Profound & Multiple Learning Difficulty,3,2,1
Slough,State-funded secondary,SEN support but no specialist assessment of type of need,61,38,23
Slough,State-funded secondary,Severe Learning Difficulty,9,7,2
Slough,State-funded secondary,"Social, Emotional and Mental Health",328,227,101
Slough,State-funded secondary,Specific Learning Difficulty,231,130,101
Slough,State-funded secondary,"Speech, Language and Communications needs",350,212,138
Slough,State-funded secondary,Visual Impairment,31,15,16
Slough,State-funded special school,Autistic Spectrum Disorder,177,134,43
Slough,State-funded special school,Hearing Impairment,4,2,2
Slough,State-funded special school,Moderate Learning Difficulty,33,20,13
Slough,State-funded special school,Other Difficulty/Disability,19,13,6
Slough,State-funded special school,Physical Disability,7,3,4
Slough,State-funded special school,Profound & Multiple Learning Difficulty,23,14,9
Slough,State-funded special school,Severe Learning Difficulty,57,35,22
Slough,State-funded special school,"Social, Emotional and Mental Health",16,15,1
Slough,State-funded special school,Specific Learning Difficulty,11,2,9
Slough,State-funded special school,"Speech, Language and Communications needs",24,18,6
Slough,State-funded special school,Visual Impairment,2,0,2
Windsor and Maidenhead,Non-maintained special school,Autistic Spectrum Disorder,76,67,9
Windsor and Maidenhead,Non-maintained special school,Moderate Learning Difficulty,1,1,0
Windsor and Maidenhead,State-funded AP school,Autistic Spectrum Disorder,1,1,0
Windsor and Maidenhead,State-funded AP school,Hearing Impairment,1,1,0
Windsor and Maidenhead,State-funded AP school,Moderate Learning Difficulty,2,0,2
Windsor and Maidenhead,State-funded AP school,Other Difficulty/Disability,1,1,0
Windsor and Maidenhead,State-funded AP school,"Social, Emotional and Mental Health",17,12,5
Windsor and Maidenhead,State-funded AP school,Specific Learning Difficulty,1,0,1
Windsor and Maidenhead,State-funded AP school,"Speech, Language and Communications needs",2,2,0
Windsor and Maidenhead,State-funded nursery,Autistic Spectrum Disorder,5,3,2
Windsor and Maidenhead,State-funded nursery,Hearing Impairment,1,1,0
Windsor and Maidenhead,State-funded nursery,Other Difficulty/Disability,1,1,0
Windsor and Maidenhead,State-funded nursery,SEN support but no specialist assessment of type of need,1,1,0
Windsor and Maidenhead,State-funded nursery,"Speech, Language and Communications needs",28,15,13
Windsor and Maidenhead,State-funded primary,Autistic Spectrum Disorder,233,172,61
Windsor and Maidenhead,State-funded primary,Hearing Impairment,25,9,16
Windsor and Maidenhead,State-funded primary,Moderate Learning Difficulty,128,71,57
Windsor and Maidenhead,State-funded primary,Multi- Sensory Impairment,11,7,4
Windsor and Maidenhead,State-funded primary,Other Difficulty/Disability,68,45,23
Windsor and Maidenhead,State-funded primary,Physical Disability,30,19,11
Windsor and Maidenhead,State-funded primary,Profound & Multiple Learning Difficulty,2,2,0
Windsor and Maidenhead,State-funded primary,SEN support but no specialist assessment of type of need,101,56,45
Windsor and Maidenhead,State-funded primary,Severe Learning Difficulty,6,3,3
Windsor and Maidenhead,State-funded primary,"Social, Emotional and Mental Health",257,194,63
Windsor and Maidenhead,State-funded primary,Specific Learning Difficulty,146,89,57
Windsor and Maidenhead,State-funded primary,"Speech, Language and Communications needs",411,283,128
Windsor and Maidenhead,State-funded primary,Visual Impairment,9,2,7
Windsor and Maidenhead,State-funded secondary,Autistic Spectrum Disorder,317,224,93
Windsor and Maidenhead,State-funded secondary,Hearing Impairment,27,11,16
Windsor and Maidenhead,State-funded secondary,Moderate Learning Difficulty,208,118,90
Windsor and Maidenhead,State-funded secondary,Multi- Sensory Impairment,2,2,0
Windsor and Maidenhead,State-funded secondary,Other Difficulty/Disability,141,83,58
Windsor and Maidenhead,State-funded secondary,Physical Disability,25,12,13
Windsor and Maidenhead,State-funded secondary,Profound & Multiple Learning Difficulty,1,0,1
Windsor and Maidenhead,State-funded secondary,SEN support but no specialist assessment of type of need,35,21,14
Windsor and Maidenhead,State-funded secondary,Severe Learning Difficulty,5,5,0
Windsor and Maidenhead,State-funded secondary,"Social, Emotional and Mental Health",323,208,115
Windsor and Maidenhead,State-funded secondary,Specific Learning Difficulty,379,237,142
Windsor and Maidenhead,State-funded secondary,"Speech, Language and Communications needs",178,124,54
Windsor and Maidenhead,State-funded secondary,Visual Impairment,17,8,9
Windsor and Maidenhead,State-funded special school,Autistic Spectrum Disorder,213,168,45
Windsor and Maidenhead,State-funded special school,Moderate Learning Difficulty,30,16,14
Windsor and Maidenhead,State-funded special school,Other Difficulty/Disability,24,16,8
Windsor and Maidenhead,State-funded special school,Physical Disability,22,12,10
Windsor and Maidenhead,State-funded special school,Profound & Multiple Learning Difficulty,23,16,7
Windsor and Maidenhead,State-funded special school,Severe Learning Difficulty,51,31,20
Windsor and Maidenhead,State-funded special school,"Social, Emotional and Mental Health",6,5,1
Windsor and Maidenhead,State-funded special school,Specific Learning Difficulty,5,4,1
Windsor and Maidenhead,State-funded special school,"Speech, Language and Communications needs",22,19,3
Windsor and Maidenhead,State-funded special school,Visual Impairment,2,2,0
Wokingham,Non-maintained special school,Autistic Spectrum Disorder,29,23,6
Wokingham,Non-maintained special school,Moderate Learning Difficulty,2,1,1
Wokingham,Non-maintained special school,Multi- Sensory Impairment,1,0,1
Wokingham,Non-maintained special school,Other Difficulty/Disability,1,1,0
Wokingham,Non-maintained special school,"Social, Emotional and Mental Health",41,25,16
Wokingham,Non-maintained special school,Specific Learning Difficulty,4,2,2
Wokingham,Non-maintained special school,"Speech, Language and Communications needs",7,4,3
Wokingham,State-funded AP school,Autistic Spectrum Disorder,1,1,0
Wokingham,State-funded AP school,"Social, Emotional and Mental Health",10,8,2
Wokingham,State-funded AP school,Specific Learning Difficulty,1,1,0
Wokingham,State-funded AP school,"Speech, Language and Communications needs",1,1,0
Wokingham,State-funded nursery,Other Difficulty/Disability,1,1,0
Wokingham,State-funded nursery,Physical Disability,1,1,0
Wokingham,State-funded nursery,"Speech, Language and Communications needs",8,7,1
Wokingham,State-funded primary,Autistic Spectrum Disorder,350,246,104
Wokingham,State-funded primary,Hearing Impairment,55,28,27
Wokingham,State-funded primary,Moderate Learning Difficulty,188,112,76
Wokingham,State-funded primary,Multi- Sensory Impairment,7,5,2
Wokingham,State-funded primary,Other Difficulty/Disability,83,58,25
Wokingham,State-funded primary,Physical Disability,61,34,27
Wokingham,State-funded primary,Profound & Multiple Learning Difficulty,1,1,0
Wokingham,State-funded primary,SEN support but no specialist assessment of type of need,145,80,65
Wokingham,State-funded primary,Severe Learning Difficulty,8,8,0
Wokingham,State-funded primary,"Social, Emotional and Mental Health",358,261,97
Wokingham,State-funded primary,Specific Learning Difficulty,205,113,92
Wokingham,State-funded primary,"Speech, Language and Communications needs",667,451,216
Wokingham,State-funded primary,Visual Impairment,11,6,5
Wokingham,State-funded secondary,Autistic Spectrum Disorder,410,276,134
Wokingham,State-funded secondary,Hearing Impairment,38,18,20
Wokingham,State-funded secondary,Moderate Learning Difficulty,105,68,37
Wokingham,State-funded secondary,Multi- Sensory Impairment,3,1,2
Wokingham,State-funded secondary,Other Difficulty/Disability,58,32,26
Wokingham,State-funded secondary,Physical Disability,41,25,16
Wokingham,State-funded secondary,SEN support but no specialist assessment of type of need,121,60,61
Wokingham,State-funded secondary,Severe Learning Difficulty,8,2,6
Wokingham,State-funded secondary,"Social, Emotional and Mental Health",415,251,164
Wokingham,State-funded secondary,Specific Learning Difficulty,290,150,140
Wokingham,State-funded secondary,"Speech, Language and Communications needs",98,74,24
Wokingham,State-funded secondary,Visual Impairment,15,9,6
Wokingham,State-funded special school,Autistic Spectrum Disorder,38,33,5
Wokingham,State-funded special school,Moderate Learning Difficulty,28,18,10
Wokingham,State-funded special school,Profound & Multiple Learning Difficulty,23,10,13
Wokingham,State-funded special school,Severe Learning Difficulty,222,157,65
Wokingham,State-funded special school,"Social, Emotional and Mental Health",11,10,1
Milton Keynes,State-funded AP school,Autistic Spectrum Disorder,2,2,0
Milton Keynes,State-funded AP school,"Social, Emotional and Mental Health",23,18,5
Milton Keynes,State-funded nursery,Autistic Spectrum Disorder,2,2,0
Milton Keynes,State-funded nursery,Hearing Impairment,2,2,0
Milton Keynes,State-funded nursery,Moderate Learning Difficulty,1,1,0
Milton Keynes,State-funded nursery,Other Difficulty/Disability,1,1,0
Milton Keynes,State-funded nursery,Physical Disability,1,0,1
Milton Keynes,State-funded nursery,"Social, Emotional and Mental Health",8,7,1
Milton Keynes,State-funded nursery,"Speech, Language and Communications needs",15,12,3
Milton Keynes,State-funded primary,Autistic Spectrum Disorder,466,352,114
Milton Keynes,State-funded primary,Hearing Impairment,75,34,41
Milton Keynes,State-funded primary,Moderate Learning Difficulty,829,474,355
Milton Keynes,State-funded primary,Multi- Sensory Impairment,5,3,2
Milton Keynes,State-funded primary,Other Difficulty/Disability,129,79,50
Milton Keynes,State-funded primary,Physical Disability,69,36,33
Milton Keynes,State-funded primary,Profound & Multiple Learning Difficulty,7,5,2
Milton Keynes,State-funded primary,SEN support but no specialist assessment of type of need,181,119,62
Milton Keynes,State-funded primary,Severe Learning Difficulty,20,16,4
Milton Keynes,State-funded primary,"Social, Emotional and Mental Health",516,360,156
Milton Keynes,State-funded primary,Specific Learning Difficulty,228,129,99
Milton Keynes,State-funded primary,"Speech, Language and Communications needs",1433,1044,389
Milton Keynes,State-funded primary,Visual Impairment,33,19,14
Milton Keynes,State-funded secondary,Autistic Spectrum Disorder,429,319,110
Milton Keynes,State-funded secondary,Hearing Impairment,85,42,43
Milton Keynes,State-funded secondary,Moderate Learning Difficulty,498,329,169
Milton Keynes,State-funded secondary,Multi- Sensory Impairment,10,7,3
Milton Keynes,State-funded secondary,Other Difficulty/Disability,105,69,36
Milton Keynes,State-funded secondary,Physical Disability,42,28,14
Milton Keynes,State-funded secondary,Profound & Multiple Learning Difficulty,4,3,1
Milton Keynes,State-funded secondary,SEN support but no specialist assessment of type of need,71,49,22
Milton Keynes,State-funded secondary,Severe Learning Difficulty,7,3,4
Milton Keynes,State-funded secondary,"Social, Emotional and Mental Health",403,248,155
Milton Keynes,State-funded secondary,Specific Learning Difficulty,421,247,174
Milton Keynes,State-funded secondary,"Speech, Language and Communications needs",378,289,89
Milton Keynes,State-funded secondary,Visual Impairment,35,20,15
Milton Keynes,State-funded special school,Autistic Spectrum Disorder,369,296,73
Milton Keynes,State-funded special school,Hearing Impairment,6,6,0
Milton Keynes,State-funded special school,Moderate Learning Difficulty,135,90,45
Milton Keynes,State-funded special school,Multi- Sensory Impairment,3,3,0
Milton Keynes,State-funded special school,Other Difficulty/Disability,41,29,12
Milton Keynes,State-funded special school,Physical Disability,17,11,6
Milton Keynes,State-funded special school,Profound & Multiple Learning Difficulty,41,24,17
Milton Keynes,State-funded special school,Severe Learning Difficulty,102,46,56
Milton Keynes,State-funded special school,"Social, Emotional and Mental Health",93,86,7
Milton Keynes,State-funded special school,Specific Learning Difficulty,24,21,3
Milton Keynes,State-funded special school,"Speech, Language and Communications needs",71,53,18
Milton Keynes,State-funded special school,Visual Impairment,5,2,3
Brighton and Hove,Non-maintained special school,Hearing Impairment,36,21,15
Brighton and Hove,Non-maintained special school,"Speech, Language and Communications needs",1,0,1
Brighton and Hove,State-funded AP school,Autistic Spectrum Disorder,5,2,3
Brighton and Hove,State-funded AP school,Moderate Learning Difficulty,5,4,1
Brighton and Hove,State-funded AP school,Physical Disability,1,1,0
Brighton and Hove,State-funded AP school,"Social, Emotional and Mental Health",70,40,30
Brighton and Hove,State-funded AP school,Specific Learning Difficulty,4,3,1
Brighton and Hove,State-funded AP school,"Speech, Language and Communications needs",3,3,0
Brighton and Hove,State-funded nursery,Autistic Spectrum Disorder,4,4,0
Brighton and Hove,State-funded nursery,"Social, Emotional and Mental Health",4,3,1
Brighton and Hove,State-funded nursery,Specific Learning Difficulty,7,4,3
Brighton and Hove,State-funded nursery,"Speech, Language and Communications needs",44,29,15
Brighton and Hove,State-funded primary,Autistic Spectrum Disorder,582,428,154
Brighton and Hove,State-funded primary,Hearing Impairment,65,37,28
Brighton and Hove,State-funded primary,Moderate Learning Difficulty,324,172,152
Brighton and Hove,State-funded primary,Multi- Sensory Impairment,14,10,4
Brighton and Hove,State-funded primary,Other Difficulty/Disability,15,11,4
Brighton and Hove,State-funded primary,Physical Disability,80,45,35
Brighton and Hove,State-funded primary,Profound & Multiple Learning Difficulty,2,2,0
Brighton and Hove,State-funded primary,Severe Learning Difficulty,12,9,3
Brighton and Hove,State-funded primary,"Social, Emotional and Mental Health",706,463,243
Brighton and Hove,State-funded primary,Specific Learning Difficulty,479,281,198
Brighton and Hove,State-funded primary,"Speech, Language and Communications needs",1102,752,350
Brighton and Hove,State-funded primary,Visual Impairment,36,20,16
Brighton and Hove,State-funded secondary,Autistic Spectrum Disorder,519,341,178
Brighton and Hove,State-funded secondary,Hearing Impairment,43,29,14
Brighton and Hove,State-funded secondary,Moderate Learning Difficulty,179,86,93
Brighton and Hove,State-funded secondary,Multi- Sensory Impairment,9,5,4
Brighton and Hove,State-funded secondary,Other Difficulty/Disability,4,3,1
Brighton and Hove,State-funded secondary,Physical Disability,98,49,49
Brighton and Hove,State-funded secondary,Profound & Multiple Learning Difficulty,1,1,0
Brighton and Hove,State-funded secondary,"Social, Emotional and Mental Health",566,333,233
Brighton and Hove,State-funded secondary,Specific Learning Difficulty,727,409,318
Brighton and Hove,State-funded secondary,"Speech, Language and Communications needs",200,135,65
Brighton and Hove,State-funded secondary,Visual Impairment,29,15,14
Brighton and Hove,State-funded special school,Autistic Spectrum Disorder,141,118,23
Brighton and Hove,State-funded special school,Hearing Impairment,1,1,0
Brighton and Hove,State-funded special school,Moderate Learning Difficulty,30,18,12
Brighton and Hove,State-funded special school,Multi- Sensory Impairment,4,1,3
Brighton and Hove,State-funded special school,Physical Disability,9,3,6
Brighton and Hove,State-funded special school,Profound & Multiple Learning Difficulty,27,16,11
Brighton and Hove,State-funded special school,Severe Learning Difficulty,121,90,31
Brighton and Hove,State-funded special school,"Social, Emotional and Mental Health",39,34,5
Brighton and Hove,State-funded special school,Specific Learning Difficulty,12,5,7
Brighton and Hove,State-funded special school,"Speech, Language and Communications needs",57,41,16
Portsmouth,State-funded primary,Autistic Spectrum Disorder,161,124,37
Portsmouth,State-funded primary,Hearing Impairment,45,26,19
Portsmouth,State-funded primary,Moderate Learning Difficulty,476,261,215
Portsmouth,State-funded primary,Multi- Sensory Impairment,10,7,3
Portsmouth,State-funded primary,Other Difficulty/Disability,167,99,68
Portsmouth,State-funded primary,Physical Disability,85,60,25
Portsmouth,State-funded primary,Profound & Multiple Learning Difficulty,2,1,1
Portsmouth,State-funded primary,SEN support but no specialist assessment of type of need,89,56,33
Portsmouth,State-funded primary,Severe Learning Difficulty,6,1,5
Portsmouth,State-funded primary,"Social, Emotional and Mental Health",545,393,152
Portsmouth,State-funded primary,Specific Learning Difficulty,223,113,110
Portsmouth,State-funded primary,"Speech, Language and Communications needs",899,632,267
Portsmouth,State-funded primary,Visual Impairment,38,25,13
Portsmouth,State-funded secondary,Autistic Spectrum Disorder,181,146,35
Portsmouth,State-funded secondary,Hearing Impairment,39,21,18
Portsmouth,State-funded secondary,Moderate Learning Difficulty,326,193,133
Portsmouth,State-funded secondary,Multi- Sensory Impairment,4,2,2
Portsmouth,State-funded secondary,Other Difficulty/Disability,67,45,22
Portsmouth,State-funded secondary,Physical Disability,70,46,24
Portsmouth,State-funded secondary,Profound & Multiple Learning Difficulty,1,1,0
Portsmouth,State-funded secondary,SEN support but no specialist assessment of type of need,74,49,25
Portsmouth,State-funded secondary,Severe Learning Difficulty,2,1,1
Portsmouth,State-funded secondary,"Social, Emotional and Mental Health",609,372,237
Portsmouth,State-funded secondary,Specific Learning Difficulty,238,145,93
Portsmouth,State-funded secondary,"Speech, Language and Communications needs",252,169,83
Portsmouth,State-funded secondary,Visual Impairment,39,25,14
Portsmouth,State-funded special school,Autistic Spectrum Disorder,235,197,38
Portsmouth,State-funded special school,Moderate Learning Difficulty,35,22,13
Portsmouth,State-funded special school,Physical Disability,14,11,3
Portsmouth,State-funded special school,Profound & Multiple Learning Difficulty,37,17,20
Portsmouth,State-funded special school,SEN support but no specialist assessment of type of need,40,27,13
Portsmouth,State-funded special school,Severe Learning Difficulty,96,61,35
Portsmouth,State-funded special school,"Social, Emotional and Mental Health",91,73,18
Portsmouth,State-funded special school,Specific Learning Difficulty,11,9,2
Portsmouth,State-funded special school,"Speech, Language and Communications needs",106,81,25
Portsmouth,State-funded special school,Visual Impairment,2,1,1
Southampton,State-funded AP school,Autistic Spectrum Disorder,4,3,1
Southampton,State-funded AP school,Moderate Learning Difficulty,1,1,0
Southampton,State-funded AP school,"Social, Emotional and Mental Health",35,28,7
Southampton,State-funded AP school,"Speech, Language and Communications needs",3,3,0
Southampton,State-funded nursery,Autistic Spectrum Disorder,1,1,0
Southampton,State-funded nursery,Hearing Impairment,1,1,0
Southampton,State-funded nursery,"Social, Emotional and Mental Health",1,0,1
Southampton,State-funded nursery,Specific Learning Difficulty,3,2,1
Southampton,State-funded nursery,"Speech, Language and Communications needs",2,2,0
Southampton,State-funded primary,Autistic Spectrum Disorder,632,461,171
Southampton,State-funded primary,Hearing Impairment,60,32,28
Southampton,State-funded primary,Moderate Learning Difficulty,706,417,289
Southampton,State-funded primary,Multi- Sensory Impairment,4,3,1
Southampton,State-funded primary,Other Difficulty/Disability,65,39,26
Southampton,State-funded primary,Physical Disability,95,53,42
Southampton,State-funded primary,Profound & Multiple Learning Difficulty,5,2,3
Southampton,State-funded primary,SEN support but no specialist assessment of type of need,54,36,18
Southampton,State-funded primary,Severe Learning Difficulty,8,4,4
Southampton,State-funded primary,"Social, Emotional and Mental Health",609,426,183
Southampton,State-funded primary,Specific Learning Difficulty,171,99,72
Southampton,State-funded primary,"Speech, Language and Communications needs",1070,749,321
Southampton,State-funded primary,Visual Impairment,39,30,9
Southampton,State-funded secondary,Autistic Spectrum Disorder,466,322,144
Southampton,State-funded secondary,Hearing Impairment,45,20,25
Southampton,State-funded secondary,Moderate Learning Difficulty,510,312,198
Southampton,State-funded secondary,Multi- Sensory Impairment,2,1,1
Southampton,State-funded secondary,Other Difficulty/Disability,46,28,18
Southampton,State-funded secondary,Physical Disability,64,41,23
Southampton,State-funded secondary,SEN support but no specialist assessment of type of need,11,8,3
Southampton,State-funded secondary,Severe Learning Difficulty,1,1,0
Southampton,State-funded secondary,"Social, Emotional and Mental Health",629,376,253
Southampton,State-funded secondary,Specific Learning Difficulty,365,170,195
Southampton,State-funded secondary,"Speech, Language and Communications needs",302,203,99
Southampton,State-funded secondary,Visual Impairment,22,11,11
Southampton,State-funded special school,Autistic Spectrum Disorder,231,182,49
Southampton,State-funded special school,Hearing Impairment,6,2,4
Southampton,State-funded special school,Moderate Learning Difficulty,97,60,37
Southampton,State-funded special school,Other Difficulty/Disability,18,13,5
Southampton,State-funded special school,Physical Disability,38,22,16
Southampton,State-funded special school,Profound & Multiple Learning Difficulty,70,41,29
Southampton,State-funded special school,Severe Learning Difficulty,119,91,28
Southampton,State-funded special school,"Social, Emotional and Mental Health",123,114,9
Southampton,State-funded special school,Specific Learning Difficulty,27,21,6
Southampton,State-funded special school,"Speech, Language and Communications needs",134,85,49
Southampton,State-funded special school,Visual Impairment,6,5,1
Isle of Wight,Non-maintained special school,Autistic Spectrum Disorder,10,7,3
Isle of Wight,Non-maintained special school,Hearing Impairment,1,1,0
Isle of Wight,Non-maintained special school,Moderate Learning Difficulty,6,4,2
Isle of Wight,Non-maintained special school,Other Difficulty/Disability,1,0,1
Isle of Wight,Non-maintained special school,Physical Disability,2,2,0
Isle of Wight,Non-maintained special school,Profound & Multiple Learning Difficulty,1,0,1
Isle of Wight,Non-maintained special school,"Social, Emotional and Mental Health",4,3,1
Isle of Wight,Non-maintained special school,Specific Learning Difficulty,2,2,0
Isle of Wight,Non-maintained special school,"Speech, Language and Communications needs",65,50,15
Isle of Wight,State-funded AP school,Autistic Spectrum Disorder,2,1,1
Isle of Wight,State-funded AP school,Moderate Learning Difficulty,2,1,1
Isle of Wight,State-funded AP school,"Social, Emotional and Mental Health",27,22,5
Isle of Wight,State-funded AP school,Specific Learning Difficulty,1,0,1
Isle of Wight,State-funded AP school,"Speech, Language and Communications needs",4,3,1
Isle of Wight,State-funded primary,Autistic Spectrum Disorder,142,105,37
Isle of Wight,State-funded primary,Hearing Impairment,11,7,4
Isle of Wight,State-funded primary,Moderate Learning Difficulty,414,223,191
Isle of Wight,State-funded primary,Multi- Sensory Impairment,9,6,3
Isle of Wight,State-funded primary,Other Difficulty/Disability,28,18,10
Isle of Wight,State-funded primary,Physical Disability,26,14,12
Isle of Wight,State-funded primary,Profound & Multiple Learning Difficulty,2,1,1
Isle of Wight,State-funded primary,SEN support but no specialist assessment of type of need,27,13,14
Isle of Wight,State-funded primary,Severe Learning Difficulty,23,14,9
Isle of Wight,State-funded primary,"Social, Emotional and Mental Health",292,205,87
Isle of Wight,State-funded primary,Specific Learning Difficulty,191,105,86
Isle of Wight,State-funded primary,"Speech, Language and Communications needs",504,340,164
Isle of Wight,State-funded primary,Visual Impairment,7,4,3
Isle of Wight,State-funded secondary,Autistic Spectrum Disorder,193,134,59
Isle of Wight,State-funded secondary,Hearing Impairment,12,4,8
Isle of Wight,State-funded secondary,Moderate Learning Difficulty,367,198,169
Isle of Wight,State-funded secondary,Multi- Sensory Impairment,8,3,5
Isle of Wight,State-funded secondary,Other Difficulty/Disability,14,11,3
Isle of Wight,State-funded secondary,Physical Disability,21,14,7
Isle of Wight,State-funded secondary,Profound & Multiple Learning Difficulty,1,0,1
Isle of Wight,State-funded secondary,SEN support but no specialist assessment of type of need,20,12,8
Isle of Wight,State-funded secondary,Severe Learning Difficulty,8,3,5
Isle of Wight,State-funded secondary,"Social, Emotional and Mental Health",370,262,108
Isle of Wight,State-funded secondary,Specific Learning Difficulty,236,125,111
Isle of Wight,State-funded secondary,"Speech, Language and Communications needs",273,176,97
Isle of Wight,State-funded secondary,Visual Impairment,9,5,4
Isle of Wight,State-funded special school,Autistic Spectrum Disorder,48,36,12
Isle of Wight,State-funded special school,Moderate Learning Difficulty,53,28,25
Isle of Wight,State-funded special school,Multi- Sensory Impairment,2,1,1
Isle of Wight,State-funded special school,Physical Disability,2,0,2
Isle of Wight,State-funded special school,Profound & Multiple Learning Difficulty,27,10,17
Isle of Wight,State-funded special school,Severe Learning Difficulty,143,105,38
Isle of Wight,State-funded special school,"Social, Emotional and Mental Health",6,4,2
Isle of Wight,State-funded special school,Specific Learning Difficulty,6,5,1
Isle of Wight,State-funded special school,"Speech, Language and Communications needs",16,13,3
Buckinghamshire,State-funded AP school,Autistic Spectrum Disorder,21,14,7
Buckinghamshire,State-funded AP school,Moderate Learning Difficulty,10,8,2
Buckinghamshire,State-funded AP school,Other Difficulty/Disability,1,0,1
Buckinghamshire,State-funded AP school,Physical Disability,1,1,0
Buckinghamshire,State-funded AP school,Severe Learning Difficulty,2,1,1
Buckinghamshire,State-funded AP school,"Social, Emotional and Mental Health",41,29,12
Buckinghamshire,State-funded AP school,Specific Learning Difficulty,3,2,1
Buckinghamshire,State-funded AP school,"Speech, Language and Communications needs",4,2,2
Buckinghamshire,State-funded nursery,Autistic Spectrum Disorder,13,9,4
Buckinghamshire,State-funded nursery,Hearing Impairment,1,1,0
Buckinghamshire,State-funded nursery,Moderate Learning Difficulty,2,1,1
Buckinghamshire,State-funded nursery,Other Difficulty/Disability,5,2,3
Buckinghamshire,State-funded nursery,Physical Disability,4,2,2
Buckinghamshire,State-funded nursery,"Social, Emotional and Mental Health",10,6,4
Buckinghamshire,State-funded nursery,"Speech, Language and Communications needs",34,26,8
Buckinghamshire,State-funded nursery,Visual Impairment,1,0,1
Buckinghamshire,State-funded primary,Autistic Spectrum Disorder,673,510,163
Buckinghamshire,State-funded primary,Hearing Impairment,111,62,49
Buckinghamshire,State-funded primary,Moderate Learning Difficulty,817,488,329
Buckinghamshire,State-funded primary,Multi- Sensory Impairment,24,15,9
Buckinghamshire,State-funded primary,Other Difficulty/Disability,266,175,91
Buckinghamshire,State-funded primary,Physical Disability,158,92,66
Buckinghamshire,State-funded primary,Profound & Multiple Learning Difficulty,11,6,5
Buckinghamshire,State-funded primary,SEN support but no specialist assessment of type of need,401,247,154
Buckinghamshire,State-funded primary,Severe Learning Difficulty,16,10,6
Buckinghamshire,State-funded primary,"Social, Emotional and Mental Health",1203,885,318
Buckinghamshire,State-funded primary,Specific Learning Difficulty,852,477,375
Buckinghamshire,State-funded primary,"Speech, Language and Communications needs",2471,1662,809
Buckinghamshire,State-funded primary,Visual Impairment,59,35,24
Buckinghamshire,State-funded secondary,Autistic Spectrum Disorder,925,594,331
Buckinghamshire,State-funded secondary,Hearing Impairment,120,61,59
Buckinghamshire,State-funded secondary,Moderate Learning Difficulty,580,329,251
Buckinghamshire,State-funded secondary,Multi- Sensory Impairment,16,10,6
Buckinghamshire,State-funded secondary,Other Difficulty/Disability,282,162,120
Buckinghamshire,State-funded secondary,Physical Disability,113,60,53
Buckinghamshire,State-funded secondary,Profound & Multiple Learning Difficulty,1,0,1
Buckinghamshire,State-funded secondary,SEN support but no specialist assessment of type of need,217,115,102
Buckinghamshire,State-funded secondary,Severe Learning Difficulty,11,8,3
Buckinghamshire,State-funded secondary,"Social, Emotional and Mental Health",1012,641,371
Buckinghamshire,State-funded secondary,Specific Learning Difficulty,1120,587,533
Buckinghamshire,State-funded secondary,"Speech, Language and Communications needs",484,339,145
Buckinghamshire,State-funded secondary,Visual Impairment,76,37,39
Buckinghamshire,State-funded special school,Autistic Spectrum Disorder,663,539,124
Buckinghamshire,State-funded special school,Hearing Impairment,9,6,3
Buckinghamshire,State-funded special school,Moderate Learning Difficulty,235,126,109
Buckinghamshire,State-funded special school,Multi- Sensory Impairment,13,7,6
Buckinghamshire,State-funded special school,Other Difficulty/Disability,14,12,2
Buckinghamshire,State-funded special school,Physical Disability,76,38,38
Buckinghamshire,State-funded special school,Profound & Multiple Learning Difficulty,34,19,15
Buckinghamshire,State-funded special school,Severe Learning Difficulty,86,58,28
Buckinghamshire,State-funded special school,"Social, Emotional and Mental Health",152,136,16
Buckinghamshire,State-funded special school,Specific Learning Difficulty,39,25,14
Buckinghamshire,State-funded special school,"Speech, Language and Communications needs",347,234,113
Buckinghamshire,State-funded special school,Visual Impairment,8,7,1
East Sussex,Non-maintained special school,Autistic Spectrum Disorder,73,54,19
East Sussex,Non-maintained special school,Moderate Learning Difficulty,24,10,14
East Sussex,Non-maintained special school,Multi- Sensory Impairment,1,1,0
East Sussex,Non-maintained special school,Other Difficulty/Disability,1,1,0
East Sussex,Non-maintained special school,Physical Disability,82,44,38
East Sussex,Non-maintained special school,Profound & Multiple Learning Difficulty,3,2,1
East Sussex,Non-maintained special school,Severe Learning Difficulty,4,3,1
East Sussex,Non-maintained special school,"Social, Emotional and Mental Health",7,5,2
East Sussex,Non-maintained special school,Specific Learning Difficulty,1,1,0
East Sussex,Non-maintained special school,"Speech, Language and Communications needs",21,12,9
East Sussex,State-funded AP school,Autistic Spectrum Disorder,2,2,0
East Sussex,State-funded AP school,Moderate Learning Difficulty,1,1,0
East Sussex,State-funded AP school,"Social, Emotional and Mental Health",36,30,6
East Sussex,State-funded AP school,"Speech, Language and Communications needs",1,1,0
East Sussex,State-funded primary,Autistic Spectrum Disorder,747,561,186
East Sussex,State-funded primary,Hearing Impairment,78,44,34
East Sussex,State-funded primary,Moderate Learning Difficulty,503,287,216
East Sussex,State-funded primary,Multi- Sensory Impairment,13,7,6
East Sussex,State-funded primary,Other Difficulty/Disability,253,156,97
East Sussex,State-funded primary,Physical Disability,149,83,66
East Sussex,State-funded primary,Profound & Multiple Learning Difficulty,11,8,3
East Sussex,State-funded primary,SEN support but no specialist assessment of type of need,353,236,117
East Sussex,State-funded primary,Severe Learning Difficulty,8,4,4
East Sussex,State-funded primary,"Social, Emotional and Mental Health",1235,857,378
East Sussex,State-funded primary,Specific Learning Difficulty,667,385,282
East Sussex,State-funded primary,"Speech, Language and Communications needs",2089,1407,682
East Sussex,State-funded primary,Visual Impairment,37,17,20
East Sussex,State-funded secondary,Autistic Spectrum Disorder,817,601,216
East Sussex,State-funded secondary,Hearing Impairment,69,30,39
East Sussex,State-funded secondary,Moderate Learning Difficulty,376,219,157
East Sussex,State-funded secondary,Multi- Sensory Impairment,8,5,3
East Sussex,State-funded secondary,Other Difficulty/Disability,219,146,73
East Sussex,State-funded secondary,Physical Disability,103,67,36
East Sussex,State-funded secondary,SEN support but no specialist assessment of type of need,54,32,22
East Sussex,State-funded secondary,Severe Learning Difficulty,9,7,2
East Sussex,State-funded secondary,"Social, Emotional and Mental Health",991,599,392
East Sussex,State-funded secondary,Specific Learning Difficulty,883,501,382
East Sussex,State-funded secondary,"Speech, Language and Communications needs",643,425,218
East Sussex,State-funded secondary,Visual Impairment,44,30,14
East Sussex,State-funded special school,Autistic Spectrum Disorder,479,388,91
East Sussex,State-funded special school,Hearing Impairment,3,1,2
East Sussex,State-funded special school,Moderate Learning Difficulty,129,75,54
East Sussex,State-funded special school,Other Difficulty/Disability,22,16,6
East Sussex,State-funded special school,Physical Disability,21,10,11
East Sussex,State-funded special school,Profound & Multiple Learning Difficulty,81,46,35
East Sussex,State-funded special school,Severe Learning Difficulty,165,115,50
East Sussex,State-funded special school,"Social, Emotional and Mental Health",233,194,39
East Sussex,State-funded special school,Specific Learning Difficulty,18,13,5
East Sussex,State-funded special school,"Speech, Language and Communications needs",145,97,48
East Sussex,State-funded special school,Visual Impairment,4,3,1
Hampshire,Non-maintained special school,Physical Disability,74,43,31
Hampshire,State-funded AP school,Autistic Spectrum Disorder,4,4,0
Hampshire,State-funded AP school,Hearing Impairment,1,0,1
Hampshire,State-funded AP school,Moderate Learning Difficulty,5,5,0
Hampshire,State-funded AP school,Other Difficulty/Disability,4,1,3
Hampshire,State-funded AP school,Severe Learning Difficulty,1,1,0
Hampshire,State-funded AP school,"Social, Emotional and Mental Health",93,63,30
Hampshire,State-funded AP school,Specific Learning Difficulty,6,3,3
Hampshire,State-funded AP school,"Speech, Language and Communications needs",2,2,0
Hampshire,State-funded nursery,Autistic Spectrum Disorder,9,7,2
Hampshire,State-funded nursery,Hearing Impairment,1,1,0
Hampshire,State-funded nursery,Moderate Learning Difficulty,5,4,1
Hampshire,State-funded nursery,Multi- Sensory Impairment,5,3,2
Hampshire,State-funded nursery,Other Difficulty/Disability,3,2,1
Hampshire,State-funded nursery,Physical Disability,4,0,4
Hampshire,State-funded nursery,Profound & Multiple Learning Difficulty,5,3,2
Hampshire,State-funded nursery,Severe Learning Difficulty,1,1,0
Hampshire,State-funded nursery,"Social, Emotional and Mental Health",1,1,0
Hampshire,State-funded nursery,"Speech, Language and Communications needs",67,48,19
Hampshire,State-funded primary,Autistic Spectrum Disorder,1339,1009,330
Hampshire,State-funded primary,Hearing Impairment,220,110,110
Hampshire,State-funded primary,Moderate Learning Difficulty,4045,2342,1703
Hampshire,State-funded primary,Multi- Sensory Impairment,62,42,20
Hampshire,State-funded primary,Other Difficulty/Disability,319,178,141
Hampshire,State-funded primary,Physical Disability,429,257,172
Hampshire,State-funded primary,Profound & Multiple Learning Difficulty,19,7,12
Hampshire,State-funded primary,SEN support but no specialist assessment of type of need,531,328,203
Hampshire,State-funded primary,Severe Learning Difficulty,44,34,10
Hampshire,State-funded primary,"Social, Emotional and Mental Health",3134,2299,835
Hampshire,State-funded primary,Specific Learning Difficulty,1937,1104,833
Hampshire,State-funded primary,"Speech, Language and Communications needs",4588,3194,1394
Hampshire,State-funded primary,Visual Impairment,116,77,39
Hampshire,State-funded secondary,Autistic Spectrum Disorder,1293,891,402
Hampshire,State-funded secondary,Hearing Impairment,194,104,90
Hampshire,State-funded secondary,Moderate Learning Difficulty,2519,1442,1077
Hampshire,State-funded secondary,Multi- Sensory Impairment,27,17,10
Hampshire,State-funded secondary,Other Difficulty/Disability,574,322,252
Hampshire,State-funded secondary,Physical Disability,303,182,121
Hampshire,State-funded secondary,Profound & Multiple Learning Difficulty,2,1,1
Hampshire,State-funded secondary,SEN support but no specialist assessment of type of need,187,112,75
Hampshire,State-funded secondary,Severe Learning Difficulty,15,11,4
Hampshire,State-funded secondary,"Social, Emotional and Mental Health",2487,1655,832
Hampshire,State-funded secondary,Specific Learning Difficulty,2412,1300,1112
Hampshire,State-funded secondary,"Speech, Language and Communications needs",1146,789,357
Hampshire,State-funded secondary,Visual Impairment,133,76,57
Hampshire,State-funded special school,Autistic Spectrum Disorder,450,354,96
Hampshire,State-funded special school,Hearing Impairment,8,2,6
Hampshire,State-funded special school,Moderate Learning Difficulty,715,506,209
Hampshire,State-funded special school,Multi- Sensory Impairment,4,3,1
Hampshire,State-funded special school,Other Difficulty/Disability,21,9,12
Hampshire,State-funded special school,Physical Disability,62,38,24
Hampshire,State-funded special school,Profound & Multiple Learning Difficulty,138,76,62
Hampshire,State-funded special school,Severe Learning Difficulty,945,653,292
Hampshire,State-funded special school,"Social, Emotional and Mental Health",564,505,59
Hampshire,State-funded special school,Specific Learning Difficulty,71,45,26
Hampshire,State-funded special school,"Speech, Language and Communications needs",309,215,94
Hampshire,State-funded special school,Visual Impairment,9,4,5
Kent,Non-maintained special school,Autistic Spectrum Disorder,40,28,12
Kent,Non-maintained special school,Moderate Learning Difficulty,1,1,0
Kent,Non-maintained special school,Other Difficulty/Disability,4,4,0
Kent,Non-maintained special school,"Social, Emotional and Mental Health",70,56,14
Kent,Non-maintained special school,"Speech, Language and Communications needs",6,5,1
Kent,State-funded AP school,Autistic Spectrum Disorder,1,1,0
Kent,State-funded AP school,"Social, Emotional and Mental Health",6,5,1
Kent,State-funded nursery,"Social, Emotional and Mental Health",1,0,1
Kent,State-funded nursery,"Speech, Language and Communications needs",11,8,3
Kent,State-funded primary,Autistic Spectrum Disorder,2886,2101,785
Kent,State-funded primary,Hearing Impairment,182,101,81
Kent,State-funded primary,Moderate Learning Difficulty,1969,1122,847
Kent,State-funded primary,Multi- Sensory Impairment,62,45,17
Kent,State-funded primary,Other Difficulty/Disability,672,433,239
Kent,State-funded primary,Physical Disability,481,267,214
Kent,State-funded primary,Profound & Multiple Learning Difficulty,54,31,23
Kent,State-funded primary,SEN support but no specialist assessment of type of need,767,473,294
Kent,State-funded primary,Severe Learning Difficulty,86,56,30
Kent,State-funded primary,"Social, Emotional and Mental Health",3888,2824,1064
Kent,State-funded primary,Specific Learning Difficulty,1768,999,769
Kent,State-funded primary,"Speech, Language and Communications needs",6583,4513,2070
Kent,State-funded primary,Visual Impairment,120,62,58
Kent,State-funded secondary,Autistic Spectrum Disorder,2364,1597,767
Kent,State-funded secondary,Hearing Impairment,143,59,84
Kent,State-funded secondary,Moderate Learning Difficulty,1629,895,734
Kent,State-funded secondary,Multi- Sensory Impairment,41,22,19
Kent,State-funded secondary,Other Difficulty/Disability,820,483,337
Kent,State-funded secondary,Physical Disability,452,232,220
Kent,State-funded secondary,Profound & Multiple Learning Difficulty,5,3,2
Kent,State-funded secondary,SEN support but no specialist assessment of type of need,465,247,218
Kent,State-funded secondary,Severe Learning Difficulty,35,14,21
Kent,State-funded secondary,"Social, Emotional and Mental Health",3656,2204,1452
Kent,State-funded secondary,Specific Learning Difficulty,2475,1289,1186
Kent,State-funded secondary,"Speech, Language and Communications needs",2310,1435,875
Kent,State-funded secondary,Visual Impairment,115,48,67
Kent,State-funded special school,Autistic Spectrum Disorder,3369,2614,755
Kent,State-funded special school,Hearing Impairment,3,1,2
Kent,State-funded special school,Moderate Learning Difficulty,208,121,87
Kent,State-funded special school,Multi- Sensory Impairment,1,0,1
Kent,State-funded special school,Other Difficulty/Disability,23,16,7
Kent,State-funded special school,Physical Disability,219,126,93
Kent,State-funded special school,Profound & Multiple Learning Difficulty,292,160,132
Kent,State-funded special school,SEN support but no specialist assessment of type of need,34,27,7
Kent,State-funded special school,Severe Learning Difficulty,604,368,236
Kent,State-funded special school,"Social, Emotional and Mental Health",618,528,90
Kent,State-funded special school,Specific Learning Difficulty,32,18,14
Kent,State-funded special school,"Speech, Language and Communications needs",633,429,204
Kent,State-funded special school,Visual Impairment,10,6,4
Oxfordshire,Non-maintained special school,Autistic Spectrum Disorder,68,68,0
Oxfordshire,Non-maintained special school,Moderate Learning Difficulty,1,1,0
Oxfordshire,Non-maintained special school,Other Difficulty/Disability,1,1,0
Oxfordshire,Non-maintained special school,"Social, Emotional and Mental Health",23,17,6
Oxfordshire,Non-maintained special school,"Speech, Language and Communications needs",2,2,0
Oxfordshire,State-funded AP school,"Social, Emotional and Mental Health",5,5,0
Oxfordshire,State-funded AP school,"Speech, Language and Communications needs",1,1,0
Oxfordshire,State-funded nursery,Autistic Spectrum Disorder,12,8,4
Oxfordshire,State-funded nursery,Multi- Sensory Impairment,3,3,0
Oxfordshire,State-funded nursery,Other Difficulty/Disability,5,3,2
Oxfordshire,State-funded nursery,Physical Disability,3,2,1
Oxfordshire,State-funded nursery,SEN support but no specialist assessment of type of need,2,2,0
Oxfordshire,State-funded nursery,"Social, Emotional and Mental Health",15,12,3
Oxfordshire,State-funded nursery,Specific Learning Difficulty,1,0,1
Oxfordshire,State-funded nursery,"Speech, Language and Communications needs",57,36,21
Oxfordshire,State-funded primary,Autistic Spectrum Disorder,995,757,238
Oxfordshire,State-funded primary,Hearing Impairment,148,76,72
Oxfordshire,State-funded primary,Moderate Learning Difficulty,1969,1153,816
Oxfordshire,State-funded primary,Multi- Sensory Impairment,20,14,6
Oxfordshire,State-funded primary,Other Difficulty/Disability,132,86,46
Oxfordshire,State-funded primary,Physical Disability,191,96,95
Oxfordshire,State-funded primary,Profound & Multiple Learning Difficulty,50,32,18
Oxfordshire,State-funded primary,SEN support but no specialist assessment of type of need,286,167,119
Oxfordshire,State-funded primary,Severe Learning Difficulty,41,25,16
Oxfordshire,State-funded primary,"Social, Emotional and Mental Health",1903,1321,582
Oxfordshire,State-funded primary,Specific Learning Difficulty,865,486,379
Oxfordshire,State-funded primary,"Speech, Language and Communications needs",3114,2196,918
Oxfordshire,State-funded primary,Visual Impairment,41,19,22
Oxfordshire,State-funded secondary,Autistic Spectrum Disorder,1154,800,354
Oxfordshire,State-funded secondary,Hearing Impairment,133,65,68
Oxfordshire,State-funded secondary,Moderate Learning Difficulty,1615,961,654
Oxfordshire,State-funded secondary,Multi- Sensory Impairment,19,10,9
Oxfordshire,State-funded secondary,Other Difficulty/Disability,268,156,112
Oxfordshire,State-funded secondary,Physical Disability,166,94,72
Oxfordshire,State-funded secondary,Profound & Multiple Learning Difficulty,6,5,1
Oxfordshire,State-funded secondary,SEN support but no specialist assessment of type of need,117,75,42
Oxfordshire,State-funded secondary,Severe Learning Difficulty,12,6,6
Oxfordshire,State-funded secondary,"Social, Emotional and Mental Health",1788,1105,683
Oxfordshire,State-funded secondary,Specific Learning Difficulty,1470,854,616
Oxfordshire,State-funded secondary,"Speech, Language and Communications needs",898,603,295
Oxfordshire,State-funded secondary,Visual Impairment,48,24,24
Oxfordshire,State-funded special school,Autistic Spectrum Disorder,454,367,87
Oxfordshire,State-funded special school,Hearing Impairment,5,3,2
Oxfordshire,State-funded special school,Moderate Learning Difficulty,127,82,45
Oxfordshire,State-funded special school,Multi- Sensory Impairment,4,2,2
Oxfordshire,State-funded special school,Other Difficulty/Disability,12,6,6
Oxfordshire,State-funded special school,Physical Disability,25,14,11
Oxfordshire,State-funded special school,Profound & Multiple Learning Difficulty,72,40,32
Oxfordshire,State-funded special school,Severe Learning Difficulty,330,223,107
Oxfordshire,State-funded special school,"Social, Emotional and Mental Health",139,120,19
Oxfordshire,State-funded special school,Specific Learning Difficulty,19,15,4
Oxfordshire,State-funded special school,"Speech, Language and Communications needs",126,83,43
Oxfordshire,State-funded special school,Visual Impairment,2,2,0
Surrey,Non-maintained special school,Autistic Spectrum Disorder,57,41,16
Surrey,Non-maintained special school,Moderate Learning Difficulty,14,9,5
Surrey,Non-maintained special school,Other Difficulty/Disability,2,1,1
Surrey,Non-maintained special school,Physical Disability,1,1,0
Surrey,Non-maintained special school,Profound & Multiple Learning Difficulty,46,25,21
Surrey,Non-maintained special school,Severe Learning Difficulty,47,36,11
Surrey,Non-maintained special school,"Social, Emotional and Mental Health",1,1,0
Surrey,Non-maintained special school,Specific Learning Difficulty,1,1,0
Surrey,Non-maintained special school,"Speech, Language and Communications needs",291,197,94
Surrey,State-funded AP school,Autistic Spectrum Disorder,2,1,1
Surrey,State-funded AP school,Moderate Learning Difficulty,11,6,5
Surrey,State-funded AP school,Other Difficulty/Disability,5,4,1
Surrey,State-funded AP school,SEN support but no specialist assessment of type of need,2,1,1
Surrey,State-funded AP school,"Social, Emotional and Mental Health",55,28,27
Surrey,State-funded AP school,Specific Learning Difficulty,12,8,4
Surrey,State-funded AP school,"Speech, Language and Communications needs",12,9,3
Surrey,State-funded nursery,Autistic Spectrum Disorder,25,20,5
Surrey,State-funded nursery,Multi- Sensory Impairment,1,1,0
Surrey,State-funded nursery,Other Difficulty/Disability,2,1,1
Surrey,State-funded nursery,Physical Disability,4,2,2
Surrey,State-funded nursery,SEN support but no specialist assessment of type of need,1,1,0
Surrey,State-funded nursery,Severe Learning Difficulty,1,1,0
Surrey,State-funded nursery,Specific Learning Difficulty,3,1,2
Surrey,State-funded nursery,"Speech, Language and Communications needs",89,64,25
Surrey,State-funded nursery,Visual Impairment,1,0,1
Surrey,State-funded primary,Autistic Spectrum Disorder,1468,1127,341
Surrey,State-funded primary,Hearing Impairment,165,87,78
Surrey,State-funded primary,Moderate Learning Difficulty,2081,1190,891
Surrey,State-funded primary,Multi- Sensory Impairment,69,60,9
Surrey,State-funded primary,Other Difficulty/Disability,442,274,168
Surrey,State-funded primary,Physical Disability,273,160,113
Surrey,State-funded primary,Profound & Multiple Learning Difficulty,20,15,5
Surrey,State-funded primary,SEN support but no specialist assessment of type of need,694,431,263
Surrey,State-funded primary,Severe Learning Difficulty,44,30,14
Surrey,State-funded primary,"Social, Emotional and Mental Health",2828,1991,837
Surrey,State-funded primary,Specific Learning Difficulty,1693,934,759
Surrey,State-funded primary,"Speech, Language and Communications needs",4732,3276,1456
Surrey,State-funded primary,Visual Impairment,98,50,48
Surrey,State-funded secondary,Autistic Spectrum Disorder,1343,953,390
Surrey,State-funded secondary,Hearing Impairment,142,66,76
Surrey,State-funded secondary,Moderate Learning Difficulty,1303,722,581
Surrey,State-funded secondary,Multi- Sensory Impairment,51,32,19
Surrey,State-funded secondary,Other Difficulty/Disability,619,362,257
Surrey,State-funded secondary,Physical Disability,237,129,108
Surrey,State-funded secondary,Profound & Multiple Learning Difficulty,4,2,2
Surrey,State-funded secondary,SEN support but no specialist assessment of type of need,374,217,157
Surrey,State-funded secondary,Severe Learning Difficulty,16,5,11
Surrey,State-funded secondary,"Social, Emotional and Mental Health",2568,1616,952
Surrey,State-funded secondary,Specific Learning Difficulty,2652,1466,1186
Surrey,State-funded secondary,"Speech, Language and Communications needs",1201,798,403
Surrey,State-funded secondary,Visual Impairment,107,59,48
Surrey,State-funded special school,Autistic Spectrum Disorder,1307,993,314
Surrey,State-funded special school,Hearing Impairment,4,1,3
Surrey,State-funded special school,Moderate Learning Difficulty,447,258,189
Surrey,State-funded special school,Multi- Sensory Impairment,4,2,2
Surrey,State-funded special school,Other Difficulty/Disability,43,31,12
Surrey,State-funded special school,Physical Disability,39,20,19
Surrey,State-funded special school,Profound & Multiple Learning Difficulty,93,50,43
Surrey,State-funded special school,Severe Learning Difficulty,421,266,155
Surrey,State-funded special school,"Social, Emotional and Mental Health",277,254,23
Surrey,State-funded special school,Specific Learning Difficulty,65,45,20
Surrey,State-funded special school,"Speech, Language and Communications needs",359,245,114
Surrey,State-funded special school,Visual Impairment,4,2,2
West Sussex,Non-maintained special school,Physical Disability,52,36,16
West Sussex,Non-maintained special school,Severe Learning Difficulty,1,0,1
West Sussex,Non-maintained special school,"Social, Emotional and Mental Health",118,118,0
West Sussex,Non-maintained special school,"Speech, Language and Communications needs",10,6,4
West Sussex,State-funded AP school,Autistic Spectrum Disorder,1,1,0
West Sussex,State-funded AP school,Hearing Impairment,1,1,0
West Sussex,State-funded AP school,Moderate Learning Difficulty,13,9,4
West Sussex,State-funded AP school,Other Difficulty/Disability,2,2,0
West Sussex,State-funded AP school,"Social, Emotional and Mental Health",116,82,34
West Sussex,State-funded AP school,Specific Learning Difficulty,5,3,2
West Sussex,State-funded AP school,"Speech, Language and Communications needs",3,2,1
West Sussex,State-funded AP school,Visual Impairment,1,1,0
West Sussex,State-funded nursery,Autistic Spectrum Disorder,6,6,0
West Sussex,State-funded nursery,Moderate Learning Difficulty,1,1,0
West Sussex,State-funded nursery,Other Difficulty/Disability,1,0,1
West Sussex,State-funded nursery,Physical Disability,3,2,1
West Sussex,State-funded nursery,"Social, Emotional and Mental Health",3,2,1
West Sussex,State-funded nursery,"Speech, Language and Communications needs",111,76,35
West Sussex,State-funded nursery,Visual Impairment,2,0,2
West Sussex,State-funded primary,Autistic Spectrum Disorder,739,528,211
West Sussex,State-funded primary,Hearing Impairment,121,67,54
West Sussex,State-funded primary,Moderate Learning Difficulty,1247,746,501
West Sussex,State-funded primary,Multi- Sensory Impairment,34,16,18
West Sussex,State-funded primary,Other Difficulty/Disability,366,227,139
West Sussex,State-funded primary,Physical Disability,233,120,113
West Sussex,State-funded primary,Profound & Multiple Learning Difficulty,13,4,9
West Sussex,State-funded primary,SEN support but no specialist assessment of type of need,649,377,272
West Sussex,State-funded primary,Severe Learning Difficulty,31,17,14
West Sussex,State-funded primary,"Social, Emotional and Mental Health",1724,1231,493
West Sussex,State-funded primary,Specific Learning Difficulty,1368,759,609
West Sussex,State-funded primary,"Speech, Language and Communications needs",3646,2562,1084
West Sussex,State-funded primary,Visual Impairment,75,43,32
West Sussex,State-funded secondary,Autistic Spectrum Disorder,621,424,196
West Sussex,State-funded secondary,Hearing Impairment,137,61,76
West Sussex,State-funded secondary,Moderate Learning Difficulty,1528,886,642
West Sussex,State-funded secondary,Multi- Sensory Impairment,23,12,11
West Sussex,State-funded secondary,Other Difficulty/Disability,746,417,329
West Sussex,State-funded secondary,Physical Disability,246,138,108
West Sussex,State-funded secondary,Profound & Multiple Learning Difficulty,6,5,1
West Sussex,State-funded secondary,SEN support but no specialist assessment of type of need,284,154,130
West Sussex,State-funded secondary,Severe Learning Difficulty,14,10,4
West Sussex,State-funded secondary,"Social, Emotional and Mental Health",1865,1116,749
West Sussex,State-funded secondary,Specific Learning Difficulty,2471,1328,1143
West Sussex,State-funded secondary,"Speech, Language and Communications needs",1466,1042,424
West Sussex,State-funded secondary,Visual Impairment,74,44,30
West Sussex,State-funded special school,Autistic Spectrum Disorder,549,464,85
West Sussex,State-funded special school,Hearing Impairment,4,2,2
West Sussex,State-funded special school,Moderate Learning Difficulty,232,137,95
West Sussex,State-funded special school,Multi- Sensory Impairment,5,0,5
West Sussex,State-funded special school,Other Difficulty/Disability,82,55,27
West Sussex,State-funded special school,Physical Disability,54,31,23
West Sussex,State-funded special school,Profound & Multiple Learning Difficulty,68,34,34
West Sussex,State-funded special school,Severe Learning Difficulty,407,273,134
West Sussex,State-funded special school,"Social, Emotional and Mental Health",244,227,17
West Sussex,State-funded special school,Specific Learning Difficulty,31,15,16
West Sussex,State-funded special school,"Speech, Language and Communications needs",363,250,113
West Sussex,State-funded special school,Visual Impairment,8,5,3
Bath and North East Somerset,State-funded primary,Autistic Spectrum Disorder,205,147,58
Bath and North East Somerset,State-funded primary,Hearing Impairment,39,22,17
Bath and North East Somerset,State-funded primary,Moderate Learning Difficulty,230,142,88
Bath and North East Somerset,State-funded primary,Multi- Sensory Impairment,9,7,2
Bath and North East Somerset,State-funded primary,Other Difficulty/Disability,76,48,28
Bath and North East Somerset,State-funded primary,Physical Disability,59,34,25
Bath and North East Somerset,State-funded primary,Profound & Multiple Learning Difficulty,4,3,1
Bath and North East Somerset,State-funded primary,SEN support but no specialist assessment of type of need,74,39,35
Bath and North East Somerset,State-funded primary,Severe Learning Difficulty,11,8,3
Bath and North East Somerset,State-funded primary,"Social, Emotional and Mental Health",554,363,191
Bath and North East Somerset,State-funded primary,Specific Learning Difficulty,286,151,135
Bath and North East Somerset,State-funded primary,"Speech, Language and Communications needs",791,530,261
Bath and North East Somerset,State-funded primary,Visual Impairment,9,2,7
Bath and North East Somerset,State-funded secondary,Autistic Spectrum Disorder,249,166,83
Bath and North East Somerset,State-funded secondary,Hearing Impairment,30,11,19
Bath and North East Somerset,State-funded secondary,Moderate Learning Difficulty,250,148,102
Bath and North East Somerset,State-funded secondary,Multi- Sensory Impairment,7,3,4
Bath and North East Somerset,State-funded secondary,Other Difficulty/Disability,80,41,39
Bath and North East Somerset,State-funded secondary,Physical Disability,29,12,17
Bath and North East Somerset,State-funded secondary,Profound & Multiple Learning Difficulty,2,1,1
Bath and North East Somerset,State-funded secondary,SEN support but no specialist assessment of type of need,119,72,47
Bath and North East Somerset,State-funded secondary,Severe Learning Difficulty,1,1,0
Bath and North East Somerset,State-funded secondary,"Social, Emotional and Mental Health",520,333,187
Bath and North East Somerset,State-funded secondary,Specific Learning Difficulty,389,208,181
Bath and North East Somerset,State-funded secondary,"Speech, Language and Communications needs",245,169,76
Bath and North East Somerset,State-funded secondary,Visual Impairment,21,12,9
Bath and North East Somerset,State-funded special school,Autistic Spectrum Disorder,143,112,31
Bath and North East Somerset,State-funded special school,Moderate Learning Difficulty,45,27,18
Bath and North East Somerset,State-funded special school,Multi- Sensory Impairment,1,0,1
Bath and North East Somerset,State-funded special school,Other Difficulty/Disability,17,11,6
Bath and North East Somerset,State-funded special school,Physical Disability,3,1,2
Bath and North East Somerset,State-funded special school,Profound & Multiple Learning Difficulty,31,22,9
Bath and North East Somerset,State-funded special school,Severe Learning Difficulty,184,117,67
Bath and North East Somerset,State-funded special school,"Social, Emotional and Mental Health",71,59,12
Bath and North East Somerset,State-funded special school,Specific Learning Difficulty,9,7,2
Bath and North East Somerset,State-funded special school,"Speech, Language and Communications needs",47,37,10
Bath and North East Somerset,State-funded special school,Visual Impairment,2,1,1
"Bristol, City of",State-funded AP school,Autistic Spectrum Disorder,8,4,4
"Bristol, City of",State-funded AP school,Moderate Learning Difficulty,4,3,1
"Bristol, City of",State-funded AP school,Other Difficulty/Disability,8,4,4
"Bristol, City of",State-funded AP school,SEN support but no specialist assessment of type of need,1,0,1
"Bristol, City of",State-funded AP school,"Social, Emotional and Mental Health",67,45,22
"Bristol, City of",State-funded AP school,Specific Learning Difficulty,4,3,1
"Bristol, City of",State-funded AP school,"Speech, Language and Communications needs",7,3,4
"Bristol, City of",State-funded AP school,Visual Impairment,1,0,1
"Bristol, City of",State-funded nursery,Autistic Spectrum Disorder,12,9,3
"Bristol, City of",State-funded nursery,Hearing Impairment,5,2,3
"Bristol, City of",State-funded nursery,Other Difficulty/Disability,2,0,2
"Bristol, City of",State-funded nursery,Physical Disability,12,8,4
"Bristol, City of",State-funded nursery,Severe Learning Difficulty,3,1,2
"Bristol, City of",State-funded nursery,"Social, Emotional and Mental Health",23,18,5
"Bristol, City of",State-funded nursery,Specific Learning Difficulty,3,1,2
"Bristol, City of",State-funded nursery,"Speech, Language and Communications needs",181,130,51
"Bristol, City of",State-funded nursery,Visual Impairment,4,1,3
"Bristol, City of",State-funded primary,Autistic Spectrum Disorder,598,452,146
"Bristol, City of",State-funded primary,Hearing Impairment,102,51,51
"Bristol, City of",State-funded primary,Moderate Learning Difficulty,586,313,273
"Bristol, City of",State-funded primary,Multi- Sensory Impairment,17,15,2
"Bristol, City of",State-funded primary,Other Difficulty/Disability,191,116,75
"Bristol, City of",State-funded primary,Physical Disability,146,83,63
"Bristol, City of",State-funded primary,Profound & Multiple Learning Difficulty,18,9,9
"Bristol, City of",State-funded primary,SEN support but no specialist assessment of type of need,281,174,107
"Bristol, City of",State-funded primary,Severe Learning Difficulty,25,16,9
"Bristol, City of",State-funded primary,"Social, Emotional and Mental Health",1385,954,431
"Bristol, City of",State-funded primary,Specific Learning Difficulty,455,259,196
"Bristol, City of",State-funded primary,"Speech, Language and Communications needs",2236,1523,713
"Bristol, City of",State-funded primary,Visual Impairment,49,25,24
"Bristol, City of",State-funded secondary,Autistic Spectrum Disorder,430,296,134
"Bristol, City of",State-funded secondary,Hearing Impairment,62,31,31
"Bristol, City of",State-funded secondary,Moderate Learning Difficulty,553,316,237
"Bristol, City of",State-funded secondary,Multi- Sensory Impairment,8,8,0
"Bristol, City of",State-funded secondary,Other Difficulty/Disability,317,182,135
"Bristol, City of",State-funded secondary,Physical Disability,127,80,47
"Bristol, City of",State-funded secondary,Profound & Multiple Learning Difficulty,4,2,2
"Bristol, City of",State-funded secondary,SEN support but no specialist assessment of type of need,82,37,45
"Bristol, City of",State-funded secondary,Severe Learning Difficulty,34,15,19
"Bristol, City of",State-funded secondary,"Social, Emotional and Mental Health",1320,798,522
"Bristol, City of",State-funded secondary,Specific Learning Difficulty,1054,535,519
"Bristol, City of",State-funded secondary,"Speech, Language and Communications needs",822,512,310
"Bristol, City of",State-funded secondary,Visual Impairment,42,24,18
"Bristol, City of",State-funded special school,Autistic Spectrum Disorder,527,422,105
"Bristol, City of",State-funded special school,Hearing Impairment,44,24,20
"Bristol, City of",State-funded special school,Moderate Learning Difficulty,55,40,15
"Bristol, City of",State-funded special school,Multi- Sensory Impairment,3,1,2
"Bristol, City of",State-funded special school,Other Difficulty/Disability,15,10,5
"Bristol, City of",State-funded special school,Physical Disability,29,18,11
"Bristol, City of",State-funded special school,Profound & Multiple Learning Difficulty,72,34,38
"Bristol, City of",State-funded special school,Severe Learning Difficulty,101,64,37
"Bristol, City of",State-funded special school,"Social, Emotional and Mental Health",312,267,45
"Bristol, City of",State-funded special school,Specific Learning Difficulty,36,23,13
"Bristol, City of",State-funded special school,"Speech, Language and Communications needs",110,83,27
"Bristol, City of",State-funded special school,Visual Impairment,4,3,1
North Somerset,State-funded AP school,"Social, Emotional and Mental Health",36,26,10
North Somerset,State-funded AP school,Specific Learning Difficulty,4,3,1
North Somerset,State-funded AP school,"Speech, Language and Communications needs",2,1,1
North Somerset,State-funded primary,Autistic Spectrum Disorder,157,116,41
North Somerset,State-funded primary,Hearing Impairment,33,23,10
North Somerset,State-funded primary,Moderate Learning Difficulty,282,171,111
North Somerset,State-funded primary,Multi- Sensory Impairment,7,3,4
North Somerset,State-funded primary,Other Difficulty/Disability,96,62,34
North Somerset,State-funded primary,Physical Disability,74,39,35
North Somerset,State-funded primary,Profound & Multiple Learning Difficulty,9,6,3
North Somerset,State-funded primary,SEN support but no specialist assessment of type of need,64,44,20
North Somerset,State-funded primary,Severe Learning Difficulty,23,13,10
North Somerset,State-funded primary,"Social, Emotional and Mental Health",494,355,139
North Somerset,State-funded primary,Specific Learning Difficulty,265,162,103
North Somerset,State-funded primary,"Speech, Language and Communications needs",580,406,174
North Somerset,State-funded primary,Visual Impairment,15,9,6
North Somerset,State-funded secondary,Autistic Spectrum Disorder,180,119,61
North Somerset,State-funded secondary,Hearing Impairment,37,22,15
North Somerset,State-funded secondary,Moderate Learning Difficulty,277,155,122
North Somerset,State-funded secondary,Multi- Sensory Impairment,4,3,1
North Somerset,State-funded secondary,Other Difficulty/Disability,45,24,21
North Somerset,State-funded secondary,Physical Disability,66,37,29
North Somerset,State-funded secondary,SEN support but no specialist assessment of type of need,52,38,14
North Somerset,State-funded secondary,Severe Learning Difficulty,3,2,1
North Somerset,State-funded secondary,"Social, Emotional and Mental Health",543,328,215
North Somerset,State-funded secondary,Specific Learning Difficulty,615,346,269
North Somerset,State-funded secondary,"Speech, Language and Communications needs",166,108,58
North Somerset,State-funded secondary,Visual Impairment,25,11,14
North Somerset,State-funded special school,Autistic Spectrum Disorder,99,79,20
North Somerset,State-funded special school,Hearing Impairment,6,4,2
North Somerset,State-funded special school,Moderate Learning Difficulty,60,28,32
North Somerset,State-funded special school,Other Difficulty/Disability,4,3,1
North Somerset,State-funded special school,Physical Disability,7,5,2
North Somerset,State-funded special school,Profound & Multiple Learning Difficulty,38,17,21
North Somerset,State-funded special school,Severe Learning Difficulty,75,39,36
North Somerset,State-funded special school,"Social, Emotional and Mental Health",71,57,14
North Somerset,State-funded special school,Specific Learning Difficulty,11,8,3
North Somerset,State-funded special school,"Speech, Language and Communications needs",56,36,20
North Somerset,State-funded special school,Visual Impairment,2,1,1
South Gloucestershire,State-funded AP school,Autistic Spectrum Disorder,6,2,4
South Gloucestershire,State-funded AP school,Moderate Learning Difficulty,1,0,1
South Gloucestershire,State-funded AP school,Physical Disability,1,1,0
South Gloucestershire,State-funded AP school,"Social, Emotional and Mental Health",60,47,13
South Gloucestershire,State-funded AP school,"Speech, Language and Communications needs",3,3,0
South Gloucestershire,State-funded primary,Autistic Spectrum Disorder,412,299,113
South Gloucestershire,State-funded primary,Hearing Impairment,58,27,31
South Gloucestershire,State-funded primary,Moderate Learning Difficulty,375,229,146
South Gloucestershire,State-funded primary,Multi- Sensory Impairment,17,12,5
South Gloucestershire,State-funded primary,Other Difficulty/Disability,98,64,34
South Gloucestershire,State-funded primary,Physical Disability,96,55,41
South Gloucestershire,State-funded primary,Profound & Multiple Learning Difficulty,9,6,3
South Gloucestershire,State-funded primary,SEN support but no specialist assessment of type of need,169,112,57
South Gloucestershire,State-funded primary,Severe Learning Difficulty,20,12,8
South Gloucestershire,State-funded primary,"Social, Emotional and Mental Health",745,545,199
South Gloucestershire,State-funded primary,Specific Learning Difficulty,392,219,173
South Gloucestershire,State-funded primary,"Speech, Language and Communications needs",1105,770,335
South Gloucestershire,State-funded primary,Visual Impairment,33,18,15
South Gloucestershire,State-funded secondary,Autistic Spectrum Disorder,357,246,111
South Gloucestershire,State-funded secondary,Hearing Impairment,51,29,22
South Gloucestershire,State-funded secondary,Moderate Learning Difficulty,328,204,124
South Gloucestershire,State-funded secondary,Multi- Sensory Impairment,2,1,1
South Gloucestershire,State-funded secondary,Other Difficulty/Disability,99,67,32
South Gloucestershire,State-funded secondary,Physical Disability,64,37,27
South Gloucestershire,State-funded secondary,SEN support but no specialist assessment of type of need,69,35,34
South Gloucestershire,State-funded secondary,Severe Learning Difficulty,5,3,2
South Gloucestershire,State-funded secondary,"Social, Emotional and Mental Health",815,512,302
South Gloucestershire,State-funded secondary,Specific Learning Difficulty,533,322,211
South Gloucestershire,State-funded secondary,"Speech, Language and Communications needs",378,234,144
South Gloucestershire,State-funded secondary,Visual Impairment,31,20,11
South Gloucestershire,State-funded special school,Autistic Spectrum Disorder,194,166,28
South Gloucestershire,State-funded special school,Hearing Impairment,5,3,2
South Gloucestershire,State-funded special school,Moderate Learning Difficulty,76,46,30
South Gloucestershire,State-funded special school,Other Difficulty/Disability,6,5,1
South Gloucestershire,State-funded special school,Physical Disability,17,10,7
South Gloucestershire,State-funded special school,Profound & Multiple Learning Difficulty,24,10,14
South Gloucestershire,State-funded special school,Severe Learning Difficulty,108,66,42
South Gloucestershire,State-funded special school,"Social, Emotional and Mental Health",72,62,10
South Gloucestershire,State-funded special school,Specific Learning Difficulty,11,6,5
South Gloucestershire,State-funded special school,"Speech, Language and Communications needs",71,61,10
South Gloucestershire,State-funded special school,Visual Impairment,3,1,2
Plymouth,State-funded AP school,Autistic Spectrum Disorder,22,18,4
Plymouth,State-funded AP school,Moderate Learning Difficulty,2,2,0
Plymouth,State-funded AP school,"Social, Emotional and Mental Health",99,77,22
Plymouth,State-funded AP school,"Speech, Language and Communications needs",4,3,1
Plymouth,State-funded nursery,Moderate Learning Difficulty,8,5,3
Plymouth,State-funded nursery,Physical Disability,2,1,1
Plymouth,State-funded nursery,Severe Learning Difficulty,8,6,2
Plymouth,State-funded nursery,"Social, Emotional and Mental Health",3,3,0
Plymouth,State-funded nursery,"Speech, Language and Communications needs",6,5,1
Plymouth,State-funded primary,Autistic Spectrum Disorder,263,193,70
Plymouth,State-funded primary,Hearing Impairment,67,38,29
Plymouth,State-funded primary,Moderate Learning Difficulty,406,232,174
Plymouth,State-funded primary,Multi- Sensory Impairment,10,8,2
Plymouth,State-funded primary,Other Difficulty/Disability,80,57,23
Plymouth,State-funded primary,Physical Disability,80,44,36
Plymouth,State-funded primary,Profound & Multiple Learning Difficulty,3,0,3
Plymouth,State-funded primary,SEN support but no specialist assessment of type of need,144,79,65
Plymouth,State-funded primary,Severe Learning Difficulty,12,7,5
Plymouth,State-funded primary,"Social, Emotional and Mental Health",857,595,262
Plymouth,State-funded primary,Specific Learning Difficulty,185,99,86
Plymouth,State-funded primary,"Speech, Language and Communications needs",1336,904,432
Plymouth,State-funded primary,Visual Impairment,21,8,13
Plymouth,State-funded secondary,Autistic Spectrum Disorder,477,364,113
Plymouth,State-funded secondary,Hearing Impairment,56,29,27
Plymouth,State-funded secondary,Moderate Learning Difficulty,255,154,101
Plymouth,State-funded secondary,Multi- Sensory Impairment,3,2,1
Plymouth,State-funded secondary,Other Difficulty/Disability,305,154,151
Plymouth,State-funded secondary,Physical Disability,84,49,35
Plymouth,State-funded secondary,Profound & Multiple Learning Difficulty,1,0,1
Plymouth,State-funded secondary,SEN support but no specialist assessment of type of need,34,20,14
Plymouth,State-funded secondary,Severe Learning Difficulty,2,1,1
Plymouth,State-funded secondary,"Social, Emotional and Mental Health",909,547,362
Plymouth,State-funded secondary,Specific Learning Difficulty,283,153,130
Plymouth,State-funded secondary,"Speech, Language and Communications needs",432,271,161
Plymouth,State-funded secondary,Visual Impairment,38,19,19
Plymouth,State-funded special school,Autistic Spectrum Disorder,148,128,20
Plymouth,State-funded special school,Moderate Learning Difficulty,67,48,19
Plymouth,State-funded special school,Multi- Sensory Impairment,4,2,2
Plymouth,State-funded special school,Other Difficulty/Disability,39,30,9
Plymouth,State-funded special school,Physical Disability,77,35,42
Plymouth,State-funded special school,Profound & Multiple Learning Difficulty,8,3,5
Plymouth,State-funded special school,Severe Learning Difficulty,197,148,49
Plymouth,State-funded special school,"Social, Emotional and Mental Health",123,103,20
Plymouth,State-funded special school,Specific Learning Difficulty,6,5,1
Plymouth,State-funded special school,"Speech, Language and Communications needs",67,52,15
Plymouth,State-funded special school,Visual Impairment,1,1,0
Torbay,State-funded AP school,Hearing Impairment,1,0,1
Torbay,State-funded AP school,Moderate Learning Difficulty,1,1,0
Torbay,State-funded AP school,Other Difficulty/Disability,2,2,0
Torbay,State-funded AP school,SEN support but no specialist assessment of type of need,3,2,1
Torbay,State-funded AP school,"Social, Emotional and Mental Health",13,8,5
Torbay,State-funded AP school,Specific Learning Difficulty,2,1,1
Torbay,State-funded AP school,"Speech, Language and Communications needs",1,1,0
Torbay,State-funded primary,Autistic Spectrum Disorder,177,129,48
Torbay,State-funded primary,Hearing Impairment,15,10,5
Torbay,State-funded primary,Moderate Learning Difficulty,136,77,59
Torbay,State-funded primary,Multi- Sensory Impairment,3,1,2
Torbay,State-funded primary,Other Difficulty/Disability,45,29,16
Torbay,State-funded primary,Physical Disability,69,37,32
Torbay,State-funded primary,Profound & Multiple Learning Difficulty,2,1,1
Torbay,State-funded primary,SEN support but no specialist assessment of type of need,97,67,30
Torbay,State-funded primary,Severe Learning Difficulty,5,4,1
Torbay,State-funded primary,"Social, Emotional and Mental Health",358,261,97
Torbay,State-funded primary,Specific Learning Difficulty,206,119,87
Torbay,State-funded primary,"Speech, Language and Communications needs",737,518,219
Torbay,State-funded primary,Visual Impairment,16,7,9
Torbay,State-funded secondary,Autistic Spectrum Disorder,180,128,52
Torbay,State-funded secondary,Hearing Impairment,25,16,9
Torbay,State-funded secondary,Moderate Learning Difficulty,90,51,39
Torbay,State-funded secondary,Multi- Sensory Impairment,1,1,0
Torbay,State-funded secondary,Other Difficulty/Disability,32,22,10
Torbay,State-funded secondary,Physical Disability,53,34,19
Torbay,State-funded secondary,SEN support but no specialist assessment of type of need,46,33,13
Torbay,State-funded secondary,"Social, Emotional and Mental Health",335,201,134
Torbay,State-funded secondary,Specific Learning Difficulty,324,163,161
Torbay,State-funded secondary,"Speech, Language and Communications needs",161,90,71
Torbay,State-funded secondary,Visual Impairment,21,14,7
Torbay,State-funded special school,Autistic Spectrum Disorder,159,127,32
Torbay,State-funded special school,Hearing Impairment,1,1,0
Torbay,State-funded special school,Moderate Learning Difficulty,110,69,41
Torbay,State-funded special school,Multi- Sensory Impairment,1,0,1
Torbay,State-funded special school,Physical Disability,36,19,17
Torbay,State-funded special school,Profound & Multiple Learning Difficulty,19,9,10
Torbay,State-funded special school,Severe Learning Difficulty,61,31,30
Torbay,State-funded special school,"Social, Emotional and Mental Health",100,84,16
Torbay,State-funded special school,Specific Learning Difficulty,10,7,3
Torbay,State-funded special school,"Speech, Language and Communications needs",91,66,25
Torbay,State-funded special school,Visual Impairment,1,1,0
Swindon,State-funded AP school,Autistic Spectrum Disorder,1,0,1
Swindon,State-funded AP school,Moderate Learning Difficulty,3,2,1
Swindon,State-funded AP school,"Social, Emotional and Mental Health",56,35,21
Swindon,State-funded AP school,"Speech, Language and Communications needs",1,1,0
Swindon,State-funded primary,Autistic Spectrum Disorder,283,214,69
Swindon,State-funded primary,Hearing Impairment,81,51,30
Swindon,State-funded primary,Moderate Learning Difficulty,511,301,210
Swindon,State-funded primary,Multi- Sensory Impairment,8,7,1
Swindon,State-funded primary,Other Difficulty/Disability,84,51,33
Swindon,State-funded primary,Physical Disability,83,47,36
Swindon,State-funded primary,Profound & Multiple Learning Difficulty,2,1,1
Swindon,State-funded primary,SEN support but no specialist assessment of type of need,172,102,70
Swindon,State-funded primary,Severe Learning Difficulty,7,4,3
Swindon,State-funded primary,"Social, Emotional and Mental Health",628,448,180
Swindon,State-funded primary,Specific Learning Difficulty,398,221,177
Swindon,State-funded primary,"Speech, Language and Communications needs",905,626,279
Swindon,State-funded primary,Visual Impairment,30,21,9
Swindon,State-funded secondary,Autistic Spectrum Disorder,365,257,108
Swindon,State-funded secondary,Hearing Impairment,75,32,43
Swindon,State-funded secondary,Moderate Learning Difficulty,488,296,192
Swindon,State-funded secondary,Multi- Sensory Impairment,5,2,3
Swindon,State-funded secondary,Other Difficulty/Disability,128,77,51
Swindon,State-funded secondary,Physical Disability,49,29,20
Swindon,State-funded secondary,Profound & Multiple Learning Difficulty,2,0,2
Swindon,State-funded secondary,SEN support but no specialist assessment of type of need,76,47,29
Swindon,State-funded secondary,Severe Learning Difficulty,3,1,2
Swindon,State-funded secondary,"Social, Emotional and Mental Health",660,397,263
Swindon,State-funded secondary,Specific Learning Difficulty,427,258,169
Swindon,State-funded secondary,"Speech, Language and Communications needs",285,175,110
Swindon,State-funded secondary,Visual Impairment,30,16,14
Swindon,State-funded special school,Autistic Spectrum Disorder,300,247,53
Swindon,State-funded special school,Hearing Impairment,9,6,3
Swindon,State-funded special school,Moderate Learning Difficulty,38,22,16
Swindon,State-funded special school,Multi- Sensory Impairment,2,1,1
Swindon,State-funded special school,Other Difficulty/Disability,40,26,14
Swindon,State-funded special school,Physical Disability,13,9,4
Swindon,State-funded special school,Profound & Multiple Learning Difficulty,59,41,18
Swindon,State-funded special school,Severe Learning Difficulty,130,96,34
Swindon,State-funded special school,"Social, Emotional and Mental Health",161,126,35
Swindon,State-funded special school,Specific Learning Difficulty,14,8,6
Swindon,State-funded special school,"Speech, Language and Communications needs",66,52,14
Swindon,State-funded special school,Visual Impairment,2,2,0
Cornwall,State-funded AP school,Autistic Spectrum Disorder,5,4,1
Cornwall,State-funded AP school,Moderate Learning Difficulty,6,5,1
Cornwall,State-funded AP school,Other Difficulty/Disability,2,2,0
Cornwall,State-funded AP school,Physical Disability,1,1,0
Cornwall,State-funded AP school,SEN support but no specialist assessment of type of need,27,20,7
Cornwall,State-funded AP school,"Social, Emotional and Mental Health",53,42,11
Cornwall,State-funded AP school,Specific Learning Difficulty,4,4,0
Cornwall,State-funded AP school,"Speech, Language and Communications needs",5,3,2
Cornwall,State-funded nursery,Autistic Spectrum Disorder,1,1,0
Cornwall,State-funded nursery,Hearing Impairment,1,1,0
Cornwall,State-funded nursery,Moderate Learning Difficulty,3,3,0
Cornwall,State-funded nursery,Multi- Sensory Impairment,2,2,0
Cornwall,State-funded nursery,Other Difficulty/Disability,5,3,2
Cornwall,State-funded nursery,Physical Disability,1,0,1
Cornwall,State-funded nursery,Profound & Multiple Learning Difficulty,1,0,1
Cornwall,State-funded nursery,SEN support but no specialist assessment of type of need,2,1,1
Cornwall,State-funded nursery,Severe Learning Difficulty,1,1,0
Cornwall,State-funded nursery,"Social, Emotional and Mental Health",9,5,4
Cornwall,State-funded nursery,"Speech, Language and Communications needs",25,19,6
Cornwall,State-funded primary,Autistic Spectrum Disorder,421,317,104
Cornwall,State-funded primary,Hearing Impairment,71,35,36
Cornwall,State-funded primary,Moderate Learning Difficulty,1071,608,463
Cornwall,State-funded primary,Multi- Sensory Impairment,60,46,14
Cornwall,State-funded primary,Other Difficulty/Disability,242,152,90
Cornwall,State-funded primary,Physical Disability,159,73,86
Cornwall,State-funded primary,Profound & Multiple Learning Difficulty,15,11,4
Cornwall,State-funded primary,SEN support but no specialist assessment of type of need,334,206,128
Cornwall,State-funded primary,Severe Learning Difficulty,50,31,19
Cornwall,State-funded primary,"Social, Emotional and Mental Health",1375,952,423
Cornwall,State-funded primary,Specific Learning Difficulty,716,406,310
Cornwall,State-funded primary,"Speech, Language and Communications needs",2352,1672,680
Cornwall,State-funded primary,Visual Impairment,41,16,25
Cornwall,State-funded secondary,Autistic Spectrum Disorder,798,581,217
Cornwall,State-funded secondary,Hearing Impairment,80,40,40
Cornwall,State-funded secondary,Moderate Learning Difficulty,884,545,339
Cornwall,State-funded secondary,Multi- Sensory Impairment,36,22,14
Cornwall,State-funded secondary,Other Difficulty/Disability,295,179,116
Cornwall,State-funded secondary,Physical Disability,133,69,64
Cornwall,State-funded secondary,SEN support but no specialist assessment of type of need,215,126,89
Cornwall,State-funded secondary,Severe Learning Difficulty,51,30,21
Cornwall,State-funded secondary,"Social, Emotional and Mental Health",1289,774,515
Cornwall,State-funded secondary,Specific Learning Difficulty,964,548,416
Cornwall,State-funded secondary,"Speech, Language and Communications needs",517,362,155
Cornwall,State-funded secondary,Visual Impairment,53,27,26
Cornwall,State-funded special school,Autistic Spectrum Disorder,129,101,28
Cornwall,State-funded special school,Hearing Impairment,3,3,0
Cornwall,State-funded special school,Moderate Learning Difficulty,57,30,27
Cornwall,State-funded special school,Other Difficulty/Disability,4,2,2
Cornwall,State-funded special school,Physical Disability,24,12,12
Cornwall,State-funded special school,Profound & Multiple Learning Difficulty,47,29,18
Cornwall,State-funded special school,Severe Learning Difficulty,115,69,46
Cornwall,State-funded special school,"Social, Emotional and Mental Health",6,3,3
Cornwall,State-funded special school,"Speech, Language and Communications needs",81,64,17
Cornwall,State-funded special school,Visual Impairment,2,2,0
Isles of Scilly,State-funded secondary,Autistic Spectrum Disorder,4,4,0
Isles of Scilly,State-funded secondary,Moderate Learning Difficulty,1,0,1
Isles of Scilly,State-funded secondary,Multi- Sensory Impairment,1,1,0
Isles of Scilly,State-funded secondary,Physical Disability,1,0,1
Isles of Scilly,State-funded secondary,SEN support but no specialist assessment of type of need,1,1,0
Isles of Scilly,State-funded secondary,"Social, Emotional and Mental Health",1,1,0
Isles of Scilly,State-funded secondary,Specific Learning Difficulty,8,6,2
Isles of Scilly,State-funded secondary,"Speech, Language and Communications needs",6,5,1
Wiltshire,State-funded primary,Autistic Spectrum Disorder,702,526,176
Wiltshire,State-funded primary,Hearing Impairment,94,56,38
Wiltshire,State-funded primary,Moderate Learning Difficulty,1228,713,515
Wiltshire,State-funded primary,Multi- Sensory Impairment,21,12,9
Wiltshire,State-funded primary,Other Difficulty/Disability,196,131,65
Wiltshire,State-funded primary,Physical Disability,168,98,70
Wiltshire,State-funded primary,Profound & Multiple Learning Difficulty,26,20,6
Wiltshire,State-funded primary,SEN support but no specialist assessment of type of need,424,253,171
Wiltshire,State-funded primary,Severe Learning Difficulty,55,28,27
Wiltshire,State-funded primary,"Social, Emotional and Mental Health",1281,892,389
Wiltshire,State-funded primary,Specific Learning Difficulty,776,460,316
Wiltshire,State-funded primary,"Speech, Language and Communications needs",2297,1586,711
Wiltshire,State-funded primary,Visual Impairment,49,30,19
Wiltshire,State-funded secondary,Autistic Spectrum Disorder,812,567,245
Wiltshire,State-funded secondary,Hearing Impairment,77,34,43
Wiltshire,State-funded secondary,Moderate Learning Difficulty,676,393,283
Wiltshire,State-funded secondary,Multi- Sensory Impairment,32,11,21
Wiltshire,State-funded secondary,Other Difficulty/Disability,374,217,157
Wiltshire,State-funded secondary,Physical Disability,129,76,53
Wiltshire,State-funded secondary,Profound & Multiple Learning Difficulty,1,0,1
Wiltshire,State-funded secondary,SEN support but no specialist assessment of type of need,248,154,94
Wiltshire,State-funded secondary,Severe Learning Difficulty,13,10,3
Wiltshire,State-funded secondary,"Social, Emotional and Mental Health",1028,661,367
Wiltshire,State-funded secondary,Specific Learning Difficulty,1097,623,474
Wiltshire,State-funded secondary,"Speech, Language and Communications needs",588,383,205
Wiltshire,State-funded secondary,Visual Impairment,38,20,18
Wiltshire,State-funded special school,Autistic Spectrum Disorder,454,386,68
Wiltshire,State-funded special school,Hearing Impairment,3,2,1
Wiltshire,State-funded special school,Moderate Learning Difficulty,69,36,33
Wiltshire,State-funded special school,Other Difficulty/Disability,16,8,8
Wiltshire,State-funded special school,Physical Disability,11,6,5
Wiltshire,State-funded special school,Profound & Multiple Learning Difficulty,43,27,16
Wiltshire,State-funded special school,Severe Learning Difficulty,119,82,37
Wiltshire,State-funded special school,"Social, Emotional and Mental Health",109,78,31
Wiltshire,State-funded special school,Specific Learning Difficulty,24,14,10
Wiltshire,State-funded special school,"Speech, Language and Communications needs",65,42,23
Wiltshire,State-funded special school,Visual Impairment,4,2,2
"Bournemouth, Christchurch and Poole",Non-maintained special school,Autistic Spectrum Disorder,112,92,20
"Bournemouth, Christchurch and Poole",Non-maintained special school,Moderate Learning Difficulty,7,4,3
"Bournemouth, Christchurch and Poole",Non-maintained special school,Other Difficulty/Disability,8,5,3
"Bournemouth, Christchurch and Poole",Non-maintained special school,Physical Disability,38,24,14
"Bournemouth, Christchurch and Poole",Non-maintained special school,Profound & Multiple Learning Difficulty,36,19,17
"Bournemouth, Christchurch and Poole",Non-maintained special school,Severe Learning Difficulty,15,11,4
"Bournemouth, Christchurch and Poole",Non-maintained special school,"Social, Emotional and Mental Health",7,7,0
"Bournemouth, Christchurch and Poole",Non-maintained special school,Specific Learning Difficulty,8,5,3
"Bournemouth, Christchurch and Poole",Non-maintained special school,"Speech, Language and Communications needs",5,4,1
"Bournemouth, Christchurch and Poole",Non-maintained special school,Visual Impairment,2,1,1
"Bournemouth, Christchurch and Poole",State-funded AP school,Autistic Spectrum Disorder,3,2,1
"Bournemouth, Christchurch and Poole",State-funded AP school,Hearing Impairment,1,0,1
"Bournemouth, Christchurch and Poole",State-funded AP school,SEN support but no specialist assessment of type of need,19,8,11
"Bournemouth, Christchurch and Poole",State-funded AP school,"Social, Emotional and Mental Health",71,43,28
"Bournemouth, Christchurch and Poole",State-funded AP school,"Speech, Language and Communications needs",1,1,0
"Bournemouth, Christchurch and Poole",State-funded primary,Autistic Spectrum Disorder,258,190,68
"Bournemouth, Christchurch and Poole",State-funded primary,Hearing Impairment,58,32,26
"Bournemouth, Christchurch and Poole",State-funded primary,Moderate Learning Difficulty,357,218,139
"Bournemouth, Christchurch and Poole",State-funded primary,Multi- Sensory Impairment,16,11,5
"Bournemouth, Christchurch and Poole",State-funded primary,Other Difficulty/Disability,110,69,41
"Bournemouth, Christchurch and Poole",State-funded primary,Physical Disability,94,51,43
"Bournemouth, Christchurch and Poole",State-funded primary,Profound & Multiple Learning Difficulty,7,5,2
"Bournemouth, Christchurch and Poole",State-funded primary,SEN support but no specialist assessment of type of need,290,189,101
"Bournemouth, Christchurch and Poole",State-funded primary,Severe Learning Difficulty,8,3,5
"Bournemouth, Christchurch and Poole",State-funded primary,"Social, Emotional and Mental Health",676,517,159
"Bournemouth, Christchurch and Poole",State-funded primary,Specific Learning Difficulty,427,251,176
"Bournemouth, Christchurch and Poole",State-funded primary,"Speech, Language and Communications needs",1707,1167,540
"Bournemouth, Christchurch and Poole",State-funded primary,Visual Impairment,37,25,12
"Bournemouth, Christchurch and Poole",State-funded secondary,Autistic Spectrum Disorder,532,350,182
"Bournemouth, Christchurch and Poole",State-funded secondary,Hearing Impairment,79,48,31
"Bournemouth, Christchurch and Poole",State-funded secondary,Moderate Learning Difficulty,341,190,151
"Bournemouth, Christchurch and Poole",State-funded secondary,Multi- Sensory Impairment,14,9,5
"Bournemouth, Christchurch and Poole",State-funded secondary,Other Difficulty/Disability,174,100,74
"Bournemouth, Christchurch and Poole",State-funded secondary,Physical Disability,120,56,64
"Bournemouth, Christchurch and Poole",State-funded secondary,Profound & Multiple Learning Difficulty,3,2,1
"Bournemouth, Christchurch and Poole",State-funded secondary,SEN support but no specialist assessment of type of need,248,141,107
"Bournemouth, Christchurch and Poole",State-funded secondary,Severe Learning Difficulty,6,4,2
"Bournemouth, Christchurch and Poole",State-funded secondary,"Social, Emotional and Mental Health",895,524,371
"Bournemouth, Christchurch and Poole",State-funded secondary,Specific Learning Difficulty,1108,590,518
"Bournemouth, Christchurch and Poole",State-funded secondary,"Speech, Language and Communications needs",473,290,183
"Bournemouth, Christchurch and Poole",State-funded secondary,Visual Impairment,50,29,21
"Bournemouth, Christchurch and Poole",State-funded special school,Autistic Spectrum Disorder,316,256,60
"Bournemouth, Christchurch and Poole",State-funded special school,Hearing Impairment,2,1,1
"Bournemouth, Christchurch and Poole",State-funded special school,Moderate Learning Difficulty,102,64,38
"Bournemouth, Christchurch and Poole",State-funded special school,Multi- Sensory Impairment,1,1,0
"Bournemouth, Christchurch and Poole",State-funded special school,Other Difficulty/Disability,19,13,6
"Bournemouth, Christchurch and Poole",State-funded special school,Physical Disability,6,4,2
"Bournemouth, Christchurch and Poole",State-funded special school,Profound & Multiple Learning Difficulty,35,19,16
"Bournemouth, Christchurch and Poole",State-funded special school,SEN support but no specialist assessment of type of need,2,0,2
"Bournemouth, Christchurch and Poole",State-funded special school,Severe Learning Difficulty,125,86,39
"Bournemouth, Christchurch and Poole",State-funded special school,"Social, Emotional and Mental Health",168,139,29
"Bournemouth, Christchurch and Poole",State-funded special school,Specific Learning Difficulty,34,25,9
"Bournemouth, Christchurch and Poole",State-funded special school,"Speech, Language and Communications needs",138,96,42
"Bournemouth, Christchurch and Poole",State-funded special school,Visual Impairment,1,0,1
Dorset,State-funded AP school,Autistic Spectrum Disorder,6,3,3
Dorset,State-funded AP school,Moderate Learning Difficulty,1,1,0
Dorset,State-funded AP school,Other Difficulty/Disability,5,4,1
Dorset,State-funded AP school,SEN support but no specialist assessment of type of need,1,0,1
Dorset,State-funded AP school,"Social, Emotional and Mental Health",76,54,22
Dorset,State-funded AP school,Specific Learning Difficulty,24,21,3
Dorset,State-funded AP school,"Speech, Language and Communications needs",6,4,2
Dorset,State-funded AP school,Visual Impairment,1,1,0
Dorset,State-funded primary,Autistic Spectrum Disorder,249,174,75
Dorset,State-funded primary,Hearing Impairment,54,28,26
Dorset,State-funded primary,Moderate Learning Difficulty,260,141,119
Dorset,State-funded primary,Multi- Sensory Impairment,13,8,5
Dorset,State-funded primary,Other Difficulty/Disability,183,114,69
Dorset,State-funded primary,Physical Disability,93,59,34
Dorset,State-funded primary,Profound & Multiple Learning Difficulty,7,4,3
Dorset,State-funded primary,SEN support but no specialist assessment of type of need,218,128,90
Dorset,State-funded primary,Severe Learning Difficulty,13,7,6
Dorset,State-funded primary,"Social, Emotional and Mental Health",671,468,203
Dorset,State-funded primary,Specific Learning Difficulty,606,324,282
Dorset,State-funded primary,"Speech, Language and Communications needs",1604,1057,547
Dorset,State-funded primary,Visual Impairment,38,21,17
Dorset,State-funded secondary,Autistic Spectrum Disorder,665,439,226
Dorset,State-funded secondary,Hearing Impairment,78,41,37
Dorset,State-funded secondary,Moderate Learning Difficulty,304,186,118
Dorset,State-funded secondary,Multi- Sensory Impairment,13,7,6
Dorset,State-funded secondary,Other Difficulty/Disability,358,224,134
Dorset,State-funded secondary,Physical Disability,118,67,51
Dorset,State-funded secondary,Profound & Multiple Learning Difficulty,1,1,0
Dorset,State-funded secondary,SEN support but no specialist assessment of type of need,190,96,94
Dorset,State-funded secondary,Severe Learning Difficulty,5,3,2
Dorset,State-funded secondary,"Social, Emotional and Mental Health",917,540,377
Dorset,State-funded secondary,Specific Learning Difficulty,1241,688,553
Dorset,State-funded secondary,"Speech, Language and Communications needs",540,351,189
Dorset,State-funded secondary,Visual Impairment,38,19,19
Dorset,State-funded special school,Autistic Spectrum Disorder,286,223,63
Dorset,State-funded special school,Hearing Impairment,3,2,1
Dorset,State-funded special school,Moderate Learning Difficulty,211,148,63
Dorset,State-funded special school,Other Difficulty/Disability,68,38,30
Dorset,State-funded special school,Physical Disability,10,9,1
Dorset,State-funded special school,Profound & Multiple Learning Difficulty,17,11,6
Dorset,State-funded special school,Severe Learning Difficulty,77,55,22
Dorset,State-funded special school,"Social, Emotional and Mental Health",30,21,9
Dorset,State-funded special school,Specific Learning Difficulty,40,27,13
Dorset,State-funded special school,"Speech, Language and Communications needs",104,69,35
Dorset,State-funded special school,Visual Impairment,2,2,0
Devon,Non-maintained special school,Autistic Spectrum Disorder,1,1,0
Devon,Non-maintained special school,Hearing Impairment,33,25,8
Devon,Non-maintained special school,Multi- Sensory Impairment,11,8,3
Devon,Non-maintained special school,Specific Learning Difficulty,1,1,0
Devon,State-funded AP school,Autistic Spectrum Disorder,3,2,1
Devon,State-funded AP school,Hearing Impairment,1,1,0
Devon,State-funded AP school,Moderate Learning Difficulty,4,1,3
Devon,State-funded AP school,Other Difficulty/Disability,2,2,0
Devon,State-funded AP school,"Social, Emotional and Mental Health",112,77,35
Devon,State-funded AP school,Specific Learning Difficulty,6,3,3
Devon,State-funded AP school,"Speech, Language and Communications needs",8,4,4
Devon,State-funded nursery,Autistic Spectrum Disorder,4,1,3
Devon,State-funded nursery,Profound & Multiple Learning Difficulty,2,0,2
Devon,State-funded nursery,"Social, Emotional and Mental Health",1,1,0
Devon,State-funded nursery,Specific Learning Difficulty,1,0,1
Devon,State-funded nursery,"Speech, Language and Communications needs",5,2,3
Devon,State-funded primary,Autistic Spectrum Disorder,1074,767,307
Devon,State-funded primary,Hearing Impairment,218,115,103
Devon,State-funded primary,Moderate Learning Difficulty,1308,734,574
Devon,State-funded primary,Multi- Sensory Impairment,59,43,16
Devon,State-funded primary,Other Difficulty/Disability,245,145,100
Devon,State-funded primary,Physical Disability,269,148,121
Devon,State-funded primary,Profound & Multiple Learning Difficulty,20,14,6
Devon,State-funded primary,SEN support but no specialist assessment of type of need,359,220,139
Devon,State-funded primary,Severe Learning Difficulty,48,30,18
Devon,State-funded primary,"Social, Emotional and Mental Health",2057,1399,658
Devon,State-funded primary,Specific Learning Difficulty,1027,596,431
Devon,State-funded primary,"Speech, Language and Communications needs",3594,2444,1150
Devon,State-funded primary,Visual Impairment,85,39,46
Devon,State-funded secondary,Autistic Spectrum Disorder,920,604,316
Devon,State-funded secondary,Hearing Impairment,100,47,53
Devon,State-funded secondary,Moderate Learning Difficulty,1057,612,445
Devon,State-funded secondary,Multi- Sensory Impairment,33,21,12
Devon,State-funded secondary,Other Difficulty/Disability,205,122,83
Devon,State-funded secondary,Physical Disability,223,122,101
Devon,State-funded secondary,Profound & Multiple Learning Difficulty,7,7,0
Devon,State-funded secondary,SEN support but no specialist assessment of type of need,102,58,44
Devon,State-funded secondary,Severe Learning Difficulty,32,18,14
Devon,State-funded secondary,"Social, Emotional and Mental Health",1941,1132,809
Devon,State-funded secondary,Specific Learning Difficulty,1432,816,616
Devon,State-funded secondary,"Speech, Language and Communications needs",1529,986,543
Devon,State-funded secondary,Visual Impairment,64,43,21
Devon,State-funded special school,Autistic Spectrum Disorder,583,461,122
Devon,State-funded special school,Hearing Impairment,7,3,4
Devon,State-funded special school,Moderate Learning Difficulty,86,50,36
Devon,State-funded special school,Multi- Sensory Impairment,3,3,0
Devon,State-funded special school,Other Difficulty/Disability,20,13,7
Devon,State-funded special school,Physical Disability,22,12,10
Devon,State-funded special school,Profound & Multiple Learning Difficulty,55,31,24
Devon,State-funded special school,Severe Learning Difficulty,334,223,111
Devon,State-funded special school,"Social, Emotional and Mental Health",252,223,29
Devon,State-funded special school,Specific Learning Difficulty,33,22,11
Devon,State-funded special school,"Speech, Language and Communications needs",221,164,57
Devon,State-funded special school,Visual Impairment,4,1,3
Gloucestershire,Non-maintained special school,Autistic Spectrum Disorder,4,3,1
Gloucestershire,Non-maintained special school,Hearing Impairment,1,1,0
Gloucestershire,Non-maintained special school,Moderate Learning Difficulty,1,1,0
Gloucestershire,Non-maintained special school,Other Difficulty/Disability,2,1,1
Gloucestershire,Non-maintained special school,Physical Disability,2,2,0
Gloucestershire,Non-maintained special school,Profound & Multiple Learning Difficulty,20,11,9
Gloucestershire,Non-maintained special school,Severe Learning Difficulty,14,7,7
Gloucestershire,Non-maintained special school,Specific Learning Difficulty,2,1,1
Gloucestershire,Non-maintained special school,"Speech, Language and Communications needs",5,3,2
Gloucestershire,State-funded AP school,Autistic Spectrum Disorder,1,1,0
Gloucestershire,State-funded AP school,Moderate Learning Difficulty,10,9,1
Gloucestershire,State-funded AP school,Other Difficulty/Disability,3,2,1
Gloucestershire,State-funded AP school,SEN support but no specialist assessment of type of need,3,2,1
Gloucestershire,State-funded AP school,"Social, Emotional and Mental Health",48,39,9
Gloucestershire,State-funded AP school,Specific Learning Difficulty,3,3,0
Gloucestershire,State-funded AP school,"Speech, Language and Communications needs",5,4,1
Gloucestershire,State-funded primary,Autistic Spectrum Disorder,311,231,80
Gloucestershire,State-funded primary,Hearing Impairment,83,43,40
Gloucestershire,State-funded primary,Moderate Learning Difficulty,3173,1834,1339
Gloucestershire,State-funded primary,Multi- Sensory Impairment,21,16,5
Gloucestershire,State-funded primary,Other Difficulty/Disability,281,167,114
Gloucestershire,State-funded primary,Physical Disability,183,114,69
Gloucestershire,State-funded primary,Profound & Multiple Learning Difficulty,16,14,2
Gloucestershire,State-funded primary,SEN support but no specialist assessment of type of need,372,212,160
Gloucestershire,State-funded primary,Severe Learning Difficulty,79,50,29
Gloucestershire,State-funded primary,"Social, Emotional and Mental Health",1696,1234,462
Gloucestershire,State-funded primary,Specific Learning Difficulty,959,567,392
Gloucestershire,State-funded primary,"Speech, Language and Communications needs",1918,1339,579
Gloucestershire,State-funded primary,Visual Impairment,52,30,22
Gloucestershire,State-funded secondary,Autistic Spectrum Disorder,395,286,109
Gloucestershire,State-funded secondary,Hearing Impairment,97,36,61
Gloucestershire,State-funded secondary,Moderate Learning Difficulty,1339,821,518
Gloucestershire,State-funded secondary,Multi- Sensory Impairment,13,10,3
Gloucestershire,State-funded secondary,Other Difficulty/Disability,566,327,239
Gloucestershire,State-funded secondary,Physical Disability,143,65,78
Gloucestershire,State-funded secondary,Profound & Multiple Learning Difficulty,2,1,1
Gloucestershire,State-funded secondary,SEN support but no specialist assessment of type of need,155,102,53
Gloucestershire,State-funded secondary,Severe Learning Difficulty,12,4,8
Gloucestershire,State-funded secondary,"Social, Emotional and Mental Health",1251,772,479
Gloucestershire,State-funded secondary,Specific Learning Difficulty,1114,626,488
Gloucestershire,State-funded secondary,"Speech, Language and Communications needs",544,351,193
Gloucestershire,State-funded secondary,Visual Impairment,57,21,36
Gloucestershire,State-funded special school,Autistic Spectrum Disorder,301,234,67
Gloucestershire,State-funded special school,Hearing Impairment,3,2,1
Gloucestershire,State-funded special school,Moderate Learning Difficulty,74,47,27
Gloucestershire,State-funded special school,Multi- Sensory Impairment,5,4,1
Gloucestershire,State-funded special school,Other Difficulty/Disability,33,23,10
Gloucestershire,State-funded special school,Physical Disability,23,17,6
Gloucestershire,State-funded special school,Profound & Multiple Learning Difficulty,81,43,38
Gloucestershire,State-funded special school,Severe Learning Difficulty,434,316,118
Gloucestershire,State-funded special school,"Social, Emotional and Mental Health",198,169,29
Gloucestershire,State-funded special school,Specific Learning Difficulty,71,38,33
Gloucestershire,State-funded special school,"Speech, Language and Communications needs",205,145,60
Gloucestershire,State-funded special school,Visual Impairment,6,5,1
Somerset,State-funded AP school,Autistic Spectrum Disorder,6,5,1
Somerset,State-funded AP school,Hearing Impairment,2,1,1
Somerset,State-funded AP school,Moderate Learning Difficulty,3,3,0
Somerset,State-funded AP school,Multi- Sensory Impairment,1,1,0
Somerset,State-funded AP school,Other Difficulty/Disability,4,1,3
Somerset,State-funded AP school,SEN support but no specialist assessment of type of need,4,4,0
Somerset,State-funded AP school,Severe Learning Difficulty,1,1,0
Somerset,State-funded AP school,"Social, Emotional and Mental Health",95,66,29
Somerset,State-funded AP school,Specific Learning Difficulty,5,5,0
Somerset,State-funded AP school,"Speech, Language and Communications needs",9,8,1
Somerset,State-funded AP school,Visual Impairment,1,1,0
Somerset,State-funded primary,Autistic Spectrum Disorder,429,341,88
Somerset,State-funded primary,Hearing Impairment,79,45,34
Somerset,State-funded primary,Moderate Learning Difficulty,684,399,285
Somerset,State-funded primary,Multi- Sensory Impairment,36,26,10
Somerset,State-funded primary,Other Difficulty/Disability,253,144,109
Somerset,State-funded primary,Physical Disability,165,78,87
Somerset,State-funded primary,Profound & Multiple Learning Difficulty,16,12,4
Somerset,State-funded primary,SEN support but no specialist assessment of type of need,170,105,65
Somerset,State-funded primary,Severe Learning Difficulty,50,33,17
Somerset,State-funded primary,"Social, Emotional and Mental Health",1243,892,351
Somerset,State-funded primary,Specific Learning Difficulty,653,356,297
Somerset,State-funded primary,"Speech, Language and Communications needs",1916,1315,601
Somerset,State-funded primary,Visual Impairment,64,37,27
Somerset,State-funded secondary,Autistic Spectrum Disorder,413,298,115
Somerset,State-funded secondary,Hearing Impairment,98,56,42
Somerset,State-funded secondary,Moderate Learning Difficulty,752,440,312
Somerset,State-funded secondary,Multi- Sensory Impairment,26,17,9
Somerset,State-funded secondary,Other Difficulty/Disability,228,130,98
Somerset,State-funded secondary,Physical Disability,131,65,66
Somerset,State-funded secondary,Profound & Multiple Learning Difficulty,7,1,6
Somerset,State-funded secondary,SEN support but no specialist assessment of type of need,90,53,37
Somerset,State-funded secondary,Severe Learning Difficulty,26,18,8
Somerset,State-funded secondary,"Social, Emotional and Mental Health",1559,984,575
Somerset,State-funded secondary,Specific Learning Difficulty,1075,639,436
Somerset,State-funded secondary,"Speech, Language and Communications needs",696,486,210
Somerset,State-funded secondary,Visual Impairment,60,27,33
Somerset,State-funded special school,Autistic Spectrum Disorder,390,307,83
Somerset,State-funded special school,Hearing Impairment,2,1,1
Somerset,State-funded special school,Moderate Learning Difficulty,77,41,36
Somerset,State-funded special school,Multi- Sensory Impairment,1,1,0
Somerset,State-funded special school,Other Difficulty/Disability,5,4,1
Somerset,State-funded special school,Physical Disability,21,9,12
Somerset,State-funded special school,Profound & Multiple Learning Difficulty,59,32,27
Somerset,State-funded special school,Severe Learning Difficulty,196,134,62
Somerset,State-funded special school,"Social, Emotional and Mental Health",114,103,11
Somerset,State-funded special school,Specific Learning Difficulty,18,10,8
Somerset,State-funded special school,"Speech, Language and Communications needs",116,78,38
Somerset,State-funded special school,Visual Impairment,9,6,3
