la_name,school_name,Total pupils,SEN support,EHC plan,Total Sen
City of London,The Aldgate School,271,59,8,67
City of London,City of London School for Girls,739,22,0,22
City of London,St Paul's Cathedral School,269,22,0,22
City of London,City of London School,1045,145,0,145
Camden,Thomas Coram Centre,136,23,2,25
Camden,Camden Centre for Learning (Ccfl) PRU,19,13,0,13
Camden,Camden Primary Pupil Referral Unit,19,10,9,19
Camden,Argyle Primary School,350,61,12,73
Camden,West Hampstead Primary School,389,62,11,73
Camden,Brecknock Primary School,338,65,12,77
Camden,Brookfield Primary School,394,54,4,58
Camden,Edith Neville Primary School,200,46,6,52
Camden,Fleet Primary School,228,38,5,43
Camden,Hawley Primary School,225,41,5,46
Camden,Netley Primary School & Centre for Autism,393,85,42,127
Camden,New End Primary School,355,37,3,40
Camden,Primrose Hill School,457,82,19,101
Camden,Rhyl Community Primary School,421,112,13,125
Camden,Richard Cobden Primary School,411,71,9,80
Camden,Torriano Primary School,450,60,27,87
Camden,Gospel Oak Primary School,452,56,9,65
Camden,Fitzjohn's Primary School,230,17,7,24
Camden,Eleanor Palmer Primary School,236,42,7,49
Camden,"Christ Church Primary School, Hampstead",192,12,1,13
Camden,Christ Church School,203,26,9,35
Camden,Emmanuel Church of England Primary School,229,22,5,27
Camden,Hampstead Parochial Church of England Primary School,204,17,1,18
Camden,"Holy Trinity CofE Primary School, NW3",176,17,4,21
Camden,"Holy Trinity and Saint Silas CofE Primary School, NW1",210,43,4,47
Camden,Kentish Town Church of England Primary School,234,25,25,50
Camden,Rosary Catholic Primary School,322,41,6,47
Camden,St Alban's Church of England Primary School,158,15,12,27
Camden,St Dominic's Catholic Primary School,46,11,4,15
Camden,St George the Martyr Church of England Primary School,212,40,2,42
Camden,St Josephs Catholic Primary School,176,27,4,31
Camden,St Mary's Kilburn Church of England Primary School,228,41,7,48
Camden,St Mary and St Pancras Church of England Primary School,204,33,3,36
Camden,St Michael's Church of England Primary School,0,0,0,0
Camden,St Patrick's Catholic Primary School,160,46,3,49
Camden,St Paul's Church of England Primary School,194,27,2,29
Camden,St Eugene de Mazenod Roman Catholic Primary School,198,28,6,34
Camden,Our Lady Roman Catholic Primary School,292,48,9,57
Camden,Haverstock School,982,188,28,216
Camden,Parliament Hill School,1249,167,16,183
Camden,Regent High School,1079,193,39,232
Camden,Hampstead School,1319,127,38,165
Camden,Acland Burghley School,1163,139,87,226
Camden,The Camden School for Girls,1047,115,13,128
Camden,Maria Fidelis Catholic School FCJ,832,93,24,117
Camden,William Ellis School,904,149,30,179
Camden,La Sainte Union Catholic Secondary School,817,70,8,78
Camden,Children's Hospital School at Gt Ormond Street and UCH,0,0,0,0
Camden,St Christopher's School,250,51,1,52
Camden,St Margaret's School,166,22,0,22
Camden,Sarum Hall School,185,31,1,32
Camden,The Hall School,469,100,0,100
Camden,University College School,1293,168,2,170
Camden,The Cavendish School,216,77,0,77
Camden,"St Mary's School, Hampstead",204,24,4,28
Camden,North Bridge House Nursery & Pre-Prep Schools,302,52,0,52
Camden,Hereward House School,172,35,1,36
Camden,St Anthony's School for Boys,275,75,1,76
Camden,Hampstead Hill School,388,47,0,47
Camden,North Bridge House Senior School,470,46,4,50
Camden,Trevor-Roberts School,169,17,0,17
Camden,South Hampstead High School,949,98,0,98
Camden,The Village School,68,15,0,15
Camden,Heathside Preparatory School,193,40,3,43
Camden,Devonshire House Preparatory School,561,20,1,21
Camden,Broadhurst School,120,5,0,5
Camden,College Francais Bilingue De Londres,691,83,1,84
Camden,Fine Arts College,227,80,4,84
Camden,The Mulberry House School,195,4,0,4
Camden,Southbank International School Hampstead,168,0,54,54
Camden,Frank Barnes School for Deaf Children,38,0,38,38
Camden,Camden Centre for Learning (CCfL) Special School,41,0,41,41
Camden,Royal Free Hospital Children's School,78,74,4,78
Camden,Swiss Cottage School - Development & Research Centre,261,0,261,261
Greenwich,Rachel McMillan Nursery School and Children's Centre,156,25,1,26
Greenwich,Pound Park Nursery School,171,57,0,57
Greenwich,Abbey Wood Nursery School,120,23,3,26
Greenwich,Robert Owen Nursery School,162,24,0,24
Greenwich,Newhaven Pupil Referral Unit,166,101,64,165
Greenwich,Bannockburn Primary School,886,126,25,151
Greenwich,Morden Mount Primary School,398,80,5,85
Greenwich,Cherry Orchard Primary School,226,57,14,71
Greenwich,Ealdham Primary School,398,62,3,65
Greenwich,Fossdene Primary School,319,100,9,109
Greenwich,Gallions Mount Primary School,263,32,7,39
Greenwich,Gordon Primary School,436,54,14,68
Greenwich,Haimo Primary School,373,69,8,77
Greenwich,Henwick Primary School,386,83,9,92
Greenwich,Invicta Primary School,785,121,14,135
Greenwich,Kidbrooke Park Primary School,400,105,19,124
Greenwich,Meridian Primary School,226,57,5,62
Greenwich,Plumcroft Primary School,957,238,19,257
Greenwich,Sherington Primary School,429,53,4,57
Greenwich,Thorntree Primary School,202,23,6,29
Greenwich,Wyborne Primary School,446,36,19,55
Greenwich,Montbelle Primary School,438,59,9,68
Greenwich,Boxgrove Primary School,428,120,18,138
Greenwich,De Lucy Primary School,365,114,9,123
Greenwich,Cardwell Primary School,461,78,11,89
Greenwich,Heronsgate Primary School,775,75,6,81
Greenwich,Linton Mead Primary School,357,70,4,74
Greenwich,Greenslade Primary School,222,27,7,34
Greenwich,Mulgrave Primary School,397,66,8,74
Greenwich,Charlton Manor Primary School,432,42,14,56
Greenwich,Christ Church Church of England Primary School,178,28,3,31
Greenwich,"Christ Church Church of England Primary School, Shooters Hill",209,32,7,39
Greenwich,Eltham Church of England Primary School,457,83,16,99
Greenwich,Our Lady of Grace Catholic Primary School,415,33,10,43
Greenwich,St Joseph's Catholic Primary School,161,25,4,29
Greenwich,St Margaret's Church of England Primary School,297,48,6,54
Greenwich,Saint Mary Magdalene Church of England All Through School,1708,257,30,287
Greenwich,St Patrick's Catholic Primary School,337,43,4,47
Greenwich,St Alfege with St Peter's Church of England Primary School,217,28,5,33
Greenwich,St Peter's Catholic Primary School,205,19,2,21
Greenwich,St Thomas More Catholic Primary School,184,16,1,17
Greenwich,St Thomas A Becket Roman Catholic Primary School,429,37,7,44
Greenwich,Holy Family Catholic Primary School,152,15,4,19
Greenwich,Notre Dame Catholic Primary School,177,20,3,23
Greenwich,St Margaret Clitherow Catholic Primary School,197,40,2,42
Greenwich,Bishop John Robinson Church of England Primary School,220,28,7,35
Greenwich,Eltham Hill School,1227,174,11,185
Greenwich,Plumstead Manor School,1494,233,45,278
Greenwich,Thomas Tallis School,2110,409,119,528
Greenwich,St Ursula's Convent School,631,48,6,54
Greenwich,The Pointer School,339,36,1,37
Greenwich,Blackheath Prep,384,35,0,35
Greenwich,Riverston School,179,10,122,132
Greenwich,St Olave's Prep School,212,43,2,45
Greenwich,Colfe's School,1280,290,6,296
Lewisham,Heath House Preparatory School,126,2,0,2
Greenwich,King's Oak School,40,0,40,40
Hackney,Wentworth Nursery School and Children's Centre,91,0,3,3
Hackney,Comet Nursery School and Children's Centre,121,38,3,41
Hackney,Berger Primary School,452,66,28,94
Hackney,Colvestone Primary School,134,23,10,33
Hackney,Daubeney Primary School,450,54,22,76
Hackney,De Beauvoir Primary School,127,30,10,40
Hackney,Gainsborough Primary School,273,41,24,65
Hackney,Lauriston School,398,40,8,48
Hackney,London Fields Primary School,431,80,20,100
Hackney,Millfields Community School,658,74,36,110
Hackney,Morningside Primary School,455,122,24,146
Hackney,Orchard Primary School,628,125,16,141
Hackney,Queensbridge Primary School,420,78,38,116
Hackney,Randal Cremer Primary School,264,49,14,63
Hackney,Princess May Primary School,221,21,10,31
Hackney,Sebright School,412,58,10,68
Hackney,Shacklewell Primary School,471,56,14,70
Hackney,Southwold Primary School,370,78,9,87
Hackney,Thomas Fairchild Community School,206,54,13,67
Hackney,Oldhill Community School,290,71,26,97
Hackney,Shoreditch Park Primary School,418,56,50,106
Hackney,Woodberry Down Community Primary School,667,73,34,107
Hackney,Kingsmead Primary School,225,37,12,49
Hackney,Sir Thomas Abney School,226,55,17,72
Hackney,Grasmere Primary School,206,20,8,28
Hackney,Jubilee Primary School,426,53,18,71
Hackney,Nightingale Primary School,221,36,24,60
Hackney,Baden-Powell School,172,22,8,30
Hackney,Harrington Hill Primary School,191,33,9,42
Hackney,Holmleigh Primary School,212,28,11,39
Hackney,Grazebrook Primary School,467,51,15,66
Hackney,Parkwood Primary School,210,17,8,25
Hackney,Benthal Primary School,296,73,7,80
Hackney,Mandeville Primary School,261,52,9,61
Hackney,Holy Trinity Church of England Primary School,270,43,14,57
Hackney,Our Lady and St Joseph Catholic Primary School,195,23,6,29
Hackney,St John the Baptist Voluntary Aided Church of England Primary School,307,49,23,72
Hackney,St Matthias Church of England Primary School,163,37,6,43
Hackney,St Monica's Roman Catholic Primary School,217,20,5,25
Hackney,St. Paul's With St. Michael's CofE Primary School,196,44,6,50
Hackney,St John of Jerusalem Church of England Primary School,132,48,6,54
Hackney,"St Mary's Church of England Primary School, Stoke Newington",135,24,5,29
Hackney,St Scholastica's Catholic Primary School,207,40,13,53
Hackney,Simon Marks Jewish Primary School,112,29,7,36
Hackney,Haggerston School,1053,205,42,247
Hackney,Stoke Newington School and Sixth Form,1708,283,73,356
Hackney,Our Lady's Catholic High School,576,39,6,45
Hackney,The Urswick School - A Church of England Secondary School,893,225,35,260
Hackney,Cardinal Pole Catholic School,1101,184,26,210
Hackney,Yesodey Hatorah School,196,39,4,43
Hackney,Talmud Torah Yetev Lev,887,81,12,93
Hackney,Bnois Jerusalem Girls School,721,54,8,62
Hackney,Beis Rochel d'Satmar Girls' School,1211,87,31,118
Hackney,Talmud Torah Machzikei Hadass School,642,45,25,70
Hackney,Beis Malka Girls' School,561,91,25,116
Hackney,Talmud Torah Chaim Meirim Wiznitz School,245,46,12,58
Hackney,Bobov Primary Boys School,233,45,15,60
Hackney,T T T Y Y School,154,26,5,31
Hackney,Tayyibah Girls' School,172,0,0,0
Tower Hamlets,River House Montessori School,166,24,4,28
Hackney,Stormont House School,139,0,139,139
Hackney,The Garden School,182,2,180,182
Hackney,Ickburgh School,156,0,156,156
Hammersmith and Fulham,Randolph Beresford Early Years Centre,128,33,2,35
Hammersmith and Fulham,Vanessa Nursery School,86,13,3,16
Hammersmith and Fulham,James Lee Nursery School,52,7,0,7
Hammersmith and Fulham,Bayonne Nursery School,67,17,0,17
Hammersmith and Fulham,Addison Primary School,252,17,4,21
Hammersmith and Fulham,Avonmore Primary School,195,24,11,35
Hammersmith and Fulham,Brackenbury Primary School,366,39,14,53
Hammersmith and Fulham,Miles Coverdale Primary School,217,34,24,58
Hammersmith and Fulham,Flora Gardens Primary School,186,33,5,38
Hammersmith and Fulham,Kenmont Primary School,186,24,4,28
Hammersmith and Fulham,Melcombe Primary School,172,16,9,25
Hammersmith and Fulham,Old Oak Primary School,237,54,13,67
Hammersmith and Fulham,Sir John Lillie Primary School,243,46,7,53
Hammersmith and Fulham,Wendell Park Primary School,363,44,11,55
Hammersmith and Fulham,Wormholt Park Primary School,340,122,13,135
Hammersmith and Fulham,All Saints CofE Primary School,200,30,3,33
Hammersmith and Fulham,Holy Cross RC School,596,53,26,79
Hammersmith and Fulham,John Betts Primary School,207,24,5,29
Hammersmith and Fulham,St Augustine's RC Primary School,203,18,10,28
Hammersmith and Fulham,St Johns Walham Green Church of England Primary School,352,41,13,54
Hammersmith and Fulham,St Mary's Catholic Primary School,164,15,13,28
Hammersmith and Fulham,St Paul's CofE Primary School,192,57,10,67
Hammersmith and Fulham,St Peter's Primary School,205,24,7,31
Hammersmith and Fulham,St Stephen's CofE Primary School,439,31,11,42
Hammersmith and Fulham,Good Shepherd RC Primary School,221,24,5,29
Hammersmith and Fulham,St John XXIII Catholic Primary School,345,45,14,59
Hammersmith and Fulham,St Thomas of Canterbury Catholic Primary School,139,19,5,24
Hammersmith and Fulham,St Paul's Girls' School,799,53,1,54
Hammersmith and Fulham,Bute House Preparatory School for Girls,319,27,0,27
Hammersmith and Fulham,The Godolphin and Latymer School,812,106,0,106
Hammersmith and Fulham,Latymer Upper School,1439,347,7,354
Hammersmith and Fulham,Ecole Française de Londres Jacques Prévert,252,24,0,24
Hammersmith and Fulham,Evergreen Primary School,83,4,0,4
Hammersmith and Fulham,Ravenscourt Park Preparatory School,416,21,0,21
Hammersmith and Fulham,L'Ecole des Petits School,119,5,0,5
Hammersmith and Fulham,Woodlane High School,113,0,113,113
Hammersmith and Fulham,Jack Tizard School,70,0,70,70
Hammersmith and Fulham,Cambridge School,138,0,138,138
Islington,Margaret McMillan Nursery School,89,21,0,21
Islington,Kate Greenaway Nursery School and Children's Centre,93,15,0,15
Islington,North Islington Nursery School,110,0,0,0
Islington,New River College Primary,16,8,8,16
Islington,New River College Secondary,42,34,8,42
Islington,Ambler Primary School and Children's Centre,505,70,15,85
Islington,Copenhagen Primary School,143,17,17,34
Islington,Drayton Park Primary School,282,24,12,36
Islington,Duncombe Primary School,389,43,19,62
Islington,Gillespie Primary School,225,37,8,45
Islington,Grafton Primary School,421,161,15,176
Islington,Hanover Primary School,302,41,5,46
Islington,Hargrave Park Primary School,369,62,11,73
Islington,Laycock Primary School,321,73,70,143
Islington,Moreland Primary School,428,86,21,107
Islington,Pakeman Primary School,331,52,9,61
Islington,Robert Blair School,231,57,15,72
Islington,Thornhill Primary School,457,63,20,83
Islington,Vittoria Primary School,151,18,5,23
Islington,Winton Primary School,234,38,6,44
Islington,Yerbury Primary School,453,48,12,60
Islington,Tufnell Park Primary School,435,46,21,67
Islington,Highbury Quadrant Primary School,250,55,10,65
Islington,Ashmount Primary School,403,38,24,62
Islington,Prior Weston Primary School and Children's Centre,324,58,21,79
Islington,Sacred Heart Catholic Primary School,440,42,17,59
Islington,St John Evangelist RC Primary School,250,68,14,82
Islington,St John's Upper Holloway CofE Primary School,219,48,8,56
Islington,St John's Highbury Vale CofE Primary School,196,38,7,45
Islington,St Joseph's Catholic Primary School,417,32,5,37
Islington,St Jude and St Paul's CofE Primary School,132,14,12,26
Islington,St Luke's CofE Primary School,227,35,9,44
Islington,St Mark's CofE Primary School,224,74,17,91
Islington,St Mary's CofE Primary School,156,26,1,27
Islington,St Peter and St Paul Catholic Primary School,213,42,5,47
Islington,St Andrew's (Barnsbury) Church of England Primary School,181,29,7,36
Islington,St Joan of Arc RC Primary School,424,67,18,85
Islington,Christ The King Catholic Primary School,251,51,8,59
Islington,Blessed Sacrament RC Primary School,100,32,2,34
Islington,Beacon High,381,67,34,101
Islington,Highbury Fields School,767,126,12,138
Islington,Elizabeth Garrett Anderson School,884,155,28,183
Islington,Central Foundation Boys' School,1106,202,38,240
Islington,St Aloysius RC College,515,51,16,67
Islington,Dallington School,60,9,0,9
City of London,Charterhouse Square School,253,24,0,24
Islington,Richard Cloudesley School,84,0,84,84
Islington,Samuel Rhodes MLD School,139,1,138,139
Kensington and Chelsea,Golborne Children's Centre,43,15,2,17
Kensington and Chelsea,St Anne's & Avondale Park Nursery School,47,20,0,20
Kensington and Chelsea,Chelsea Open Air Nursery School,66,15,2,17
Kensington and Chelsea,Maxilla Nursery School,45,11,2,13
Kensington and Chelsea,Ashburnham Community School,181,30,10,40
Kensington and Chelsea,Barlby Primary School,356,74,27,101
Kensington and Chelsea,Bevington Primary School,324,31,14,45
Kensington and Chelsea,Bousfield Primary School,431,44,16,60
Kensington and Chelsea,Colville Primary School,464,56,9,65
Kensington and Chelsea,Fox Primary School,417,66,25,91
Kensington and Chelsea,Marlborough Primary School,408,37,28,65
Kensington and Chelsea,Oxford Gardens Primary School,249,22,16,38
Kensington and Chelsea,Park Walk Primary School,180,12,7,19
Kensington and Chelsea,Avondale Park Primary School,321,86,13,99
Kensington and Chelsea,Thomas Jones Primary School,236,36,10,46
Kensington and Chelsea,Christ Church CofE Primary School,203,25,16,41
Kensington and Chelsea,Holy Trinity CofE Primary School,188,28,16,44
Kensington and Chelsea,Oratory Roman Catholic Primary School,211,27,5,32
Kensington and Chelsea,St Thomas' CofE Primary School,201,30,14,44
Kensington and Chelsea,St Barnabas and St Philip's CofE Primary School,183,18,6,24
Kensington and Chelsea,Saint Francis of Assisi Catholic Primary School,183,29,4,33
Kensington and Chelsea,St Clement and St James CofE Primary School,159,27,7,34
Kensington and Chelsea,St Mary Abbots CofE Primary School,175,14,5,19
Kensington and Chelsea,St Cuthbert with St Matthias CofE Primary School,156,23,3,26
Kensington and Chelsea,Saint Mary's Catholic Primary School,213,29,12,41
Kensington and Chelsea,Servite RC Primary School,210,21,13,34
Kensington and Chelsea,Saint Thomas More Language College,637,66,20,86
Kensington and Chelsea,All Saints Catholic College,797,140,48,188
Kensington and Chelsea,Our Lady of Victories RC Primary School,181,14,4,18
Kensington and Chelsea,St Charles Catholic Primary School,235,29,10,39
Kensington and Chelsea,Redcliffe Gardens School,74,9,0,9
Kensington and Chelsea,Glendower Preparatory School,288,20,0,20
Hammersmith and Fulham,Kensington Prep School,293,10,0,10
Kensington and Chelsea,Norland Place School,218,23,0,23
Kensington and Chelsea,Queen's Gate School,491,124,0,124
Kensington and Chelsea,Bassett House School,117,2,23,25
Kensington and Chelsea,Sussex House School,187,37,1,38
Kensington and Chelsea,St Philip's School,74,8,0,8
Kensington and Chelsea,Hill House School,482,73,2,75
Kensington and Chelsea,Wetherby School,358,100,0,100
Kensington and Chelsea,Falkner House,356,0,0,0
Kensington and Chelsea,More House School,138,70,2,72
Kensington and Chelsea,Garden House School,484,33,0,33
Hounslow,Falcons Pre-Preparatory Chiswick,81,4,2,6
Hammersmith and Fulham,St James Senior Girls' School,264,69,0,69
Surrey,St James Senior Boys' School,384,117,4,121
Lambeth,DLD College,373,60,3,63
Wandsworth,Thomas's Battersea,751,132,0,132
Kensington and Chelsea,Pembridge Hall School,441,25,0,25
Kensington and Chelsea,Instituto Espanol Canada Blanch,404,0,0,0
Kensington and Chelsea,Knightsbridge School,380,47,1,48
Kensington and Chelsea,Thomas's Kensington,376,84,0,84
Westminster,Kensington Park School,247,52,0,52
Kensington and Chelsea,Ashbourne College,250,87,0,87
Kensington and Chelsea,Cameron Vale School,50,14,1,15
Kensington and Chelsea,Collingham,160,109,8,117
Kensington and Chelsea,Mander Portman Woodward School,546,157,5,162
Westminster,Portland Place School,222,69,10,79
Kensington and Chelsea,Southbank International School Kensington,173,0,34,34
Westminster,Princes Gardens Preparatory School,134,17,0,17
City of London,David Game College,365,58,0,58
Kensington and Chelsea,La Petite Ecole Francaise,142,2,1,3
Kensington and Chelsea,Lycee Francais Charles de Gaulle,3440,0,0,0
Kensington and Chelsea,Chelsea  Community Hospital  School,107,48,23,71
Lambeth,Triangle Nursery School,77,26,4,30
Lambeth,Effra Nursery School and Children's Centre,90,13,1,14
Lambeth,Ethelred Nursery School and Children's Centre,91,8,1,9
Lambeth,Maytree Nursery School,103,25,0,25
Lambeth,Holmewood Nursery School,115,24,2,26
Lambeth,Ashmole Primary School,221,30,6,36
Lambeth,Clapham Manor Primary School,409,56,11,67
Lambeth,Granton Primary School,640,57,15,72
Lambeth,Heathbrook Primary School,386,39,11,50
Lambeth,Henry Cavendish Primary School,790,16,18,34
Lambeth,Jessop Primary School,323,25,10,35
Lambeth,Kingswood Primary School,519,126,9,135
Lambeth,Larkhall Primary Campus,326,87,64,151
Lambeth,Paxton Primary School,501,75,13,88
Lambeth,Richard Atkins Primary School,274,50,12,62
Lambeth,Stockwell Primary School,440,55,11,66
Lambeth,Sudbourne Primary School,313,49,13,62
Lambeth,Sunnyhill Primary School,426,69,18,87
Lambeth,Telferscot Primary School,422,65,14,79
Lambeth,Vauxhall Primary School,227,50,4,54
Lambeth,Walnut Tree Walk Primary School,350,41,7,48
Lambeth,Woodmansterne School,1548,145,45,190
Lambeth,"Wyvil Primary School and Resource Bases for Speech, Language and Communication Needs, and Autism",475,95,103,198
Lambeth,Crown Lane Primary School,286,38,21,59
Lambeth,Fenstanton Primary School,334,72,13,85
Lambeth,Elm Wood School,390,48,12,60
Lambeth,Allen Edwards Primary School,387,72,45,117
Lambeth,Glenbrook Primary School,166,38,9,47
Lambeth,Julian's School,1005,124,30,154
Lambeth,Herbert Morrison Primary School,224,16,7,23
Lambeth,Streatham Wells Primary School,237,30,6,36
Lambeth,Archbishop Sumner Church of England Primary School,326,61,22,83
Lambeth,Christ Church Primary SW9,183,27,5,32
Lambeth,Macaulay Church of England Primary School,183,26,7,33
Lambeth,St Andrew's Church of England Primary School,175,32,6,38
Lambeth,St John the Divine Church of England Primary School,141,21,4,25
Lambeth,St John's Angell Town Church of England Primary School,192,32,4,36
Lambeth,St Jude's Church of England Primary School,176,25,5,30
Lambeth,St Mark's Church of England Primary School,210,26,7,33
Lambeth,St Saviour's Church of England Primary School,189,45,6,51
Lambeth,St Stephen's Church of England Primary School,197,40,4,44
Lambeth,Holy Trinity Church of England Primary School,242,13,14,27
Lambeth,St Helen's Catholic Primary School,268,58,13,71
Lambeth,The Norwood School,1065,206,40,246
Lambeth,Lilian Baylis Technology School,845,69,42,111
Lambeth,Saint Gabriel's College,606,123,24,147
Lambeth,St Bernadette Catholic Junior School,187,28,7,35
Lambeth,St Anne's Catholic Primary School,266,45,9,54
Lambeth,St Bede's Catholic Infant School,103,5,1,6
Lambeth,St Andrew's Catholic Primary School,397,20,8,28
Lambeth,Immanuel and St Andrew Church of England Primary School,419,45,9,54
Lambeth,Reay Primary School,226,34,7,41
Lambeth,St Mary's Roman Catholic Primary School,313,41,8,49
Lambeth,La Retraite Roman Catholic Girls' School,1122,64,15,79
Lambeth,Bishop Thomas Grant Catholic Secondary School,1205,142,45,187
Lambeth,London Nautical School,570,101,44,145
Lambeth,Turney Primary and Secondary Special School,143,0,143,143
Lambeth,Oakfield Preparatory School,311,38,9,47
Lambeth,Rosemead Preparatory School,285,34,1,35
Lambeth,Streatham & Clapham High School,877,254,4,258
Lambeth,The White House Preparatory School & Woodentops Kindergarten,156,14,0,14
Lambeth,Lansdowne School,155,0,155,155
Lambeth,Elm Court School,153,0,153,153
Lewisham,Clyde Nursery School.,80,28,2,30
Lewisham,Chelwood Nursery School,133,22,2,24
Lewisham,Adamsrill Primary School,419,46,13,59
Lewisham,Athelney Primary School,402,58,38,96
Lewisham,Baring Primary School,229,30,4,34
Lewisham,Beecroft Garden Primary,389,70,13,83
Lewisham,Cooper's Lane Primary School,652,62,30,92
Lewisham,Dalmain Primary School,374,54,7,61
Lewisham,Deptford Park Primary School,330,44,8,52
Lewisham,Downderry Primary School,465,45,14,59
Lewisham,Edmund Waller Primary School,402,61,3,64
Lewisham,Elfrida Primary School,391,101,14,115
Lewisham,Forster Park Primary School,379,102,8,110
Lewisham,Gordonbrock Primary School,634,63,6,69
Lewisham,Grinling Gibbons Primary School,212,40,11,51
Lewisham,Haseltine Primary School,382,51,8,59
Lewisham,Brindishe Green School,636,71,15,86
Lewisham,Holbeach Primary School,469,90,9,99
Lewisham,John Stainer Community Primary School,405,53,9,62
Lewisham,Kelvin Grove Primary School,594,96,55,151
Lewisham,Kender Primary School,393,62,12,74
Lewisham,Launcelot Primary School,334,80,11,91
Lewisham,Brindishe Manor School,449,71,8,79
Lewisham,Lucas Vale Primary School,253,38,7,45
Lewisham,Marvels Lane Primary School,388,32,8,40
Lewisham,Rangefield Primary School,353,71,12,83
Lewisham,Rathfern Primary School,492,65,20,85
Lewisham,Rushey Green Primary School,576,98,13,111
Lewisham,Sandhurst Primary School,644,128,11,139
Lewisham,Stillness Junior School,285,47,8,55
Lewisham,Stillness Infant School,294,49,2,51
Lewisham,Torridon Primary School,640,98,30,128
Lewisham,John Ball Primary School,609,130,11,141
Lewisham,Fairlawn Primary School,417,52,6,58
Lewisham,Eliot Bank Primary School,405,42,4,46
Lewisham,Twin Oaks Primary School,226,29,6,35
Lewisham,Myatt Garden Primary School,425,40,11,51
Lewisham,Horniman Primary School,193,39,7,46
Lewisham,Perrymount Primary School,211,24,8,32
Lewisham,Ashmead Primary School,349,57,4,61
Lewisham,Brindishe Lee School,227,15,8,23
Lewisham,Kilmorie Primary School,657,74,9,83
Lewisham,All Saints' Church of England Primary School Blackheath,232,34,6,40
Lewisham,Good Shepherd RC School,235,36,8,44
Lewisham,Holy Trinity Church of England Primary School,183,39,8,47
Lewisham,St Margaret's Lee CofE Primary School,207,7,0,7
Lewisham,St Augustine's Catholic Primary School and Nursery,210,28,11,39
Lewisham,St Bartholomews's Church of England Primary School,370,47,10,57
Lewisham,St James's Hatcham Church of England Primary School,187,36,9,45
Lewisham,St John Baptist Southend Church of England Primary School,198,22,5,27
Lewisham,St Joseph's Catholic Primary School,172,21,7,28
Lewisham,St Mary's Lewisham Church of England Primary School,235,60,5,65
Lewisham,St Michael's Church of England Primary School,204,34,5,39
Lewisham,Our Lady and St Philip Neri Roman Catholic Primary School,258,25,9,34
Lewisham,St Saviour's Catholic Primary School,217,50,5,55
Lewisham,St Stephen's CofE Primary School,217,27,8,35
Lewisham,St William of York Catholic Primary School,209,36,9,45
Lewisham,Holy Cross Catholic Primary School,241,38,11,49
Lewisham,Deptford Green School,903,167,53,220
Lewisham,Sydenham School,1441,172,21,193
Lewisham,Conisborough College,839,122,82,204
Lewisham,Forest Hill School,1094,231,24,255
Lewisham,Prendergast Ladywell School,1278,158,42,200
Lewisham,Addey and Stanhope School,595,119,56,175
Lewisham,"Trinity Church of England School, Lewisham",1003,100,30,130
Lewisham,Prendergast School,958,141,15,156
Lewisham,Bonus Pastor Catholic College,921,94,53,147
Lewisham,St Dunstan's College,1127,211,0,211
Greenwich,Blackheath High School,777,123,0,123
Lewisham,"Sydenham High School, GDST",725,149,2,151
Lewisham,Brent Knoll School,168,2,166,168
Lewisham,New Woodlands School,98,2,96,98
Lewisham,Greenvale School,199,5,194,199
Lewisham,Watergate School,159,7,152,159
Southwark,Kintore Way Nursery School and Children's Centre,207,72,3,75
Southwark,Ann Bernadt Nursery School,66,40,1,41
Southwark,Dulwich Wood Nursery School,88,25,0,25
Southwark,Nell Gwynn Nursery School,95,36,0,36
Southwark,The Grove Nursery School,81,18,12,30
Southwark,Albion Primary School,443,68,11,79
Southwark,Bellenden Primary School,218,28,4,32
Southwark,Camelot Primary School,381,63,14,77
Southwark,Cobourg Primary School,227,46,7,53
Southwark,Comber Grove School,180,21,4,25
Southwark,Crampton Primary,205,48,4,52
Southwark,Crawford Primary School,410,79,8,87
Southwark,Dog Kennel Hill School,283,44,12,56
Southwark,Goodrich Community Primary School,521,65,7,72
Southwark,Grange Primary School,323,69,10,79
Southwark,Heber Primary School,426,50,7,57
Southwark,Hollydale Primary School,157,27,5,32
Southwark,Ilderton Primary School,242,32,6,38
Southwark,Ivydale Primary School,496,73,13,86
Southwark,John Ruskin Primary School and Language Classes,480,68,42,110
Southwark,Keyworth Primary School,358,42,12,54
Southwark,Dulwich Wood Primary School,394,48,12,60
Southwark,Michael Faraday School,435,85,11,96
Southwark,Riverside Primary School,294,38,5,43
Southwark,Robert Browning Primary School,201,63,15,78
Southwark,Rotherhithe Primary School,336,60,14,74
Southwark,Snowsfields Primary School,188,25,19,44
Southwark,Southwark Park Primary School,402,80,21,101
Southwark,Tower Bridge Primary School,181,32,13,45
Southwark,Townsend Primary School,111,28,6,34
Southwark,Victory Primary School,116,28,1,29
Southwark,Charlotte Sharman Primary School,184,27,5,32
Southwark,Phoenix Primary School,552,66,8,74
Southwark,Pilgrims' Way Primary School,213,37,1,38
Southwark,Alfred Salter Primary School,401,73,17,90
Southwark,Oliver Goldsmith Primary School,363,50,8,58
Southwark,Boutcher Church of England Primary School,203,16,10,26
Southwark,Dulwich Village Church of England Infants' School,251,18,5,23
Southwark,English Martyrs' Roman Catholic Primary School,337,43,7,50
Southwark,St James the Great Roman Catholic Primary School,235,39,8,47
Southwark,St Francis RC Primary School,323,60,14,74
Southwark,St George's Church of England Primary School,150,22,12,34
Southwark,St George's Cathedral Catholic Primary School,176,34,3,37
Southwark,St James' Church of England Primary School,418,63,20,83
Southwark,St John's and St Clement's Church of England Primary School,358,50,22,72
Southwark,St Joseph's Catholic Primary School,226,18,10,28
Southwark,"Saint Joseph's Catholic Primary School, the Borough",195,40,14,54
Southwark,St Jude's Church of England Primary School,81,4,2,6
Southwark,St Mary Magdalene Church of England Primary School,114,38,7,45
Southwark,Peter Hills with St Mary's and St Paul's CofE Primary School,132,15,7,22
Southwark,St Peter's Church of England Primary School,178,13,2,15
Southwark,The Cathedral School of St Saviour and St Mary Overie,214,33,5,38
Southwark,St John's Roman Catholic Primary School,218,32,8,40
Southwark,St Saviour's and St Olave's Church of England School,754,114,12,126
Southwark,St Francesca Cabrini Primary School,89,18,2,20
Southwark,St Anthony's Catholic Primary School,432,68,12,80
Southwark,St Joseph's Catholic Junior School,222,31,7,38
Southwark,St Joseph's Catholic Infants School,113,11,2,13
Southwark,Friars Primary Foundation School,176,26,6,32
Southwark,The St Thomas the Apostle College,1083,117,28,145
Southwark,Dulwich College,1856,262,3,265
Southwark,Dulwich Prep London,837,174,0,174
Southwark,James Allen's Girls' School,1169,130,0,130
Southwark,Alleyn's School,1398,245,2,247
Southwark,Herne Hill School,320,9,1,10
Southwark,Highshore School,152,0,152,152
Southwark,Evelina Hospital School,96,10,19,29
Southwark,Maudsley and Bethlem Hospital School,50,40,10,50
Southwark,Haymerle School,69,0,69,69
Southwark,Beormund Primary School,38,0,38,38
Southwark,Tuke School,93,0,93,93
Southwark,Cherry Garden School,90,0,90,90
Tower Hamlets,Childrens House Nursery School,141,30,10,40
Tower Hamlets,Columbia Market Nursery School,56,5,0,5
Tower Hamlets,Rachel Keeling Nursery School,72,15,0,15
Tower Hamlets,Alice Model Nursery School,75,10,2,12
Tower Hamlets,London East Alternative Provision,93,53,9,62
Tower Hamlets,Ben Jonson Primary School,666,63,38,101
Tower Hamlets,Bonner Primary School,797,62,24,86
Tower Hamlets,Old Palace Primary School,407,45,18,63
Tower Hamlets,Canon Barnett Primary School,197,36,10,46
Tower Hamlets,Cayley Primary School,511,39,18,57
Tower Hamlets,Blue Gate Fields Junior School,349,44,15,59
Tower Hamlets,Chisenhale Primary School,338,55,27,82
Tower Hamlets,Columbia Primary School,433,72,13,85
Tower Hamlets,Cubitt Town Primary School,695,71,32,103
Tower Hamlets,Globe Primary School,352,15,41,56
Tower Hamlets,Hague Primary School,206,37,20,57
Tower Hamlets,Harbinger Primary School,317,53,11,64
Tower Hamlets,John Scurr Primary School,466,82,7,89
Tower Hamlets,Lawdale Junior School,216,21,8,29
Tower Hamlets,Elizabeth Selby Infants' School,256,30,15,45
Tower Hamlets,Marion Richardson Primary School,514,71,14,85
Tower Hamlets,Marner Primary School,661,68,34,102
Tower Hamlets,Mayflower Primary School,393,26,14,40
Tower Hamlets,Mowlem Primary School,236,34,9,43
Tower Hamlets,Blue Gate Fields Infants' School,342,70,10,80
Tower Hamlets,Olga Primary School,573,95,22,117
Tower Hamlets,Stepney Park Primary School,802,112,26,138
Tower Hamlets,Manorfield Primary School,723,129,41,170
Tower Hamlets,Stewart Headlam Primary School,240,57,8,65
Tower Hamlets,Virginia Primary School,223,41,13,54
Tower Hamlets,Wellington Primary School,401,35,13,48
Tower Hamlets,Woolmore Primary School,667,72,15,87
Tower Hamlets,Thomas Buxton Primary School,439,66,30,96
Tower Hamlets,Seven Mills Primary School,233,30,13,43
Tower Hamlets,Osmani Primary School,435,46,17,63
Tower Hamlets,Hermitage Primary School,312,39,14,53
Tower Hamlets,Bangabandhu Primary School,400,98,37,135
Tower Hamlets,Halley Primary School,208,25,10,35
Tower Hamlets,Bigland Green Primary School,485,77,12,89
Tower Hamlets,Kobi Nazrul Primary School,235,24,9,33
Tower Hamlets,William Davis Primary School,199,36,10,46
Tower Hamlets,Christ Church CofE School,190,15,13,28
Tower Hamlets,Stepney Greencoat Church of England Primary School,161,45,7,52
Tower Hamlets,St Agnes RC Primary School,202,34,10,44
Tower Hamlets,St Anne's and Guardian Angels Catholic Primary School,234,56,20,76
Tower Hamlets,St Edmund's Catholic School,215,43,5,48
Tower Hamlets,St John's Church of England Primary School,151,55,6,61
Tower Hamlets,St Luke's Church of England Primary School,419,49,14,63
Tower Hamlets,St Paul with St Luke CofE Primary School,208,60,12,72
Tower Hamlets,St Paul's Whitechapel Church of England Primary School,229,53,9,62
Tower Hamlets,St Peter's London Docks CofE Primary School,231,104,9,113
Tower Hamlets,St Saviour's Church of England Primary School,236,58,12,70
Tower Hamlets,English Martyrs Roman Catholic Primary School,192,25,6,31
Tower Hamlets,Bow School,1264,137,38,175
Tower Hamlets,Langdon Park Community School,1074,148,65,213
Tower Hamlets,Morpeth School,1544,200,99,299
Tower Hamlets,Oaklands School,940,92,30,122
Tower Hamlets,Swanlea School,1291,201,75,276
Tower Hamlets,George Green's School,1233,271,96,367
Tower Hamlets,Central Foundation Girls' School,1529,129,21,150
Tower Hamlets,Stepney All Saints Church of England Secondary School,1418,81,88,169
Tower Hamlets,Bishop Challoner Girls' School,829,82,8,90
Tower Hamlets,Gatehouse School,525,120,6,126
Tower Hamlets,Madani Secondary Girls' School,280,0,0,0
Tower Hamlets,Bowden House School,40,0,40,40
Tower Hamlets,Phoenix School,469,1,468,469
Tower Hamlets,Beatrice Tate School,114,1,113,114
Wandsworth,Balham Nursery School,59,17,1,18
Wandsworth,Eastwood Nursery School,50,15,2,17
Wandsworth,Somerset Nursery School and Children's Centre,57,4,2,6
Wandsworth,Francis Barber Pupil Referral Unit,60,40,12,52
Wandsworth,Alderbrook Primary School,258,61,12,73
Wandsworth,Allfarthing Primary School,366,44,10,54
Wandsworth,Beatrix Potter Primary School,324,33,6,39
Wandsworth,Brandlehow Primary School,354,29,17,46
Wandsworth,Broadwater Primary School,133,22,6,28
Wandsworth,Earlsfield Primary School,451,45,9,54
Wandsworth,Falconbrook Primary School,212,30,8,38
Wandsworth,Fircroft Primary School,339,39,9,48
Wandsworth,Furzedown Primary School,353,55,8,63
Wandsworth,Honeywell Junior School,324,42,13,55
Wandsworth,Honeywell Infant School,318,19,3,22
Wandsworth,Hotham Primary School,340,39,10,49
Wandsworth,John Burns Primary School,209,45,3,48
Wandsworth,Penwortham Primary School,653,89,27,116
Wandsworth,Riversdale Primary School,373,97,43,140
Wandsworth,Sellincourt Primary School,356,46,21,67
Wandsworth,Shaftesbury Park Primary School,391,76,11,87
Wandsworth,Smallwood Primary School and Language Unit,266,51,54,105
Wandsworth,Swaffield School,332,50,19,69
Wandsworth,West Hill Primary School,177,42,9,51
Wandsworth,Sheringdale Primary School,408,28,5,33
Wandsworth,Southmead Primary School,335,48,28,76
Wandsworth,Granard Primary School,393,65,31,96
Wandsworth,Heathmere Primary School,293,52,16,68
Wandsworth,Ronald Ross Primary School,236,32,11,43
Wandsworth,Albemarle Primary School,388,69,8,77
Wandsworth,"All Saints' CofE Primary School, Putney",227,36,5,41
Wandsworth,Christ Church CofE Primary School,114,22,4,26
Wandsworth,Holy Ghost Catholic Primary School,196,17,3,20
Wandsworth,Our Lady of Victories Catholic Primary School,195,13,3,16
Wandsworth,Roehampton CofE Primary School,168,27,3,30
Wandsworth,St Anne's CofE Primary School,163,30,2,32
Wandsworth,St Boniface RC Primary School,321,28,10,38
Wandsworth,St Faith's CofE Primary School,148,22,1,23
Wandsworth,St George's CofE Primary School,227,54,6,60
Wandsworth,St Joseph's Catholic Primary and Nursery School,178,44,4,48
Wandsworth,St Mary's CofE Primary School,221,29,4,33
Wandsworth,Trinity St Mary's CofE Primary School,151,16,5,21
Wandsworth,St Mary's RC Voluntary Aided Primary School,184,42,8,50
Wandsworth,St Michael's CofE Primary School,411,34,4,38
Wandsworth,"Sacred Heart Catholic Primary School, Roehampton",401,53,22,75
Wandsworth,Our Lady Queen of Heaven RC School,224,22,5,27
Wandsworth,St Anselm's Catholic Primary School,205,10,6,16
Wandsworth,Ernest Bevin College,837,114,25,139
Wandsworth,Hillbrook School,725,84,49,133
Wandsworth,Ibstock Place School,1005,120,1,121
Wandsworth,Merlin School,121,9,1,10
Wandsworth,Hurlingham School,396,24,1,25
Merton,Willington School,198,37,0,37
Wandsworth,Emanuel School,1083,167,0,167
Wandsworth,Putney High School,1076,288,0,288
Lambeth,London Steiner School,27,6,0,6
Wandsworth,Broomwood Hall School,458,114,7,121
Wandsworth,The Roche School,267,46,7,53
Wandsworth,Finton House School,345,66,3,69
Wandsworth,Hornsby House School,437,97,0,97
Wandsworth,Eveline Day School,114,13,1,14
Wandsworth,Prospect House School,287,80,2,82
Wandsworth,Newton Preparatory School,658,56,0,56
Wandsworth,Dolphin School (Incorporating Noahs Ark Nursery Schools),156,19,0,19
Merton,Hall School Wimbledon,183,83,7,90
Wandsworth,Eaton House the Manor School,682,29,29,58
Wandsworth,Northcote Lodge School,202,105,3,108
Wandsworth,Al Risalah Secondary School,175,11,0,11
Wandsworth,Parkgate House School,133,7,0,7
Wandsworth,Oak Lodge School,90,3,87,90
Wandsworth,Bradstow School,60,0,60,60
Wandsworth,Greenmead School,62,0,62,62
Wandsworth,Paddock School,212,0,212,212
Wandsworth,Garratt Park School,199,1,198,199
Westminster,Tachbrook Nursery School,44,13,1,14
Westminster,Dorothy Gardner Nursery School,79,22,4,26
Westminster,Mary Paterson Nursery School,73,15,0,15
Westminster,Barrow Hill Junior School,217,23,10,33
Westminster,Edward Wilson Primary School,295,87,13,100
Westminster,Essendine Primary School,309,29,17,46
Westminster,George Eliot Primary School,264,29,12,41
Westminster,Hallfield Primary School,324,23,21,44
Westminster,Robinsfield Infant School,164,12,2,14
Westminster,Queen's Park Primary School,287,50,18,68
Westminster,All Souls CofE Primary School,203,18,16,34
Westminster,Burdett-Coutts and Townshend Foundation CofE Primary School,144,32,3,35
Westminster,Hampden Gurney CofE Primary School,221,14,1,15
Westminster,Our Lady of Dolours Catholic Primary,156,59,5,64
Westminster,St Augustines Federated Schools: CofE Primary School,221,18,9,27
Westminster,St Barnabas' CofE Primary School,139,10,8,18
Westminster,St Clement Danes CofE Primary School,217,31,8,39
Westminster,St Edward's Catholic Primary School,204,20,9,29
Westminster,St Gabriel's CofE Primary School,158,22,11,33
Westminster,St George's Hanover Square CofE Primary School,78,15,3,18
Westminster,Soho Parish CofE Primary School,126,22,6,28
Westminster,St James & St John Church of England Primary School,190,18,4,22
Westminster,St Joseph's RC Primary School,267,33,2,35
Westminster,St Luke's CofE Primary School,156,19,4,23
Westminster,St Mary Magdalene CofE Primary School,151,19,11,30
Westminster,St Mary's Bryanston Square CofE School,114,14,8,22
Westminster,St. Mary of the Angels Catholic Primary School,218,42,8,50
Westminster,"St Matthew's School, Westminster",173,14,7,21
Westminster,St Peter's CofE School,190,29,6,35
Westminster,St Peter's Eaton Square CofE Primary School,268,34,3,37
Westminster,St Saviour's CofE Primary School,210,19,6,25
Westminster,St Stephen's CofE Primary School,84,6,2,8
Westminster,St Vincent's Catholic Primary School,234,17,6,23
Westminster,St Vincent De Paul Catholic Primary School,241,41,14,55
Westminster,Christ Church Bentinck CofE Primary School,215,28,10,38
Westminster,St Augustine's Federated Schools: CE High School,1036,151,61,212
Westminster,Arnold House School,369,74,0,74
Westminster,"Queen's College, London",632,148,1,149
Westminster,Francis Holland School,554,141,0,141
Westminster,Westminster Abbey Choir School,27,2,0,2
Westminster,Eaton House School,172,14,0,14
Westminster,Francis Holland School,741,142,0,142
Westminster,Westminster School,773,132,1,133
Kensington and Chelsea,The Hampshire School Chelsea,88,6,1,7
Westminster,Connaught House School,71,5,1,6
Westminster,Westminster Under School,275,20,1,21
Westminster,Westminster Cathedral Choir School,276,14,0,14
Westminster,The American School in London,1401,148,1,149
Westminster,Saint Christina's School,167,38,2,40
Westminster,International Community School,113,19,0,19
Westminster,Sylvia Young Theatre School,209,34,0,34
Westminster,Fairley House School,215,90,125,215
Westminster,St John's Wood Pre-Preparatory School,43,0,0,0
Wandsworth,Centre Academy London,47,3,44,47
Westminster,Naima Jewish Preparatory School,127,26,0,26
Westminster,Abercorn School,168,12,0,12
Westminster,Eaton Square Prep School,256,65,0,65
Westminster,Bales College,121,6,7,13
Westminster,College Park School,106,0,106,106
Westminster,Queen Elizabeth II Jubilee School,78,0,78,78
Barking and Dagenham,Dorothy Barley Infants' School,307,36,8,44
Barking and Dagenham,Manor Junior School,595,73,9,82
Barking and Dagenham,Manor Infants' School/Manor Longbridge,1214,159,22,181
Barking and Dagenham,Northbury Primary School,843,97,9,106
Barking and Dagenham,Ripple Primary School,897,80,31,111
Barking and Dagenham,Beam Primary School,606,94,4,98
Barking and Dagenham,Furze Infant School,492,44,5,49
Barking and Dagenham,Grafton Primary School,907,109,29,138
Barking and Dagenham,Marsh Green Primary School,337,49,1,50
Barking and Dagenham,Rush Green Primary School,842,150,14,164
Barking and Dagenham,The Leys Primary School,423,37,13,50
Barking and Dagenham,Warren Junior School,557,74,7,81
Barking and Dagenham,"Thomas Arnold Primary School, Rowdowns Road",454,74,38,112
Barking and Dagenham,Valence Primary School,974,133,28,161
Barking and Dagenham,Village Infants' School,290,60,8,68
Barking and Dagenham,Rose Lane Primary School,675,66,18,84
Barking and Dagenham,William Bellamy Primary School,970,170,24,194
Barking and Dagenham,Parsloes Primary School,393,79,7,86
Barking and Dagenham,Five Elms Primary School,457,71,20,91
Barking and Dagenham,Henry Green Primary School,469,51,11,62
Barking and Dagenham,Roding Primary School,1130,113,32,145
Barking and Dagenham,Becontree Primary School,467,51,18,69
Barking and Dagenham,John Perry Primary School,630,97,28,125
Barking and Dagenham,William Ford CofE Junior School,332,59,6,65
Barking and Dagenham,St Peter's Catholic Primary School,400,54,18,72
Barking and Dagenham,"Barking Abbey School, A Specialist Sports and Humanities College",2325,161,67,228
Barking and Dagenham,Eastbrook School,1158,126,59,185
Barking and Dagenham,Eastbury Community School,2160,217,48,265
Barking and Dagenham,Robert Clack School,2657,294,35,329
Barking and Dagenham,All Saints Catholic School and Technology College,1443,102,29,131
Barnet,Brookhill Nursery School,115,7,0,7
Barnet,Hampden Way Nursery School,103,6,5,11
Barnet,Moss Hall Nursery School,79,6,0,6
Barnet,St Margaret's Nursery School,114,7,3,10
Barnet,Pavilion Study Centre,31,26,5,31
Barnet,Barnfield Primary School,444,52,17,69
Barnet,Bell Lane Primary School,410,72,17,89
Barnet,Brookland Junior School,358,53,21,74
Barnet,Brookland Infant and Nursery School,308,47,11,58
Barnet,Brunswick Park Primary and Nursery School,457,49,14,63
Barnet,Church Hill School,212,26,4,30
Barnet,Colindale Primary School,714,87,25,112
Barnet,Coppetts Wood Primary School,282,27,36,63
Barnet,Courtland School,211,15,4,19
Barnet,Cromer Road Primary School,415,68,14,82
Barnet,Deansbrook Infant School,258,13,10,23
Barnet,Dollis Primary School,454,49,12,61
Barnet,Edgware Primary School,473,77,17,94
Barnet,Fairway Primary School and Children's Centre,265,49,10,59
Barnet,Foulds School,319,21,8,29
Barnet,Frith Manor Primary School,521,62,12,74
Barnet,Garden Suburb Junior School,328,36,11,47
Barnet,Garden Suburb Infant School,241,27,9,36
Barnet,Goldbeaters Primary School,470,90,16,106
Barnet,Hollickwood Primary School,216,34,6,40
Barnet,Holly Park Primary School,480,60,18,78
Barnet,Livingstone Primary and Nursery School,253,63,27,90
Barnet,Manorside Primary School,237,20,10,30
Barnet,Monkfrith Primary School,420,34,10,44
Barnet,Moss Hall Junior School,441,39,10,49
Barnet,Moss Hall Infant School,356,29,8,37
Barnet,Northside Primary School,267,46,8,54
Barnet,Woodridge Primary School,203,24,8,32
Barnet,Tudor Primary School,245,33,8,41
Barnet,Underhill School,539,43,21,64
Barnet,Whitings Hill Primary School,459,53,17,70
Barnet,Chalgrove Primary School,222,25,23,48
Barnet,Sunnyfields Primary School,250,45,8,53
Barnet,Queenswell Infant & Nursery School,217,10,8,18
Barnet,Queenswell Junior School,268,26,11,37
Barnet,Danegrove Primary School,617,62,27,89
Barnet,All Saints' CofE Primary School NW2,156,19,5,24
Barnet,Christ Church Primary School,222,13,7,20
Barnet,Holy Trinity CofE Primary School,232,35,12,47
Barnet,Monken Hadley CofE Primary School,148,22,3,25
Barnet,St John's CofE Junior Mixed and Infant School,239,25,3,28
Barnet,St John's CofE Primary and Nursery School,229,24,5,29
Barnet,St Mary's CofE Primary School,464,39,7,46
Barnet,"St Mary's CofE Primary School, East Barnet",216,29,4,33
Barnet,St Paul's CofE Primary School N11,226,26,5,31
Barnet,St Paul's CofE Primary School NW7,211,29,4,33
Barnet,"St Andrew's CofE Voluntary Aided Primary School, Totteridge",204,16,2,18
Barnet,Trent CofE Primary School,209,24,8,32
Barnet,All Saints' CofE Primary School N20,241,36,8,44
Barnet,The Annunciation Catholic Infant School,190,15,3,18
Barnet,Our Lady of Lourdes RC School,227,26,6,32
Barnet,St Agnes' Catholic Primary School,433,48,15,63
Barnet,St Catherine's RC School,473,35,8,43
Barnet,St Vincent's Catholic Primary School,283,30,15,45
Barnet,St Theresa's Catholic Primary School,177,21,7,28
Barnet,St Joseph's Catholic Primary School,501,65,17,82
Barnet,Sacred Heart Roman Catholic Primary School,411,38,5,43
Barnet,Blessed Dominic Catholic Primary School,455,74,8,82
Barnet,Rosh Pinah Primary School,361,29,6,35
Barnet,Menorah Primary School,430,66,8,74
Barnet,The Annunciation RC Junior School,180,18,3,21
Barnet,Friern Barnet School,726,83,38,121
Barnet,Osidge Primary School,415,47,19,66
Barnet,St Michael's Catholic Grammar School,849,45,1,46
Barnet,Finchley Catholic High School,1188,101,25,126
Barnet,St James' Catholic High School,1252,92,32,124
Barnet,Mill Hill School Foundation,1752,435,3,438
Barnet,Hendon Preparatory School,166,7,3,10
Barnet,The King Alfred School,694,165,5,170
Barnet,Lyonsdown School,159,3,0,3
Barnet,Mount House School,242,53,10,63
Barnet,Annemount School,79,8,0,8
Barnet,Mathilda Marks-Kennedy Jewish Primary School,221,54,4,58
Barnet,Goodwyn School,189,17,1,18
Barnet,Holland House School,146,10,0,10
Barnet,Kerem School,165,26,2,28
Barnet,St Martin's School,110,29,2,31
Barnet,Pardes House Grammar School,283,27,1,28
Barnet,Menorah Grammar School,284,21,35,56
Barnet,Beth Jacob Grammar School for Girls,320,15,2,17
Barnet,Dwight School London,296,33,2,35
Barnet,Brampton College,236,91,2,93
Barnet,Northway School,141,1,140,141
Barnet,Oakleigh School & Acorn Assessment Centre,176,32,144,176
Barnet,Mapledown School,114,2,112,114
Bexley,Crook Log Primary School,432,23,18,41
Bexley,Danson Primary School,644,52,4,56
Bexley,Upton Primary School,457,60,29,89
Bexley,Birkbeck Primary School,551,29,12,41
Bexley,Longlands Primary School,305,38,4,42
Bexley,Dulverton Primary School,442,36,4,40
Bexley,Parkway Primary School,241,49,42,91
Bexley,Foster's Primary School,457,24,4,28
Bexley,St Stephen's Catholic Primary School,420,23,5,28
Bexley,Our Lady of the Rosary Catholic Primary School,416,33,8,41
Bexley,St Joseph's Catholic Primary School,211,25,1,26
Bexley,St Fidelis Catholic Primary School,457,75,10,85
Bexley,St John Fisher Catholic Primary School,209,18,1,19
Bexley,West Lodge School,164,12,1,13
Bexley,Merton Court School,308,9,0,9
Bexley,Benedict House Preparatory School,184,10,1,11
Bexley,Marlborough School,81,0,81,81
Brent,Curzon Nursery School & Family Wellbeing Centre,107,33,0,33
Brent,Fawood Nursery School & Family Wellbeing Centre,106,40,0,40
Brent,College Green School and Services,92,8,0,8
Brent,Granville Plus Nursery School,75,27,0,27
Wokingham,Foundry College,14,5,8,13
Bradford,Peel Park Primary School and Nursery,588,82,24,106
Brent,Anson Primary School,390,53,9,62
Brent,Brentfield Primary School,414,77,12,89
Brent,Byron Court Primary School,841,47,21,68
Brent,Carlton Vale Infant School,64,22,11,33
Brent,Harlesden Primary School,311,47,15,62
Brent,Mount Stewart Junior School,316,28,6,34
Brent,Mount Stewart Infant School,312,19,5,24
Brent,Uxendon Manor Primary School,674,47,9,56
Brent,Kingsbury Green Primary School,590,82,32,114
Brent,Leopold Primary School,649,80,7,87
Brent,Lyon Park Primary School,903,63,13,76
Brent,Malorees Infant School,200,10,5,15
Brent,Northview Junior and Infant School,234,29,11,40
Brent,Park Lane Primary School,455,99,6,105
Brent,Preston Park Primary School,610,45,10,55
Brent,Roe Green Junior School,456,22,9,31
Brent,Roe Green Infant School,449,21,14,35
Brent,Barham Primary School,929,102,19,121
Brent,Wykeham Primary School,466,57,14,71
Brent,Elsley Primary School,787,82,9,91
Brent,Donnington Primary School,233,30,6,36
Brent,The Stonebridge School,277,30,4,34
Brent,Newfield Primary School,239,58,15,73
Brent,Mitchell Brook Primary School,638,104,30,134
Brent,Chalkhill Primary School,463,90,10,100
Brent,Salusbury Primary School,647,81,8,89
Brent,Oliver Goldsmith Primary School,442,24,13,37
Brent,Mora Primary School,411,58,9,67
Brent,Fryent Primary School,668,58,63,121
Brent,Christ Church CofE Primary School,190,26,4,30
Brent,John Keble CofE Primary School,402,119,14,133
Brent,Princess Frederica CofE Primary School,435,36,4,40
Brent,St Mary's CofE Primary School,200,47,1,48
Brent,St Joseph's Catholic Junior School,278,56,4,60
Brent,St Mary Magdalen's Catholic Junior School,299,44,7,51
Brent,St Robert Southwell Catholic Primary School,453,57,20,77
Brent,Convent of Jesus and Mary RC Infant School,257,42,7,49
Brent,Our Lady of Lourdes Catholic Primary School,209,36,4,40
Brent,St Joseph's Catholic Infant School,261,55,1,56
Brent,Sinai Jewish Primary School,610,100,7,107
Brent,Malorees Junior School,221,18,8,26
Brent,St Joseph's Roman Catholic Primary School,471,87,21,108
Brent,The Kilburn Park School Foundation,78,22,15,37
Brent,Newman Catholic College,712,61,23,84
Harrow,Buckingham Preparatory School,110,3,0,3
Brent,Buxlow Preparatory School,88,14,6,20
Brent,St Christopher's Prep School,98,4,0,4
Ealing,"Ysgol Gymraeg Llundain, London Welsh School",8,3,0,3
Brent,Islamia Primary School,419,62,12,74
Brent,Islamia School for Girls',94,2,0,2
Brent,Al-Sadiq School,192,8,0,8
Brent,Phoenix Arch School,54,0,54,54
Bromley,Southborough Primary School,416,43,20,63
Bromley,Edgebury Primary School,413,42,13,55
Bromley,Poverest Primary School,429,45,30,75
Bromley,St Olave's and St Saviour's Grammar School,1089,59,0,59
Bromley,Babington House School,464,70,0,70
Bromley,Bickley Park School,378,29,1,30
Bromley,Bishop Challoner School,301,62,1,63
Bromley,Breaside Preparatory School,379,27,2,29
Bromley,Farringtons School,697,176,6,182
Bromley,St Christophers The Hall School,229,53,1,54
Bromley,St David's Prep,188,34,0,34
Bromley,Bromley High School,892,141,0,141
Bromley,Eltham College,1034,163,2,165
Bromley,Ashgrove School Ltd,14,0,0,0
Bromley,Darul Uloom London School,155,0,0,0
Bromley,Marjorie McClure School,112,0,112,112
Croydon,Crosfield Nursery School,50,6,1,7
Croydon,Purley Nursery School,88,7,0,7
Croydon,Tunstall Nursery School,101,10,0,10
Croydon,Saffron Valley Collegiate,89,88,1,89
Croydon,Beulah Junior School,237,51,9,60
Croydon,Elmwood Junior School,470,73,8,81
Croydon,Elmwood Infant School,392,50,9,59
Croydon,Howard Primary School,409,43,6,49
Croydon,Purley Oaks Primary School,625,85,16,101
Croydon,Winterbourne Junior Girls' School,263,38,2,40
Croydon,Winterbourne Nursery and Infants' School,427,57,10,67
Croydon,Beaumont Primary School,214,22,4,26
Croydon,Gresham Primary School,247,27,1,28
Croydon,Smitham Primary School,589,73,9,82
Croydon,The Hayes Primary School,413,47,6,53
Croydon,Forestdale Primary School,418,68,5,73
Croydon,Heavers Farm Primary School,411,63,8,71
Croydon,Downsview Primary and Nursery School,615,56,4,60
Croydon,Park Hill Infant School,270,38,3,41
Croydon,Greenvale Primary School,218,24,3,27
Croydon,Rockmount Primary School,457,91,5,96
Croydon,Norbury Manor Primary School,407,46,10,56
Croydon,All Saints CofE Primary School,257,22,6,28
Croydon,St John's CofE Primary School,418,35,8,43
Croydon,Coulsdon CofE Primary School,206,42,11,53
Croydon,Christ Church CofE Primary School (Purley),407,59,12,71
Croydon,St Joseph's RC Junior School,206,51,4,55
Croydon,Margaret Roper Catholic Primary School,201,17,5,22
Croydon,Regina Coeli Catholic Primary School,406,55,10,65
Croydon,St Joseph's RC Infant School,160,30,0,30
Croydon,Archbishop Tenison's CofE High School,764,125,21,146
Croydon,St Mary's Catholic High School,563,83,4,87
Croydon,Selsdon Primary and Nursery School,355,53,3,56
Croydon,Thomas More Catholic School,652,87,15,102
Croydon,Cumnor House School,376,32,2,34
Croydon,Elmhurst School for Boys,116,9,1,10
Croydon,Laleham Lea School,138,14,1,15
Croydon,Royal Russell School,1186,248,2,250
Croydon,Whitgift School,1561,286,3,289
Croydon,St David's School,144,26,0,26
Croydon,Trinity School,1055,1,0,1
Croydon,Rutherford School,29,1,28,29
Croydon,Croydon High School,750,108,0,108
Croydon,Old Palace of John Whitgift School,608,58,3,61
Croydon,BRIT School for Performing Arts and Technology,1397,247,48,295
Croydon,Bensham Manor School,244,0,244,244
Croydon,St Giles School,116,10,106,116
Croydon,St Nicholas School,245,33,212,245
Croydon,Red Gates School,165,18,147,165
Croydon,Priory School,139,0,139,139
Ealing,Maples Nursery School and Children's Centre,101,23,0,23
Ealing,Grove House Nursery School & Children's Centre,115,25,4,29
Ealing,South Acton Childrens Centre,130,24,10,34
Ealing,Greenfields Nursery School and Children's Centre,143,37,0,37
Ealing,Acton Gardens Primary School,379,56,16,72
Ealing,East Acton Primary School,197,26,13,39
Ealing,Oldfield Primary School,335,28,9,37
Ealing,North Ealing Primary School,656,73,20,93
Ealing,St John's Primary School,474,78,40,118
Ealing,St Mark's Primary School,488,42,10,52
Ealing,West Twyford Primary School,454,103,18,121
Ealing,West Acton Primary School,675,89,33,122
Ealing,Mayfield Primary School,438,53,7,60
Ealing,Beaconsfield Primary and Nursery School,458,52,36,88
Ealing,Coston Primary School,423,27,46,73
Ealing,Downe Manor Primary School,306,53,9,62
Ealing,Drayton Green Primary School,391,32,27,59
Ealing,North Primary School,406,26,14,40
Ealing,Ravenor Primary School,646,67,11,78
Ealing,Selborne Primary School,657,63,30,93
Ealing,Hambrough Primary School,484,43,9,52
Ealing,Hobbayne Primary School,422,43,9,52
Ealing,John Perryn Primary School,402,100,12,112
Ealing,Southfield Primary School,352,13,3,16
Ealing,Allenby Primary School,247,29,29,58
Ealing,Blair Peach Primary School,421,35,11,46
Ealing,Clifton Primary School,457,78,18,96
Ealing,Dairy Meadow Primary School,414,59,7,66
Ealing,Derwentwater Primary School,422,77,8,85
Ealing,Durdans Park Primary School,454,62,7,69
Ealing,Fielding Primary School,994,53,27,80
Ealing,Gifford Primary School,900,123,22,145
Ealing,Greenwood Primary School,638,75,6,81
Ealing,"Havelock Primary School, Nursery & Arp",392,43,38,81
Ealing,Horsenden Primary School,685,94,14,108
Ealing,Willow Tree Primary School,511,78,35,113
Ealing,Lady Margaret Primary School,536,69,9,78
Ealing,Little Ealing Primary School,677,49,18,67
Ealing,Oaklands Primary School,450,44,14,58
Ealing,Perivale Primary School,452,46,11,57
Ealing,Stanhope Primary School,375,40,8,48
Ealing,Viking Primary School,217,31,5,36
Ealing,Wolf Fields Primary School,232,29,7,36
Ealing,Featherstone Primary and Nursery School,674,47,16,63
Ealing,Three Bridges Primary School,460,57,8,65
Ealing,Montpelier Primary School,674,56,13,69
Ealing,Tudor Primary School,423,55,8,63
Ealing,Vicar's Green Primary School,447,60,11,71
Ealing,Mount Carmel Catholic Primary School,407,44,5,49
Ealing,Our Lady of the Visitation Catholic Primary School,448,56,12,68
Ealing,St John Fisher Catholic Primary School,404,40,14,54
Ealing,St Anselm's Catholic Primary School,237,33,1,34
Ealing,St Gregory's Catholic Primary School,354,27,11,38
Ealing,St Joseph's Catholic Primary School,616,61,21,82
Ealing,St Raphael's Catholic Primary School,507,38,21,59
Ealing,St Vincent's Catholic Primary School,449,51,20,71
Ealing,The Edward Betham Church of England Primary School,420,42,8,50
Ealing,Villiers High School,1484,154,17,171
Ealing,The Cardinal Wiseman Catholic School,1983,146,49,195
Ealing,Brentside High School,1666,195,21,216
Ealing,Greenford High School,1945,183,72,255
Ealing,The Ellen Wilkinson School for Girls,1305,139,17,156
Ealing,Northolt High School,924,82,11,93
Ealing,Durston House School,329,48,0,48
Ealing,Harvington Prep School,86,10,0,10
Ealing,St Augustine's Priory,454,71,0,71
Ealing,St Benedict's School,1091,326,4,330
Wandsworth,Falcons School for Girls,124,15,1,16
Ealing,The Sybil Elgar School,91,0,91,91
Ealing,Notting Hill & Ealing High School GDST,908,115,2,117
Ealing,Clifton Lodge School,119,15,0,15
Ealing,King Fahad Academy,559,34,0,34
Ealing,The Japanese School,309,14,2,16
Haringey,Greek Secondary School of London,60,3,0,3
Ealing,Orchard House School,273,35,0,35
Ealing,Avenue House School,78,8,2,10
Ealing,The Eden SDA School,61,10,15,25
Ealing,Belvue School,222,0,222,222
Ealing,Castlebar School,170,0,170,170
Ealing,Mandeville School,158,14,144,158
Ealing,John Chilton School,136,0,136,136
Ealing,Springhallow School,156,0,156,156
Ealing,St Ann's School,109,0,109,109
Enfield,Orchardside School,43,28,3,31
Enfield,Capel Manor Primary School,381,49,15,64
Enfield,Carterhatch Infant School,314,61,19,80
Enfield,Chase Side Primary School,397,39,22,61
Enfield,Eldon Primary School,883,81,34,115
Enfield,Firs Farm Primary School,603,91,25,116
Enfield,Garfield Primary School,309,33,17,50
Enfield,George Spicer Primary School,838,121,25,146
Enfield,Hadley Wood Primary School,207,18,10,28
Enfield,Hazelwood Junior School,347,32,13,45
Enfield,Hazelwood Infant School,365,37,9,46
Enfield,Honilands Primary School,406,75,20,95
Enfield,Merryhills Primary School,626,42,13,55
Enfield,Prince of Wales Primary School,579,100,35,135
Enfield,The Raglan Junior School,475,28,22,50
Enfield,Raglan Infant School,447,29,11,40
Enfield,Suffolks Primary School,238,38,17,55
Enfield,Tottenhall Infant School,282,27,5,32
Enfield,Southbury Primary School,412,38,12,50
Enfield,De Bohun Primary School,430,13,36,49
Enfield,Bush Hill Park Primary School,459,45,16,61
Enfield,Eversley Primary School,629,51,24,75
Enfield,St Michael at Bowes CofE Junior School,284,28,8,36
Enfield,St John's CofE Primary School,106,21,2,23
Enfield,Forty Hill CofE Primary School,227,21,6,27
Enfield,St Andrew's CofE Primary School,407,16,10,26
Enfield,St Andrew's Southgate Primary School (CE),197,12,4,16
Enfield,Freezywater St George's CofE VA Primary School,207,31,10,41
Enfield,St John and St James CofE Primary School,283,32,9,41
Enfield,St James CofE Primary School,190,16,8,24
Enfield,St Michael's CofE Primary School,441,29,19,48
Enfield,St Paul's CofE Primary School,415,30,6,36
Enfield,St Mary's Catholic Primary School,373,46,11,57
Enfield,St Edmund's Catholic Primary School,390,52,22,74
Enfield,St George's Catholic Primary School,560,32,9,41
Enfield,St Monica's RC Primary School,416,35,11,46
Enfield,Our Lady of Lourdes Catholic Primary School,196,20,7,27
Enfield,Latymer All Saints CofE Primary School,577,89,24,113
Enfield,Winchmore School,1677,169,69,238
Enfield,Enfield County School for Girls,1103,73,14,87
Enfield,Chace Community School,1084,205,40,245
Enfield,Bishop Stopford's School,738,136,14,150
Enfield,St Anne's Catholic High School for Girls,1071,52,16,68
Enfield,St Matthew's CofE Primary School,192,28,10,38
Enfield,The Latymer School,1357,8,4,12
Enfield,Broomfield School,677,23,19,42
Enfield,St Ignatius College,1107,83,30,113
Enfield,Keble Preparatory School,131,19,5,24
Enfield,Palmers Green High School,253,59,1,60
Enfield,Grange Park Preparatory School,123,8,1,9
Enfield,Salcombe Preparatory School,236,27,4,31
Enfield,Vita Et Pax School,107,13,3,16
Enfield,St John's Preparatory and Senior School,472,13,0,13
Enfield,Durants School,189,1,188,189
Enfield,West Lea School,444,4,440,444
Enfield,Oaktree School,137,0,137,137
Enfield,Waverley School,164,0,164,164
Haringey,Pembury House Nursery School,139,42,3,45
Haringey,Rowland Hill Nursery School,162,23,3,26
Haringey,Woodlands Park Nursery School and Childrens Centre,158,17,2,19
Haringey,Belmont Junior School,222,34,6,40
Haringey,Belmont Infant School,212,17,4,21
Haringey,Bounds Green Junior School,357,39,7,46
Haringey,Bounds Green Infant School,327,16,7,23
Haringey,Campsbourne Junior School,213,45,14,59
Haringey,Campsbourne Infant School,204,22,8,30
Haringey,The Devonshire Hill Nursery &  Primary School,357,29,19,48
Haringey,Earlsmead Primary School,478,88,14,102
Haringey,Highgate Primary School,445,39,18,57
Haringey,Lancasterian Primary School,400,59,14,73
Haringey,Coldfall Primary School,656,77,8,85
Haringey,Tetherdown Primary School,418,53,8,61
Haringey,Rokesly Junior School,319,57,18,75
Haringey,Rokesly Infant & Nursery School,266,28,5,33
Haringey,South Harringay Junior School,210,35,3,38
Haringey,South Harringay Infant School,215,10,10,20
Haringey,West Green Primary School,203,30,12,42
Haringey,Tiverton Primary School,293,35,14,49
Haringey,Coleridge Primary School,876,107,18,125
Haringey,Welbourne Primary School,485,85,16,101
Haringey,Lea Valley Primary School,407,53,18,71
Haringey,Ferry Lane Primary School,148,21,7,28
Haringey,Rhodes Avenue Primary School,696,51,18,69
Haringey,Crowland Primary School,403,67,11,78
Haringey,Weston Park Primary School,218,20,9,29
Haringey,The Willow Primary School,473,52,22,74
Haringey,St Aidan's Voluntary Controlled Primary School,215,23,13,36
Haringey,St Michael's CofE Voluntary Aided Primary School,426,22,2,24
Haringey,St James Church of England Primary School,193,20,2,22
Haringey,St Mary's CofE Primary School,425,52,16,68
Haringey,Our Lady of Muswell Catholic Primary School,408,37,10,47
Haringey,St Francis de Sales RC Junior School,320,54,19,73
Haringey,St Ignatius RC Primary School,292,77,9,86
Haringey,St Mary's Priory RC Junior School,171,30,7,37
Haringey,St Paul's Catholic Primary School,167,19,10,29
Haringey,St Mary's Priory RC Infant School,136,13,7,20
Haringey,St Peter-in-Chains RC Infant School,64,3,5,8
Haringey,St Francis de Sales RC Infant School,198,26,4,30
Haringey,St Martin of Porres Catholic Primary School,151,9,9,18
Haringey,St Gildas' Catholic Junior School,121,12,7,19
Haringey,St John Vianney RC Primary School,225,25,8,33
Haringey,Hornsey School for Girls,754,95,15,110
Haringey,Highgate Wood Secondary School,1578,258,40,298
Haringey,Fortismere School,1820,281,53,334
Haringey,Gladesmore Community School,1304,176,44,220
Haringey,Channing School,1007,167,1,168
Haringey,Highgate School,1932,476,1,477
Haringey,Norfolk House School,221,2,0,2
Haringey,North London Rudolf Steiner School,19,1,0,1
Hackney,Beis Chinuch Lebonos Girls School,747,107,21,128
Haringey,Blanche Nevile School,67,0,67,67
Haringey,Vale School,107,1,106,107
Haringey,The Brook Special Primary School,128,0,128,128
Haringey,Riverside School,157,0,157,157
Harrow,The Helix Education Centre,37,27,10,37
Harrow,"Newton Farm Nursery, Infant and Junior School",455,58,11,69
Harrow,Roxeth Primary School,417,53,15,68
Harrow,Marlborough Primary School,650,58,10,68
Harrow,Grimsdyke School,624,37,21,58
Harrow,Camrose Primary With Nursery,411,32,7,39
Harrow,Belmont School,652,69,32,101
Harrow,Kenmore Park Junior School,324,33,16,49
Harrow,Longfield Primary School,754,74,10,84
Harrow,Grange Primary School,495,30,20,50
Harrow,Cannon Lane Primary School,802,58,15,73
Harrow,Pinner Park Primary School,885,127,23,150
Harrow,Stag Lane Primary School,855,102,17,119
Harrow,Elmgrove Primary School & Nursery,800,170,28,198
Harrow,Kenmore Park Infant and Nursery School,298,22,5,27
Harrow,Roxbourne Primary School,465,19,6,25
Harrow,Stanburn Primary School,739,94,18,112
Harrow,Weald Rise Primary School,413,29,3,32
Harrow,West Lodge Primary School,648,48,39,87
Harrow,Norbury School,667,81,14,95
Harrow,Vaughan Primary School,668,66,14,80
Harrow,Glebe Primary School,639,60,4,64
Harrow,St Anselm's Catholic Primary School,415,67,8,75
Harrow,St Teresa's Catholic Primary School and Nursery,440,53,12,65
Harrow,Whitmore High School,1733,91,61,152
Harrow,Harrow School,831,173,0,173
Harrow,The John Lyon School,839,75,3,78
Harrow,Orley Farm School,513,45,1,46
Harrow,Alpha Preparatory School,138,28,0,28
Harrow,Reddiford School,251,7,0,7
Harrow,Roxeth Mead School,38,3,0,3
Hertfordshire,The Purcell School,185,26,2,28
Harrow,North London Collegiate School,1101,209,0,209
Harrow,Shaftesbury High School,172,0,172,172
Havering,The James Oglethorpe Primary School,398,51,16,67
Havering,Harold Wood Primary School,622,66,18,84
Havering,Elm Park Primary School,420,44,16,60
Havering,Hylands Primary School,651,30,10,40
Havering,Harold Court Primary School,384,25,17,42
Havering,Langtons Infant School & Nursery,199,18,7,25
Havering,Suttons Primary School,453,30,20,50
Havering,Whybridge Infant School,266,28,6,34
Havering,Clockhouse Primary School,699,57,22,79
Havering,Crownfield Junior School,403,45,11,56
Havering,Crownfield Infant School,393,24,12,36
Havering,Parklands Primary School,900,47,28,75
Havering,Squirrels Heath Junior School,338,27,10,37
Havering,Squirrels Heath Infant School,269,20,17,37
Havering,Gidea Park Primary School,448,18,13,31
Havering,Towers Infant School,317,31,8,39
Havering,Parsonage Farm Primary School,546,22,15,37
Havering,Towers Junior School,351,46,9,55
Havering,Brady Primary School,318,39,9,48
Havering,Scotts Primary School,419,14,11,25
Havering,Broadford Primary School,692,43,22,65
Havering,Newtons Primary School,416,67,11,78
Havering,Nelmes Primary School,434,13,22,35
Havering,Mead Primary School,759,72,34,106
Havering,Rainham Village Primary School,447,74,14,88
Havering,Hilldene Primary School,684,103,17,120
Havering,St Edward's Church of England Voluntary Aided Primary School,665,43,20,63
Havering,St Mary's Catholic Primary School,420,52,15,67
Havering,La Salette Catholic Primary School,207,16,6,22
Havering,St Patrick's Catholic Primary School,389,31,6,37
Havering,St Ursula's Catholic Primary School,454,49,18,67
Havering,St Joseph's Catholic Primary School,418,10,8,18
Havering,St Peter's Catholic Primary School,418,30,9,39
Havering,St Alban's Catholic Primary School,208,8,6,14
Havering,Gidea Park Preparatory School and Nursery,114,26,0,26
Havering,St Mary's Hare Park School,141,5,0,5
Havering,Immanuel School,113,1,0,1
Havering,Oakfields Preparatory School,212,11,2,13
Havering,Corbets Tey School,156,0,156,156
Hillingdon,McMillan Early Childhood Centre,147,18,0,18
Hillingdon,Bourne Primary School,218,28,1,29
Hillingdon,The Breakspear School,650,55,8,63
Hillingdon,Colham Manor Primary School,684,82,13,95
Hillingdon,Coteford Infant School,227,27,15,42
Hillingdon,Deanesfield Primary School,695,79,15,94
Hillingdon,Field End Infant School,327,56,8,64
Hillingdon,Glebe Primary School,634,63,26,89
Hillingdon,Harefield Junior School,237,58,7,65
Hillingdon,Harefield Infant School,199,38,5,43
Hillingdon,Harlyn Primary School,472,45,17,62
Hillingdon,Harmondsworth Primary School,216,60,14,74
Hillingdon,Heathrow Primary School,428,45,12,57
Hillingdon,Lady Bankes Primary School,628,108,15,123
Hillingdon,Minet Junior School,428,38,10,48
Hillingdon,Minet Infant and Nursery School,445,61,8,69
Hillingdon,Newnham Junior School,357,55,10,65
Hillingdon,Newnham Infant and Nursery School,304,55,2,57
Hillingdon,Whitehall Junior School,382,40,9,49
Hillingdon,Whiteheath Junior School,333,36,8,44
Hillingdon,Yeading Junior School,463,65,9,74
Hillingdon,Yeading Infant and Nursery School,449,53,16,69
Hillingdon,Highfield Primary School,331,57,1,58
Hillingdon,Rabbsfarm Primary School,632,43,28,71
Hillingdon,Warrender Primary School,390,28,7,35
Hillingdon,Whitehall Infant School,357,37,9,46
Hillingdon,Whiteheath Infant & Nursery School,286,42,7,49
Hillingdon,Frithwood Primary School,420,55,3,58
Hillingdon,Ruislip Gardens Primary School,288,18,7,25
Hillingdon,Bishop Winnington-Ingram CofE Primary School,223,28,12,40
Hillingdon,Holy Trinity CofE Primary School,187,27,8,35
Hillingdon,Dr Triplett's CofE Primary School,451,78,8,86
Hillingdon,St Swithun Wells Catholic Primary School,234,24,5,29
Hillingdon,Botwell House Catholic Primary School,706,232,8,240
Hillingdon,St Bernadette Catholic Primary School,435,26,13,39
Hillingdon,St Catherine Catholic Primary School,225,28,3,31
Hillingdon,St Mary's Catholic Primary School,237,23,6,29
Hillingdon,Sacred Heart Catholic Primary School,681,87,7,94
Hillingdon,Oak Farm Primary School,605,84,18,102
Hillingdon,Grange Park Junior School,406,63,7,70
Hillingdon,Grange Park Infant and Nursery School,351,42,5,47
Hillingdon,Hillside Infant School,223,20,6,26
Hillingdon,Hillside Junior School,221,46,11,57
Hillingdon,St Andrew's C of E Primary School,207,28,7,35
Hillingdon,Hayes Park School,674,86,31,117
Hillingdon,Oak Wood School,1232,134,41,175
Hillingdon,Harlington School,1277,125,41,166
Hillingdon,Northwood College for Girls GDST,887,121,2,123
Hillingdon,St Helen's School,1197,107,0,107
Hillingdon,St Martin's School,403,42,0,42
Hillingdon,The Hall School,23,1,0,1
Hillingdon,St Helen's College,370,27,0,27
Hillingdon,St John's School,340,27,0,27
Hillingdon,ACS Hillingdon International School,590,118,0,118
Hillingdon,Meadow High School,254,0,254,254
Hillingdon,Pield Heath House RC School,99,0,99,99
Hillingdon,Hedgewood School,189,0,189,189
Hounslow,Belmont Primary School,460,49,7,56
Hounslow,Cardinal Road Infant and Nursery School,334,44,2,46
Hounslow,Cavendish Primary School,185,31,6,37
Hounslow,Feltham Hill Infant and Nursery School,424,45,12,57
Hounslow,Grove Park Primary School,428,42,10,52
Hounslow,Victoria Junior School,349,55,3,58
Hounslow,Hounslow Heath Junior School,737,109,18,127
Hounslow,Hounslow Heath Infant and Nursery School,594,116,8,124
Hounslow,Hounslow Town Primary School,1088,156,51,207
Hounslow,Isleworth Town Primary School,901,163,10,173
Hounslow,Lionel Primary School,647,96,20,116
Hounslow,Marlborough Primary School,637,96,18,114
Hounslow,Norwood Green Infant and Nursery School,326,62,11,73
Hounslow,Spring Grove Primary School,278,29,7,36
Hounslow,Strand-on-the-Green Junior School,323,47,34,81
Hounslow,Strand-on-the-Green Infant and Nursery School,304,27,12,39
Hounslow,Wellington Primary School,802,122,20,142
Hounslow,Worple Primary School,217,25,6,31
Hounslow,Ivybridge Primary School,178,43,3,46
Hounslow,Edward Pauling Primary School,442,48,7,55
Hounslow,The Smallberry Green Primary School,401,73,26,99
Hounslow,Grove Road Primary School,232,28,18,46
Hounslow,Beavers Community Primary School,688,193,23,216
Hounslow,The Blue School CofE Primary,470,46,8,54
Hounslow,St Paul's CofE Primary School,303,48,6,54
Hounslow,Our Lady and St John's Catholic Primary School,221,12,6,18
Hounslow,St Lawrence Catholic  Primary School,456,60,11,71
Hounslow,"St Mary's Catholic Primary School, Isleworth",424,42,4,46
Hounslow,"St Mary's Catholic Primary School ,Chiswick",208,4,1,5
Hounslow,St Michael and St Martin Catholic Primary School,471,59,4,63
Hounslow,The Heathland School,1852,132,35,167
Hounslow,Gunnersbury Catholic School,1192,118,19,137
Hounslow,Ashton House School,100,14,0,14
Hounslow,Chiswick and Bedford Park Preparatory School,161,36,1,37
Hounslow,International School of London,418,60,1,61
Hounslow,ArtsEd Day School & Sixth Form,296,112,2,114
Hounslow,Marjory Kinnon School,318,0,318,318
Hounslow,Oaklands School,225,1,224,225
Hounslow,Lindon Bennett School,175,26,149,175
Hounslow,The Cedars Primary School,62,0,62,62
Kingston upon Thames,Surbiton Hill Nursery School,127,37,9,46
Kingston upon Thames,Malden Oaks School and Tuition Service,95,6,77,83
Kingston upon Thames,Burlington Junior School,475,73,11,84
Kingston upon Thames,Burlington Infant and Nursery School,463,65,5,70
Kingston upon Thames,Coombe Hill Infant School,270,25,2,27
Kingston upon Thames,Ellingham Primary School,362,55,11,66
Kingston upon Thames,Tolworth Junior School,411,112,27,139
Kingston upon Thames,Tolworth Infant and Nursery School,316,83,8,91
Kingston upon Thames,Coombe Hill Junior School,390,62,11,73
Kingston upon Thames,Maple Infants' School,304,17,1,18
Kingston upon Thames,Alexandra Primary School,465,41,19,60
Kingston upon Thames,King Athelstan Primary School,464,64,19,83
Kingston upon Thames,Grand Avenue Primary and Nursery School,677,80,17,97
Kingston upon Thames,Malden Manor Primary and Nursery School,433,58,15,73
Kingston upon Thames,King's Oak Primary School,489,108,35,143
Kingston upon Thames,Lovelace Primary School,602,73,12,85
Kingston upon Thames,Christ Church New Malden CofE Primary School,443,46,9,55
Kingston upon Thames,Christ Church CofE Primary School,492,34,4,38
Kingston upon Thames,Malden Parochial CofE Primary School,230,13,2,15
Kingston upon Thames,St Andrew's and St Mark's CofE Junior School,359,23,8,31
Kingston upon Thames,St John's C of E Primary School,237,29,2,31
Kingston upon Thames,St Paul's CofE Primary School,205,26,4,30
Kingston upon Thames,"St Paul's CofE Primary School, Kingston Hill",404,43,7,50
Kingston upon Thames,St Matthew's CofE Primary School,409,34,5,39
Kingston upon Thames,St Mary's CofE (Aided) Primary School,168,34,6,40
Kingston upon Thames,Corpus Christi Catholic Primary School,433,43,8,51
Kingston upon Thames,Our Lady Immaculate Catholic Primary School,415,47,14,61
Kingston upon Thames,St Joseph's Catholic Primary School,247,17,4,21
Kingston upon Thames,St Luke's CofE Primary School,274,19,5,24
Kingston upon Thames,Holy Cross Preparatory School,294,37,0,37
Kingston upon Thames,Shrewsbury House School,343,35,2,37
Kingston upon Thames,Surbiton High School,1634,212,5,217
Kingston upon Thames,Rokeby School,404,173,0,173
Kingston upon Thames,Marymount International School,233,42,0,42
Kingston upon Thames,Park Hill School,126,14,2,16
Kingston upon Thames,The Study School,88,8,0,8
Kingston upon Thames,Westbury House School,102,20,2,22
Kingston upon Thames,Kingston Grammar School,873,97,2,99
Kingston upon Thames,Canbury School,76,18,58,76
Merton,Bond Primary School,363,68,11,79
Merton,Dundonald Primary School,454,31,14,45
Merton,Garfield Primary School,309,35,10,45
Merton,Hatfeild Primary School,415,58,33,91
Merton,Hollymount School,449,28,11,39
Merton,Joseph Hood Primary School,396,75,10,85
Merton,Links Primary School,364,40,3,43
Merton,Lonesome Primary School,358,78,12,90
Merton,Merton Abbey Primary School,223,32,12,44
Merton,Merton Park Primary School,230,24,5,29
Merton,Morden Primary School,235,44,10,54
Merton,Pelham Primary School,417,46,13,59
Merton,Haslemere Primary School,404,74,8,82
Merton,Poplar Primary School,651,55,23,78
Merton,St Mark's Primary School,235,50,12,62
Merton,The Sherwood School,329,56,8,64
Merton,Singlegate Primary School,663,45,14,59
Merton,Wimbledon Park Primary School,641,38,13,51
Merton,Abbotsbury Primary School,408,53,10,63
Merton,West Wimbledon Primary School,320,46,32,78
Merton,Cranmer Primary School,510,78,47,125
Merton,Gorringe Park Primary School,418,93,16,109
Merton,Hillcross Primary School,436,73,14,87
Merton,Liberty Primary,403,45,15,60
Merton,William Morris Primary School,327,46,5,51
Merton,Wimbledon Chase Primary School,695,56,38,94
Merton,All Saints' CofE Primary School,339,56,11,67
Merton,St Matthew's CofE Primary School,186,11,4,15
Merton,Holy Trinity CofE Primary School,438,33,13,46
Merton,Bishop Gilpin CofE Primary School,466,23,7,30
Merton,St Peter and Paul Catholic Primary School,300,50,5,55
Merton,Sacred Heart Catholic Primary School,369,51,13,64
Merton,St Teresa's Catholic Primary School,488,62,17,79
Merton,St Mary's Catholic Primary School,443,43,4,47
Merton,St John Fisher RC Primary School,446,54,13,67
Merton,The Priory CofE School,207,41,8,49
Merton,Ricards Lodge High School,1361,149,30,179
Merton,Raynes Park High School,1181,360,75,435
Merton,Rutlish School,1458,146,68,214
Merton,Wimbledon College,1246,189,61,250
Merton,Ursuline High School Wimbledon,1405,186,28,214
Merton,King's College School,1474,154,1,155
Merton,The Rowans School,120,2,0,2
Merton,Ursuline Preparatory School,153,12,1,13
Merton,Donhead Preparatory School,278,34,6,40
Merton,The Study Preparatory School,307,25,0,25
Merton,Wimbledon Common Preparatory School,170,4,0,4
Merton,Wimbledon High School GDST,1050,196,1,197
Merton,Norwegian School in London,46,5,0,5
Merton,Blossom House School,320,21,299,320
Merton,Melrose School,100,0,100,100
Merton,Perseid School,152,0,152,152
Merton,Cricket Green School,246,0,246,246
Newham,Edith Kerrison Nursery School,151,32,0,32
Newham,Kay Rowe Nursery School,139,41,1,42
Newham,Rebecca Cheetham Nursery and Children's Centre,147,20,0,20
Newham,Ronald Openshaw Nursery School,116,27,4,31
Newham,St Stephen's Nursery School,198,25,0,25
Newham,Sheringham Nursery School & Children's Centre,179,58,0,58
Newham,Oliver Thomas Nursery School,142,39,0,39
Newham,Tunmarsh School,64,40,24,64
Newham,Altmore Infant School,550,59,8,67
Newham,Avenue Primary School,652,87,16,103
Newham,Brampton Primary School,925,120,30,150
Newham,Carpenters Primary School,420,46,11,57
Newham,Dersingham Primary School,624,58,11,69
Newham,Godwin Junior School,373,96,5,101
Newham,Woodgrange Infant School,378,74,9,83
Newham,Grange Primary School,205,31,1,32
Newham,Keir Hardie Primary School,444,61,12,73
Newham,Lathom Junior School,553,65,11,76
Newham,Stratford Manor Primary School & Nursery,214,36,8,44
Newham,Maryland Primary School,428,41,10,51
Newham,Odessa Infant School,222,25,2,27
Newham,Park Primary School,666,75,19,94
Newham,Roman Road Primary School,391,58,6,64
Newham,Salisbury Primary School,528,88,9,97
Newham,William Davies Primary School,238,31,8,39
Newham,Star Primary School,642,63,17,80
Newham,St Stephen's Primary School,621,52,22,74
Newham,Winsor Primary School,620,55,18,73
Newham,Colegrave Primary School,595,58,30,88
Newham,Southern Road Primary School,615,78,7,85
Newham,Calverton Primary School,373,43,27,70
Newham,Ellen Wilkinson Primary School,448,53,4,57
Newham,Essex Primary School,921,100,29,129
Newham,St James' CofE Junior School,218,24,12,36
Newham,West Ham Church Primary School,304,37,11,48
Newham,St Luke's Primary School,218,25,6,31
Newham,St Michael's Catholic Primary School,214,11,1,12
Newham,Little Ilford School,1582,296,65,361
Newham,Plashet School,1496,134,21,155
Newham,St Angela's Ursuline School,1274,32,10,42
Newham,St Bonaventure's RC School,1333,118,23,141
Newham,Grangewood Independent School,50,5,7,12
Redbridge,The Constance Bridgeman Centre,17,1,0,1
Redbridge,Manford Primary School,458,44,15,59
Redbridge,Cleveland Road Primary School,902,161,22,183
Redbridge,Fairlop Primary School,714,58,16,74
Redbridge,Gilbert Colvin Primary School,398,41,12,53
Redbridge,Glade Primary School,445,25,22,47
Redbridge,Goodmayes Primary School,665,54,17,71
Redbridge,Gordon Primary School,409,53,9,62
Redbridge,Mossford Green Primary School,452,97,10,107
Redbridge,Newbury Park Primary School,856,115,34,149
Redbridge,Uphall Primary School,915,79,15,94
Redbridge,William Torbitt Primary School,600,62,18,80
Redbridge,Aldersbrook Primary School,679,57,30,87
Redbridge,Roding Primary School,432,52,45,97
Redbridge,Wells Primary School,339,42,7,49
Redbridge,Snaresbrook Primary School,459,25,10,35
Redbridge,Fullwood Primary School,459,13,18,31
Redbridge,Woodlands Primary School,724,126,18,144
Redbridge,Grove Primary School,675,78,20,98
Redbridge,Chadwell Primary School,674,92,32,124
Redbridge,Coppice Primary School,453,60,17,77
Redbridge,John Bramston Primary School,437,32,14,46
Redbridge,Nightingale Primary School,712,95,16,111
Redbridge,Barley Lane Primary School,854,55,35,90
Redbridge,Wanstead Church School,203,25,7,32
Redbridge,St Augustine's Catholic Primary School,450,109,19,128
Redbridge,St Antony's Catholic Primary School,441,15,9,24
Redbridge,St Bede's Catholic Primary School,444,55,5,60
Redbridge,Wohl Ilford Jewish Primary School,215,17,7,24
Redbridge,Caterham High School,1019,152,32,184
Redbridge,Ilford County High School,1184,35,7,42
Redbridge,Wanstead High School,1470,153,40,193
Redbridge,Woodford County High School,1240,30,3,33
Redbridge,Woodbridge High School,1851,232,38,270
Redbridge,Seven Kings School,2227,193,87,280
Redbridge,Valentines High School,1346,72,52,124
Redbridge,Mayfield School,1896,181,21,202
Redbridge,Trinity Catholic High School,1641,122,18,140
Redbridge,King Solomon High School,1003,96,24,120
Redbridge,St Aubyn's School,504,46,0,46
Redbridge,Woodford Green Preparatory School,379,83,0,83
Redbridge,Beehive Preparatory School,64,8,0,8
Redbridge,Eastcourt Independent School,182,3,0,3
Redbridge,Snaresbrook Prep School,140,13,0,13
Redbridge,Avon House School,272,34,0,34
Redbridge,Park School for Girls,123,11,0,11
Redbridge,The Ursuline Prep School Ilford,107,9,0,9
Redbridge,Bancrofts School,880,119,1,120
Redbridge,Little Heath School,196,0,196,196
Redbridge,New Rush Hall School,66,2,64,66
Redbridge,Hatton School and Special Needs Centre,190,0,190,190
Richmond upon Thames,Windham Nursery School,90,0,0,0
Richmond upon Thames,Carlisle Infant School,246,21,8,29
Richmond upon Thames,Darell Primary and Nursery School,204,20,20,40
Richmond upon Thames,East Sheen Primary School,574,64,18,82
Richmond upon Thames,Hampton Hill Junior School,359,26,24,50
Richmond upon Thames,Hampton Junior School,447,46,16,62
Richmond upon Thames,Hampton Infant School and Nursery,407,35,9,44
Richmond upon Thames,Hampton Wick Infant and Nursery School,205,20,1,21
Richmond upon Thames,Heathfield Junior School,422,49,33,82
Richmond upon Thames,Heathfield Infant School,348,61,12,73
Richmond upon Thames,Lowther Primary School,278,25,9,34
Richmond upon Thames,Meadlands Primary School,233,14,7,21
Richmond upon Thames,Orleans Primary School,453,18,11,29
Richmond upon Thames,The Russell Primary School,219,21,5,26
Richmond upon Thames,Sheen Mount Primary School,580,37,24,61
Richmond upon Thames,Stanley  Primary School,519,57,39,96
Richmond upon Thames,Trafalgar Junior School,286,29,5,34
Richmond upon Thames,Trafalgar Infant School,188,13,5,18
Richmond upon Thames,Barnes Primary School,479,38,15,53
Richmond upon Thames,Collis Primary School,718,45,13,58
Richmond upon Thames,Buckingham Primary School,519,81,15,96
Richmond upon Thames,Chase Bridge Primary School,650,29,15,44
Richmond upon Thames,The Vineyard School,607,42,18,60
Richmond upon Thames,St Richard's Church of England Primary School,214,30,19,49
Richmond upon Thames,Holy Trinity Church of England Primary School,412,34,11,45
Richmond upon Thames,St Mary Magdalen's Catholic Primary School,203,26,3,29
Richmond upon Thames,St Elizabeth's Catholic Primary School,232,24,10,34
Richmond upon Thames,St John the Baptist Church of England Junior School,229,29,11,40
Richmond upon Thames,St Edmund's Catholic Primary School,465,36,10,46
Richmond upon Thames,St James's Roman Catholic Primary School,677,42,25,67
Richmond upon Thames,St Mary's Church of England Primary School,617,75,15,90
Richmond upon Thames,St Stephen's C E Primary School,415,31,10,41
Richmond upon Thames,Sacred Heart Roman Catholic Primary School,187,18,8,26
Richmond upon Thames,St Mary's and St Peter's Church of England Primary School,610,36,19,55
Richmond upon Thames,Bishop Perrin Church of England Primary School,205,23,5,28
Richmond upon Thames,St Osmund's Catholic Primary School,151,10,4,14
Richmond upon Thames,Archdeacon Cambridge's Church of England Primary School,439,33,7,40
Richmond upon Thames,The Queen's Church of England Primary School,395,35,15,50
Richmond upon Thames,Christ's Church of England Comprehensive Secondary School,1036,88,47,135
Richmond upon Thames,King's House School,419,16,3,19
Richmond upon Thames,Lady Eleanor Holles School,978,123,0,123
Richmond upon Thames,The Mall School,198,35,1,36
Richmond upon Thames,Newland House School,463,70,2,72
Richmond upon Thames,The Old Vicarage School,220,41,0,41
Richmond upon Thames,St Catherine's School,432,85,1,86
Richmond upon Thames,Tower House School,174,45,2,47
Richmond upon Thames,Broomfield House School,176,23,0,23
Richmond upon Thames,Jack and Jill School,217,11,0,11
Richmond upon Thames,Kew College Prep,274,42,0,42
Richmond upon Thames,St Paul's School,1517,1,1,2
Richmond upon Thames,Twickenham Preparatory School,277,57,0,57
Richmond upon Thames,Unicorn School,169,24,0,24
Richmond upon Thames,The German School,864,140,0,140
Richmond upon Thames,Hampton School,1567,462,0,462
Richmond upon Thames,The Royal Ballet School,221,42,0,42
Richmond upon Thames,The Swedish School,242,4,0,4
Richmond upon Thames,The Harrodian School,1046,61,0,61
Sutton,Spencer Nursery School,71,5,0,5
Sutton,Thomas Wall Nursery School,109,21,0,21
Sutton,Hackbridge Primary School,779,112,4,116
Sutton,High View Primary School,452,40,12,52
Sutton,Devonshire Primary School,682,59,5,64
Sutton,Robin Hood Infants' School,262,25,10,35
Sutton,Dorchester Primary School,580,97,14,111
Sutton,Beddington Infants' School,296,49,5,54
Sutton,Robin Hood Junior School,356,24,5,29
Sutton,Nonsuch Primary School,236,25,7,32
Sutton,Foresters Primary School,258,38,44,82
Sutton,All Saints Benhilton CofE Primary School,461,38,7,45
Sutton,Holy Trinity CofE Junior School,351,52,11,63
Sutton,St Dunstan's Cheam CofE Primary School,444,53,6,59
Sutton,St Cecilia's Catholic Primary School,468,52,6,58
Sutton,St Mary's RC Junior School,361,54,2,56
Sutton,St Mary's RC Infants School,288,31,1,32
Sutton,St Elphege's RC Junior School,387,55,9,64
Sutton,St Elphege's RC Infants' School,341,48,6,54
Sutton,Stanley Park Junior School,373,50,6,56
Sutton,The John Fisher School,1163,157,22,179
Sutton,St Philomena's Catholic High School for Girls,1479,169,10,179
Sutton,Homefield Preparatory School,313,19,0,19
Sutton,Collingwood School,120,18,1,19
Sutton,Seaton House School,170,4,0,4
Sutton,Sutton High School GDST,847,134,2,136
Sutton,Sherwood Park School,167,0,167,167
Waltham Forest,Low Hall Nursery School,73,8,2,10
Waltham Forest,Church Hill Nursery School,109,3,5,8
Waltham Forest,Acacia Nursery,113,9,4,13
Waltham Forest,Chase Lane Primary School,673,89,19,108
Waltham Forest,Whitehall Primary School,466,52,26,78
Waltham Forest,Downsell Primary School,429,89,32,121
Waltham Forest,Newport School,843,102,14,116
Waltham Forest,Chapel End Infant School and Early Years Centre,318,56,6,62
Waltham Forest,Edinburgh Primary School,293,49,11,60
Waltham Forest,Greenleaf Primary School,467,48,20,68
Waltham Forest,Handsworth Primary School,444,87,24,111
Waltham Forest,Thorpe Hall Primary School,364,55,8,63
Waltham Forest,The Winns Primary School,619,73,17,90
Waltham Forest,Oakhill Primary School,179,43,6,49
Waltham Forest,Henry Maynard Primary School,784,120,31,151
Waltham Forest,South Grove Primary School,471,59,29,88
Waltham Forest,Dawlish Primary School,179,25,8,33
Waltham Forest,Gwyn Jones Primary School,426,29,22,51
Waltham Forest,George Tomlinson Primary School,477,85,16,101
Waltham Forest,Mission Grove Primary School,831,66,25,91
Waltham Forest,Coppermill Primary School,236,39,10,49
Waltham Forest,Stoneydown Park School,579,81,22,103
Waltham Forest,Buxton School,1203,192,52,244
Waltham Forest,Parkside Primary School,677,85,26,111
Waltham Forest,The Jenny Hammond Primary School,415,37,22,59
Waltham Forest,Chingford CofE Primary School,419,85,12,97
Waltham Forest,St Mary's Catholic Primary School,213,30,8,38
Waltham Forest,St Joseph's Catholic Junior School,138,30,4,34
Waltham Forest,St Patrick's Catholic Primary School,428,31,11,42
Waltham Forest,St Joseph's Catholic Infant School,146,19,3,22
Waltham Forest,Frederick Bremer School,889,135,77,212
Waltham Forest,Heathcote School & Science College,1098,159,63,222
Waltham Forest,Willowfield School,939,164,29,193
Waltham Forest,Leytonstone School,1002,144,27,171
Waltham Forest,Walthamstow School for Girls,895,94,17,111
Waltham Forest,Kelmscott School,986,106,29,135
Waltham Forest,Holy Family Catholic School,1270,84,21,105
Waltham Forest,Forest School,1521,194,0,194
Haringey,Hyland House School,46,6,0,6
Waltham Forest,Normanhurst School,281,32,0,32
Barnet,St Mary's and St John's CofE School,1647,187,25,212
Birmingham,Bordesley Green East Nursery School,98,9,0,9
Birmingham,Brearley Nursery School,128,36,2,38
Birmingham,Garretts Green Nursery School,76,18,6,24
Birmingham,Perry Beeches Nursery School,73,7,0,7
Birmingham,St Thomas Centre Nursery School,117,18,0,18
Birmingham,Highfield Nursery School,157,39,0,39
Birmingham,Marsh Hill Nursery School,119,24,0,24
Birmingham,West Heath Nursery School,118,16,1,17
Birmingham,Goodway Nursery School,105,12,2,14
Birmingham,Kings Norton Nursery School,89,15,1,16
Birmingham,Allens Croft Nursery School,162,18,10,28
Birmingham,Rubery Nursery School,119,18,0,18
Birmingham,Washwood Heath Nursery School,145,34,0,34
Birmingham,Weoley Castle Nursery School,158,52,3,55
Birmingham,Highters Heath Nursery School,53,14,1,15
Birmingham,Gracelands Nursery School,88,15,1,16
Birmingham,Jakeman Nursery School,80,16,2,18
Birmingham,Lillian De Lissa Nursery School,93,13,0,13
Birmingham,Bloomsbury Nursery School,113,16,0,16
Birmingham,Featherstone Nursery School,111,14,0,14
Birmingham,Adderley Nursery School,127,26,2,28
Birmingham,Newtown Nursery School,107,19,0,19
Birmingham,Shenley Fields Nursery School,146,14,5,19
Birmingham,Castle Vale Nursery School,160,47,7,54
Birmingham,Osborne Nursery School,121,14,1,15
Birmingham,City of Birmingham School,351,329,21,350
Birmingham,Edith Cadbury Nursery School,87,18,1,19
Birmingham,Shaw Hill Primary School,474,35,7,42
Birmingham,Adderley Primary School,453,50,1,51
Birmingham,Barford Primary School,421,58,1,59
Birmingham,Beeches Junior School,359,36,2,38
Birmingham,Beeches Infant School,270,30,5,35
Birmingham,The Oaks Primary School,340,101,3,104
Birmingham,Bordesley Green Primary School,670,126,1,127
Birmingham,Cherry Orchard Primary School,467,39,29,68
Birmingham,Colmore Junior School,477,78,7,85
Birmingham,Colmore Infant and Nursery School,412,70,4,74
Birmingham,Cotteridge Primary School,444,79,9,88
Birmingham,Anderton Park Primary School,463,53,4,57
Birmingham,Regents Park Community Primary School,461,67,1,68
Birmingham,Summerfield Junior and Infant School,414,75,1,76
Birmingham,George Dixon Primary School,359,54,7,61
Birmingham,Gilbertstone Primary School,431,85,4,89
Birmingham,Grendon Primary School,376,64,6,70
Birmingham,Gunter Primary School,187,37,3,40
Birmingham,Hall Green Junior School,479,55,7,62
Birmingham,Hall Green Infant School,404,44,3,47
Birmingham,Story Wood School,234,36,2,38
Birmingham,Hawthorn Primary School,228,37,13,50
Birmingham,Ward End Primary School,906,163,16,179
Birmingham,Kingsland Primary School (NC),329,75,4,79
Birmingham,Lakey Lane Junior and Infant School,456,87,5,92
Birmingham,Lozells Junior and Infant School and Nursery,456,56,15,71
Birmingham,Lyndon Green Junior School,362,57,16,73
Birmingham,Lyndon Green Infant School,280,43,13,56
Birmingham,Marsh Hill Primary School,418,57,2,59
Birmingham,Nelson Junior and Infant School,440,68,14,82
Birmingham,Paget Primary School,392,103,23,126
Birmingham,Park Hill Primary School,339,62,8,70
Birmingham,Allens Croft Primary School,417,96,26,122
Birmingham,Raddlebarn Primary School,424,57,1,58
Birmingham,Redhill Primary School,204,47,5,52
Birmingham,Rednal Hill Junior School,344,76,7,83
Birmingham,Rednal Hill Infant School,293,57,3,60
Birmingham,Severne Junior Infant and Nursery School,414,42,4,46
Birmingham,Sladefield Infant School,360,38,5,43
Birmingham,Somerville Primary (NC) School,730,102,11,113
Birmingham,Stanville Primary School,239,54,1,55
Birmingham,St Benedict's Primary School,374,59,9,68
Birmingham,Stechford Primary School,442,38,2,40
Birmingham,Colebourne Primary School,464,67,5,72
Birmingham,Ladypool Primary School,267,49,1,50
Birmingham,Sundridge Primary School,166,42,2,44
Birmingham,Court Farm Primary School,233,46,2,48
Birmingham,Thornton Primary School,505,96,7,103
Birmingham,World's End Junior School,357,65,10,75
Birmingham,Yardley Wood Community Primary School,448,90,4,94
Birmingham,Yorkmead Junior and Infant School,462,54,4,58
Birmingham,Broadmeadow Junior School,223,48,2,50
Birmingham,Broadmeadow Infant School,180,51,0,51
Birmingham,Bellfield Infant School (NC),202,43,4,47
Birmingham,Bellfield Junior School,270,58,3,61
Birmingham,Welsh House Farm Community School and Special Needs Resources Base,236,36,18,54
Birmingham,The Meadows Primary School,585,83,39,122
Birmingham,Chilcote Primary School,446,54,6,60
Birmingham,Blakesley Hall Primary School,560,102,6,108
Birmingham,Woodgate Primary School,404,63,12,75
Birmingham,Deykin Avenue Junior and Infant School,210,59,0,59
Birmingham,Hollywood Primary School,405,66,16,82
Birmingham,Cofton Primary School,408,46,8,54
Birmingham,William Murdoch Primary School,631,71,4,75
Birmingham,Featherstone Primary School,417,71,4,75
Birmingham,Glenmead Primary School,302,33,3,36
Birmingham,Arden Primary School,703,47,15,62
Birmingham,Water Mill Primary School,204,28,2,30
Birmingham,Welford Primary School,443,41,7,48
Birmingham,Chad Vale Primary School,418,15,13,28
Birmingham,Woodthorpe Junior and Infant School,213,37,1,38
Birmingham,World's End Infant and Nursery School,326,20,5,25
Birmingham,Kitwell Primary School,185,54,2,56
Birmingham,Boldmere Junior School,380,54,20,74
Birmingham,Boldmere Infant School and Nursery,315,34,9,43
Birmingham,Minworth Junior and Infant School,206,39,2,41
Birmingham,Wylde Green Primary School,420,64,3,67
Birmingham,Moor Hall Primary School,368,20,2,22
Birmingham,Maney Hill Primary School,420,45,3,48
Birmingham,Penns Primary School,211,24,3,27
Birmingham,Holland House Infant School and Nursery,197,27,4,31
Birmingham,Benson Community School,417,52,7,59
Birmingham,Kingsthorne Primary School,366,61,2,63
Birmingham,Woodcock Hill Primary School,195,38,2,40
Birmingham,Elms Farm Community Primary School,385,71,4,75
Birmingham,Bells Farm Primary School,199,51,2,53
Birmingham,Nelson Mandela School,453,82,12,94
Birmingham,Little Sutton Primary School,422,23,0,23
Birmingham,Coppice Primary School,414,40,1,41
Birmingham,Calshot Primary School,462,42,5,47
Birmingham,Grove School,678,127,6,133
Birmingham,New Hall Primary School,324,34,2,36
Birmingham,Christ Church CofE Controlled Primary School and Nursery,228,25,2,27
Birmingham,Moseley Church of England Primary School,212,31,1,32
Birmingham,"St James Church of England Primary School, Handsworth",418,67,7,74
Birmingham,St Matthew's CofE Primary School,205,18,5,23
Birmingham,St Saviour's C of E Primary School,413,59,13,72
Birmingham,St Mary's Church of England Primary School,417,58,12,70
Birmingham,St Laurence Church Junior School,364,62,4,66
Birmingham,St Vincent's Catholic Primary School,232,57,6,63
Birmingham,Holy Family Catholic Primary School,232,31,4,35
Birmingham,Christ The King Catholic Primary School,400,85,6,91
Birmingham,Corpus Christi Catholic Primary School,405,70,3,73
Birmingham,English Martyrs' Catholic Primary School,379,64,3,67
Birmingham,Maryvale Catholic Primary School,230,15,2,17
Birmingham,The Oratory Roman Catholic Primary School,213,32,3,35
Birmingham,Our Lady of Lourdes Catholic Primary School,227,29,4,33
Birmingham,St Augustine's Catholic Primary School,241,34,3,37
Birmingham,St Catherine of Siena Catholic Primary School,249,39,1,40
Birmingham,St Anne's Catholic Primary School,204,30,4,34
Birmingham,St Francis Catholic Primary School,384,85,6,91
Birmingham,St Mary's Catholic Primary School,418,32,5,37
Birmingham,St Patrick's Catholic Primary School,178,26,1,27
Birmingham,St Edmund's Catholic Primary School,198,39,3,42
Birmingham,Our Lady and St Rose of Lima Catholic Primary School,233,31,2,33
Birmingham,King David Primary School,226,42,3,45
Birmingham,Bournville Village Primary,654,55,3,58
Birmingham,St Edward's Catholic Primary School,405,41,7,48
Birmingham,St Margaret Mary RC Junior and Infant School,384,32,1,33
Birmingham,St Dunstan's Catholic Primary School,378,37,2,39
Birmingham,St Teresa's Catholic Primary School,210,33,4,37
Birmingham,St Gerard's RC Junior and Infant School,234,22,0,22
Birmingham,St Laurence Church Infant School,270,54,4,58
Birmingham,St Bernadette's Catholic Primary School,634,102,19,121
Birmingham,St Bernard's Catholic Primary School,412,36,4,40
Birmingham,St Jude's Catholic Primary School,205,38,3,41
Birmingham,St Ambrose Barlow Catholic Primary School,207,20,4,24
Birmingham,St Alban's Catholic Primary School,211,34,1,35
Birmingham,St Martin de Porres Catholic Primary School,206,44,2,46
Birmingham,St Peter's Catholic Primary School,208,24,3,27
Birmingham,St Cuthbert's RC Junior and Infant (NC) School,244,53,6,59
Birmingham,St Clare's Catholic Primary School,280,47,5,52
Birmingham,St John and Monica Catholic Primary School,207,37,5,42
Birmingham,Holly Hill Methodist CofE Infant School,174,46,4,50
Birmingham,Hodge Hill Girls' School,745,90,9,99
Birmingham,Kings Heath Boys,732,84,5,89
Birmingham,Bordesley Green Girls' School & Sixth Form,974,122,20,142
Birmingham,Queensbridge School,904,200,23,223
Birmingham,Selly Park  Girls' School,793,111,2,113
Birmingham,Wheelers Lane Technology College,670,155,18,173
Birmingham,Hodge Hill College,1221,125,7,132
Birmingham,Holte School,1194,236,12,248
Birmingham,Swanshurst School,1866,280,8,288
Birmingham,Moseley School and Sixth Form,1475,244,6,250
Birmingham,St Paul's School for Girls,1027,164,8,172
Birmingham,St John Wall Catholic School,636,46,4,50
Birmingham,Cardinal Wiseman Catholic School,759,108,11,119
Birmingham,Walmley Junior School,360,68,3,71
Birmingham,Walmley Infant School,321,38,5,43
Birmingham,Bishop Challoner Catholic College,1228,181,13,194
Birmingham,King's Norton Boys' School,795,151,13,164
Birmingham,Colmers School and Sixth Form College,1247,215,12,227
Birmingham,St George's School Edgbaston,391,57,47,104
Birmingham,Priory School,400,21,5,26
Birmingham,Edgbaston High School for Girls,873,70,0,70
Birmingham,Hallfield School,572,55,1,56
Birmingham,Norfolk House School,150,15,0,15
Birmingham,Rosslyn School,15,0,0,0
Birmingham,West House School,347,34,2,36
Birmingham,Highclare School,519,63,8,71
Birmingham,The Shrubbery School Ltd,95,19,0,19
Birmingham,The Blue Coat School Birmingham,623,50,0,50
Birmingham,King Edward's School,875,119,0,119
Birmingham,King Edward VI High School for Girls,658,58,0,58
Birmingham,Darul Uloom Islamic High School,134,0,134,134
Birmingham,Mander Portman Woodward Independent College,209,39,0,39
Birmingham,Red Boots School (National Institute of Conductive Education),17,0,17,17
Birmingham,Birchfield Independent Girls' School,123,2,0,2
Wirral,Prenton Primary School,394,44,4,48
Birmingham,Hamilton School,128,0,128,128
Birmingham,Victoria School,226,0,226,226
Birmingham,Longwill A Primary School for Deaf Children,62,0,62,62
Birmingham,Uffculme School,264,0,264,264
Birmingham,Baskerville School,176,0,176,176
Birmingham,Braidwood School for the Deaf,70,0,70,70
Birmingham,Selly Oak Trust School,386,0,386,386
Birmingham,Priestley Smith School,86,0,86,86
Birmingham,The Dame Ellen Pinsent School,151,0,151,151
Birmingham,The Pines Special School,264,0,264,264
Birmingham,Springfield House Community Special School,85,0,85,85
Birmingham,Fox Hollies School,110,0,110,110
Birmingham,Cherry Oak School,111,0,111,111
Birmingham,Beaufort School,96,0,96,96
Birmingham,Oscott Manor School,177,0,177,177
Birmingham,Langley School,103,0,103,103
Birmingham,Lindsworth School,130,0,130,130
Coventry,Hillfields Nursery School,153,44,0,44
Coventry,Hollyfast Primary School,629,77,6,83
Coventry,Earlsdon Primary School,416,59,3,62
Coventry,Edgewick Community Primary School,440,76,8,84
Coventry,Gosford Park Primary School,442,65,7,72
Coventry,Little Heath Primary School,238,48,9,57
Coventry,Longford Park Primary School,226,32,7,39
Coventry,St Christopher Primary School,448,56,3,59
Coventry,Whitley Abbey Primary School,409,70,3,73
Coventry,Allesley Hall Primary School,187,21,6,27
Coventry,Ernesford Grange Primary School,470,70,5,75
Coventry,Potters Green Primary School,381,44,3,47
Coventry,Allesley Primary School,394,60,7,67
Coventry,Grangehurst Primary School,411,102,8,110
Coventry,Grange Farm Primary School,416,45,7,52
Coventry,Eastern Green Junior School,237,54,3,57
Coventry,Park Hill Primary School,420,48,4,52
Coventry,Cannon Park Primary School,205,23,2,25
Coventry,Sowe Valley Primary School,215,35,4,39
Coventry,Broad Heath Community Primary School,684,58,7,65
Coventry,Joseph Cash Primary School,480,76,8,84
Coventry,Whoberley Hall Primary School,218,52,4,56
Coventry,Holbrook Primary School,626,65,5,70
Coventry,Stoke Primary School,435,45,7,52
Coventry,Coundon Primary School,566,69,6,75
Coventry,Aldermoor Farm Primary School,616,102,18,120
Coventry,Ravensdale Primary School,453,49,5,54
Coventry,Stoke Heath Primary School,510,114,6,120
Coventry,Whitmore Park Primary School,675,109,8,117
Coventry,Stivichall Primary School,531,85,16,101
Coventry,John Gulson Primary School,479,61,5,66
Coventry,Manor Park Primary School,731,57,6,63
Coventry,Templars Primary School,657,140,9,149
Coventry,Frederick Bird Primary School,807,112,7,119
Coventry,Wyken Croft Primary School,909,165,14,179
Coventry,Moseley Primary School,486,87,7,94
Coventry,John Shelton Community Primary School,238,62,4,66
Coventry,All Saints Church of England Primary School,244,49,3,52
Coventry,St Andrew's Church of England Infant School,179,39,3,42
Coventry,St Osburg's Catholic Primary School,218,26,3,29
Coventry,Our Lady of the Assumption Catholic Primary School,224,35,2,37
Coventry,St Anne's Catholic Primary School,228,59,3,62
Coventry,All Souls' Catholic Primary School,234,43,1,44
Coventry,Holy Family Catholic Primary School,445,100,5,105
Coventry,Pattison College,151,14,2,16
Coventry,King Henry VIII School,805,153,3,156
Coventry,Bablake School,708,170,2,172
Coventry,Lote Tree Primary School,85,7,0,7
Coventry,BKHS Bablake Preparatory School,356,86,1,87
Coventry,Sherbourne Fields School,241,0,241,241
Coventry,Tiverton School,113,0,113,113
Coventry,Baginton Fields School,117,0,117,117
Dudley,Netherton Park Nursery School,140,67,5,72
Dudley,Brierley Hill Primary School,227,21,1,22
Dudley,Brockmoor Primary School,418,81,29,110
Dudley,Brook Primary School,406,56,9,65
Dudley,Maidensbridge Primary School,204,27,6,33
Dudley,Mount Pleasant Primary School,366,31,4,35
Dudley,Dawley Brook Primary School,210,29,5,34
Dudley,Red Hall Primary School,384,89,7,96
Dudley,Fairhaven Primary School,299,26,10,36
Dudley,Thorns Primary School,196,50,5,55
Dudley,Crestwood Park Primary School,209,19,15,34
Dudley,Peters Hill Primary School,825,108,14,122
Dudley,Blanford Mere Primary School,312,38,1,39
Dudley,Greenfield Primary School,279,43,9,52
Dudley,Wollescote Primary School,435,111,15,126
Dudley,Caslon Primary Community  School,259,21,20,41
Dudley,Huntingtree Primary School,437,56,18,74
Dudley,The Ridge Primary School,231,24,3,27
Dudley,Amblecote Primary School,307,47,14,61
Dudley,Hurst Green Primary School,418,53,8,61
Dudley,Withymoor Primary School,418,36,15,51
Dudley,Cotwall End Primary School,418,64,11,75
Dudley,Russells Hall Primary School,413,52,18,70
Dudley,Howley Grange Primary School,422,50,7,57
Dudley,Newfield Park Primary School,474,78,6,84
Dudley,Ashwood Park Primary School,334,47,28,75
Dudley,Bromley Hills Primary School,303,50,11,61
Dudley,Hawbush Primary School,264,49,21,70
Dudley,Roberts Primary School,697,84,20,104
Dudley,Gig Mill Primary School,589,80,22,102
Dudley,Wrens Nest Primary School,514,82,40,122
Dudley,Queen Victoria Primary School,560,87,8,95
Dudley,Straits Primary School,406,51,2,53
Dudley,Belle Vue Primary School,451,43,11,54
Dudley,Dingle Community Primary School,193,28,4,32
Dudley,Quarry Bank Primary School,386,57,9,66
Dudley,Glynne Primary School,472,64,9,73
Dudley,Milking Bank Primary School,466,30,13,43
Dudley,St Mark's CofE Primary School,345,64,14,78
Dudley,St Mary's CofE (VC) Primary School,207,19,7,26
Dudley,Christ Church CofE Primary School,591,75,17,92
Dudley,Oldswinford C of E Primary School,420,33,8,41
Dudley,St Margaret's At Hasbury CofE Primary School,194,23,7,30
Dudley,Jesson's CofE Primary School (VA),715,78,24,102
Dudley,Cradley CofE Primary School,211,24,4,28
Dudley,Halesowen CofE Primary School,210,67,8,75
Dudley,Our Lady and St Kenelm RC School,201,11,3,14
Dudley,St James's CofE Primary School,417,46,6,52
Dudley,Summerhill School,1046,172,37,209
Dudley,The Dormston School,1150,236,32,268
Dudley,The Wordsley School,895,118,29,147
Dudley,Alder Coppice Primary School,426,45,6,51
Dudley,Old Swinford Hospital,742,62,11,73
Dudley,Elmfield Rudolf Steiner School Limited,204,41,15,56
Dudley,Sutton School,184,1,183,184
Dudley,The Brier School,174,0,174,174
Dudley,Woodsetton School,104,0,104,104
Dudley,The Old Park School,153,0,153,153
Dudley,Halesbury School,165,0,165,165
Dudley,Rosewood School,51,0,51,51
Dudley,Pens Meadow School,109,0,109,109
Sandwell,Albright Education Centre,11,7,4,11
Sandwell,Hamstead Junior School,232,19,6,25
Sandwell,Hamstead Infant School,212,10,3,13
Sandwell,Hargate Primary School,485,29,44,73
Sandwell,Albert Pritchard Infant School,278,35,6,41
Sandwell,Moorlands Primary School,206,38,7,45
Sandwell,Old Park Primary School,470,93,23,116
Sandwell,Park Hill Primary School,235,30,12,42
Sandwell,Wood Green Junior School,342,57,6,63
Sandwell,Burnt Tree Primary School,445,71,6,77
Sandwell,Great Bridge Primary School,456,56,25,81
Sandwell,Ocker Hill Infant School,232,52,3,55
Sandwell,Whitecrest Primary School,204,13,5,18
Sandwell,Eaton Valley Primary School,464,71,7,78
Sandwell,Glebefields Primary School,388,82,6,88
Sandwell,Tipton Green Junior School,353,56,8,64
Sandwell,Abbey Junior School,353,24,7,31
Sandwell,Abbey Infant School,290,16,1,17
Sandwell,Annie Lennard Primary School,222,20,7,27
Sandwell,Bearwood Primary School,465,43,8,51
Sandwell,Bleakhouse Primary School,434,48,6,54
Sandwell,Brickhouse Primary School,232,55,8,63
Sandwell,Cape Primary School,590,80,16,96
Sandwell,Crocketts Community Primary School,477,82,21,103
Sandwell,Grace Mary Primary School,253,57,18,75
Sandwell,Highfields Primary School,441,73,8,81
Sandwell,Moat Farm Infant School,418,139,12,151
Sandwell,Oakham Primary School,466,44,13,57
Sandwell,Old Hill Primary School,243,21,5,26
Sandwell,Perryfields Primary School,354,83,8,91
Sandwell,Reddal Hill Primary School,432,85,12,97
Sandwell,Rowley Hall Primary School,616,73,14,87
Sandwell,Temple Meadow Primary School,389,49,6,55
Sandwell,Tividale Hall Primary School,455,75,4,79
Sandwell,Lyng Primary School,492,64,12,76
Sandwell,Lodge Primary School,446,56,10,66
Sandwell,Joseph Turner Primary School,458,51,8,59
Sandwell,Grove Vale Primary School,420,38,9,47
Sandwell,Yew Tree Primary School,654,75,9,84
Sandwell,Brandhall Primary School,476,79,5,84
Sandwell,Hall Green Primary School,457,87,8,95
Sandwell,Langley Primary School,448,35,10,45
Sandwell,Ryders Green Primary School,461,59,8,67
Sandwell,Blackheath Primary School,481,63,13,76
Sandwell,Ferndale Primary School,599,64,26,90
Sandwell,Causeway Green Primary School,447,77,16,93
Sandwell,Rood End Primary School,505,83,9,92
Sandwell,Holy Trinity CofE Primary School,461,59,8,67
Sandwell,St Martin's CofE Primary School,242,23,9,32
Sandwell,St Mary Magdalene CofE Voluntary Controlled Primary School,235,28,7,35
Sandwell,All Saints CofE Primary School,459,36,7,43
Sandwell,St Margaret's CofE Primary School,227,19,4,23
Sandwell,Holy Name Catholic Primary School,214,13,7,20
Sandwell,Christ Church CofE Primary School,424,29,19,48
Sandwell,St Matthew's CofE Primary School,416,38,5,43
Sandwell,Holly Lodge High School College of Science,1575,208,22,230
Sandwell,St Michael's Church of England High School,1212,260,39,299
Solihull,Triple Crown Centre,2,0,2,2
Solihull,Blossomfield Infant and Nursery School,317,26,7,33
Solihull,Burman Infant School,214,9,6,15
Solihull,Coppice Junior School,259,43,4,47
Solihull,Cranmore Infant School,211,13,2,15
Solihull,Dorridge Primary School,686,76,10,86
Solihull,Haslucks Green School,240,24,3,27
Solihull,Kineton Green Primary School,224,39,6,45
Solihull,Sharmans Cross Junior School,419,86,9,95
Solihull,Shirley Heath Junior School,420,54,7,61
Solihull,Valley Primary,621,73,11,84
Solihull,Woodlands Infant School,203,10,3,13
Solihull,Widney Junior School,325,38,9,47
Solihull,Oak Cottage Primary School,241,9,0,9
Solihull,Mill Lodge Primary School,238,18,14,32
Solihull,Marston Green Junior School,353,64,8,72
Solihull,Tidbury Green School,478,68,6,74
Solihull,Castle Bromwich Junior School,475,85,10,95
Solihull,Castle Bromwich Infant and Nursery School,501,56,10,66
Solihull,Coleshill Heath School,579,79,14,93
Solihull,Windy Arbor Primary School,451,100,29,129
Solihull,Cheswick Green Primary School,253,35,6,41
Solihull,Peterbrook Primary School,432,57,8,65
Solihull,Olton Primary School,651,77,11,88
Solihull,Yorkswood Primary School,435,96,6,102
Solihull,Greswold Primary School,687,73,18,91
Solihull,Langley Primary School,432,53,9,62
Solihull,Monkspath Junior and Infant School,671,69,8,77
Solihull,Meriden Church of England Primary School,203,45,9,54
Solihull,St Alphege Church of England Infant and Nursery School,262,17,3,20
Solihull,St Alphege Church of England Junior School,284,25,6,31
Solihull,Berkswell Church of England Voluntary Aided Primary School,234,16,3,19
Solihull,George Fentham Endowed School,221,19,4,23
Solihull,St Mary and St Margaret's Church of England Aided Primary School,230,21,6,27
Solihull,Bishop Wilson Church of England Primary School,444,89,7,96
Solihull,Fordbridge Community Primary School,548,97,10,107
Solihull,Eversfield Preparatory School,312,8,1,9
Solihull,Solihull School,1534,215,2,217
Solihull,Ruckleigh School,217,15,0,15
Solihull,Kingswood School,75,20,5,25
Solihull,Hazel Oak School,190,0,190,190
Solihull,Reynalds Cross School,146,2,144,146
Solihull,Forest Oak School,181,0,181,181
Solihull,Merstone School,148,2,146,148
Walsall,Sandbank Nursery School,198,11,2,13
Walsall,Fullbrook Nursery School,125,28,1,29
Walsall,Rowley View Nursery School,160,11,4,15
Walsall,Valley Nursery School,198,7,17,24
Walsall,Millfields Nursery School,76,5,0,5
Walsall,Lane Head Nursery School,83,10,0,10
Walsall,Alumwell Nursery School,144,14,0,14
Walsall,Ogley Hay Nursery School,88,20,1,21
Walsall,Alumwell Junior School,364,39,15,54
Walsall,Alumwell Infant School,270,36,12,48
Walsall,Blakenall Heath Junior School,222,47,0,47
Walsall,Sunshine Infant and Nursery School,201,37,8,45
Walsall,Butts Primary School,248,36,10,46
Walsall,Delves Infant School,349,30,9,39
Walsall,Elmore Green Primary School,308,59,8,67
Walsall,Leamore Primary School,240,37,8,45
Walsall,Palfrey Junior School,361,60,10,70
Walsall,Palfrey Infant School,353,27,9,36
Walsall,Whitehall Junior Community School,328,52,7,59
Walsall,Whitehall Nursery and Infant School,315,13,12,25
Walsall,Abbey Primary School,233,33,5,38
Walsall,Lower Farm Primary School,480,57,8,65
Walsall,Delves Junior School,358,56,7,63
Walsall,Bentley West Primary School Additionally Resourced for Hearing Impaired,456,93,14,107
Walsall,King Charles Primary School,451,70,21,91
Walsall,Pinfold Street Primary School,416,97,15,112
Walsall,Salisbury Primary School,325,40,6,46
Walsall,Kings Hill Primary School,477,56,16,72
Walsall,New Invention Infant School,340,53,12,65
Walsall,Short Heath Junior School,287,59,26,85
Walsall,County Bridge Primary School,234,45,7,52
Walsall,Pool Hayes Primary School,216,31,2,33
Walsall,New Invention Junior School,362,51,15,66
Walsall,Rushall Primary School,264,36,33,69
Walsall,Whetstone Field Primary School,237,11,6,17
Walsall,Walsall Wood School,236,37,5,42
Walsall,Watling Street Primary School,230,42,5,47
Walsall,Millfield Primary School,226,27,3,30
Walsall,Castlefort Junior Mixed and Infant School,235,30,2,32
Walsall,Radleys Primary School,229,37,5,42
Walsall,Manor Primary School,383,38,2,40
Walsall,Lindens Primary School,459,31,17,48
Walsall,Pelsall Village School,296,58,8,66
Walsall,Greenfield Primary School,268,37,3,40
Walsall,Meadow View JMI School,464,59,6,65
Walsall,Christ Church CofE Primary School,427,79,28,107
Walsall,Little Bloxwich CofE VC Primary School,211,16,7,23
Walsall,Holy Trinity Church of England Primary School,204,29,6,35
Walsall,Old Church Church of England C Primary School,437,66,7,73
Walsall,Rosedale Church of England C Infant School,242,44,14,58
Walsall,St Giles Church of England Primary School,456,57,6,63
Walsall,St Michael's Church of England C Primary School,445,55,10,65
Walsall,St John's Church of England Primary School,358,29,12,41
Walsall,Blue Coat Church of England Aided Junior School,359,65,11,76
Walsall,Blue Coat Church of England Aided Infant School,312,40,8,48
Walsall,St Mary's The Mount Catholic Primary School,233,16,10,26
Walsall,"St Patrick's Catholic Primary School, Walsall",226,31,10,41
Walsall,"St Peter's Catholic Primary School, Bloxwich",220,19,5,24
Walsall,"St Joseph's Catholic Primary School, Darlaston",225,55,3,58
Walsall,St Thomas of Canterbury Catholic Primary School,289,53,9,62
Walsall,St Francis Catholic Primary School,202,21,6,27
Walsall,St Mary of the Angels Catholic Primary School,229,19,4,23
Walsall,"St Anne's Catholic Primary School, Streetly",235,8,3,11
Walsall,St Francis of Assisi Catholic College,1161,118,20,138
Walsall,"St Thomas More Catholic School, Willenhall",1498,159,33,192
Walsall,Mayfield Preparatory School,212,5,1,6
Walsall,Hydesville Tower School,323,16,2,18
Walsall,Castle School,218,0,218,218
Walsall,"The Jane Lane School,  A College for Cognition & Learning",163,1,162,163
Walsall,Mary Elliot School,135,0,135,135
Walsall,Old Hall School,102,0,102,102
Walsall,Oakwood School,150,0,150,150
Wolverhampton,Low Hill Nursery School,141,52,7,59
Wolverhampton,Ashmore Park Nursery School,76,5,0,5
Wolverhampton,Eastfield Nursery School,133,9,0,9
Wolverhampton,Phoenix Nursery School,32,3,0,3
Wolverhampton,Windsor Nursery School,90,18,4,22
Wolverhampton,Bushbury Nursery School,90,19,5,24
Wolverhampton,Orchard Centre (The Nightingale Home and Hospital Service),35,9,26,35
Wolverhampton,Bushbury Hill Primary School,292,77,10,87
Wolverhampton,Fallings Park Primary School,738,130,16,146
Wolverhampton,Whitgreave Primary School,462,83,15,98
Wolverhampton,Graiseley Primary School,229,64,1,65
Wolverhampton,Springdale Primary  School,435,46,30,76
Wolverhampton,Rakegate Primary School,462,62,11,73
Wolverhampton,Claregate Primary School,430,53,5,58
Wolverhampton,Castlecroft Primary School,247,38,5,43
Wolverhampton,Westacre Infant School,291,21,3,24
Wolverhampton,Loxdale Primary School,429,91,6,97
Wolverhampton,Stowlawn Primary School,350,57,7,64
Wolverhampton,Long Knowle Primary School,230,38,3,41
Wolverhampton,Wood End Primary School,248,29,6,35
Wolverhampton,Stow Heath Primary School,483,96,25,121
Wolverhampton,Wilkinson Primary School,489,45,1,46
Wolverhampton,Lanesfield Primary School,322,49,2,51
Wolverhampton,Spring Vale Primary School,404,63,3,66
Wolverhampton,Uplands Junior School,380,26,8,34
Wolverhampton,Merridale Primary School,238,34,4,38
Wolverhampton,Oak Meadow Primary School,425,59,8,67
Wolverhampton,Eastfield Primary School,406,59,15,74
Wolverhampton,Warstones Primary School,468,66,10,76
Wolverhampton,Wodensfield Primary School,472,36,14,50
Wolverhampton,Dovecotes Primary School,276,39,2,41
Wolverhampton,Christ Church (Church of England) Infant and Nursery School,204,22,2,24
Wolverhampton,Christ Church (Church of England) Junior School,239,24,4,28
Wolverhampton,St Luke's Church of England Aided Primary School,470,83,7,90
Wolverhampton,Holy Trinity Catholic Primary School,241,39,5,44
Wolverhampton,St Paul's Church of England Aided Primary School,236,29,7,36
Wolverhampton,St Michael's Church of England Aided Primary School,214,21,15,36
Wolverhampton,St Matthias School,882,222,31,253
Wolverhampton,Colton Hills Community School,1021,110,12,122
Wolverhampton,Tettenhall College Incorporated,477,40,10,50
Wolverhampton,Newbridge Preparatory School,135,0,0,0
Wolverhampton,Wolverhampton Grammar School,768,143,2,145
Wolverhampton,Penn Fields School,186,3,183,186
Wolverhampton,Tettenhall Wood School,152,0,152,152
Wolverhampton,Green Park School,143,0,143,143
Knowsley,Meadow Park School,50,48,2,50
Knowsley,Roby Park Primary School,221,46,6,52
Knowsley,Knowsley Village School,211,21,1,22
Knowsley,Prescot Primary School,437,57,18,75
Knowsley,Malvern Primary School,468,66,8,74
Knowsley,Park Brow Community Primary School,463,72,18,90
Knowsley,Westvale Primary School,229,49,6,55
Knowsley,Millbrook Community Primary School,316,45,9,54
Knowsley,Plantation Primary School,488,37,10,47
Knowsley,Ravenscroft Community Primary School,216,32,1,33
Knowsley,Evelyn Community Primary School,264,17,12,29
Knowsley,Eastcroft Park School,238,40,2,42
Knowsley,Kirkby CofE Primary School,302,45,3,48
Knowsley,St Mary and St Paul's CofE Primary School,241,57,12,69
Knowsley,Holy Family Catholic Primary School & Nursery,222,40,7,47
Knowsley,Our Lady's Catholic Primary School,225,25,5,30
Knowsley,St Luke's Catholic Primary School,212,16,2,18
Knowsley,St Laurence's Catholic Primary School,381,64,7,71
Knowsley,St Aidan's Catholic Primary School,222,18,3,21
Knowsley,St Michael and All Angels Catholic Primary School,439,62,11,73
Knowsley,St Marie's Catholic Primary School,228,28,4,32
Knowsley,St Albert's Catholic Primary School,233,78,12,90
Knowsley,Holy Family Catholic Primary School,333,46,4,50
Knowsley,St Mark's Catholic Primary School,228,44,6,50
Knowsley,St Andrew the Apostle Catholic Primary School,241,22,9,31
Knowsley,St Joseph's Catholic Primary School,204,35,3,38
Knowsley,St Brigid's Catholic Primary School,257,61,16,77
Knowsley,St Leo's and Southmead Catholic Primary School Serving the Community,223,33,3,36
Knowsley,St John Fisher Catholic Primary School,224,24,1,25
Knowsley,St Anne's Catholic Primary School,331,45,7,52
Knowsley,Saints Peter and Paul Catholic Primary School,363,52,9,61
Knowsley,St Columba's Catholic Primary School,230,22,12,34
Knowsley,St Margaret Mary's Catholic Infant School,411,20,4,24
Knowsley,St Margaret Mary's Catholic Junior School,478,68,12,80
Knowsley,Bluebell Park School,220,0,220,220
Knowsley,Alt Bridge School,272,0,272,272
Knowsley,Knowsley Central School,100,0,100,100
Liverpool,Chatham Place Nursery School,64,9,2,11
Liverpool,East Prescot Road Nursery School,78,9,5,14
Liverpool,Everton Nursery School and Family Centre,159,61,6,67
Liverpool,Ellergreen Nursery School and Childcare Centre,169,36,10,46
Liverpool,Abercromby Nursery School,79,5,6,11
Liverpool,Banks Road Primary School,323,45,6,51
Liverpool,Barlows Primary School,442,69,5,74
Liverpool,Belle Vale Community Primary School,279,42,4,46
Liverpool,Blackmoor Park Junior School,351,72,10,82
Liverpool,Booker Avenue Junior School,389,59,6,65
Liverpool,Corinthian Community Primary School,388,84,16,100
Liverpool,Gilmour Junior School,350,41,15,56
Liverpool,Gilmour (Southbank) Infant School,315,21,5,26
Liverpool,Springwood Heath Primary School,239,29,51,80
Liverpool,Hunts Cross Primary School,355,58,7,65
Liverpool,Knotty Ash Primary School,254,39,31,70
Liverpool,Lister Junior School,216,34,2,36
Liverpool,Lister Infant and Nursery School,210,31,3,34
Liverpool,Matthew Arnold Primary School,280,51,13,64
Liverpool,Northcote Primary School,432,76,15,91
Liverpool,Northway Primary and Nursery School,410,53,11,64
Liverpool,Pleasant Street Primary School,232,49,7,56
Liverpool,Whitefield Primary School,319,100,7,107
Liverpool,Ranworth Square Primary School,236,44,4,48
Liverpool,Sudley Infant School,354,45,4,49
Liverpool,Windsor Community Primary School,238,49,9,58
Liverpool,Middlefield Community Primary School,364,52,1,53
Liverpool,Blackmoor Park Infants' School,389,33,5,38
Liverpool,Booker Avenue Infant School,297,29,10,39
Liverpool,Sudley Junior School,449,68,6,74
Liverpool,Norman Pannell Primary School,209,41,6,47
Liverpool,Gwladys Street Primary and Nursery School,412,131,10,141
Liverpool,Broadgreen Primary,231,58,11,69
Liverpool,St Cleopas' Church of England Junior Mixed and Infant School,299,83,2,85
Liverpool,Wavertree Church of England School,161,39,4,43
Liverpool,St Anne's (Stanley) Junior Mixed and Infant School,393,64,5,69
Liverpool,"St Mary's Church of England Primary School, West Derby",209,37,6,43
Liverpool,Childwall Church of England Primary School,423,52,7,59
Liverpool,Christ The King Catholic Primary School,411,56,3,59
Liverpool,Our Lady and St Swithin's Catholic Primary School,235,28,28,56
Liverpool,Holy Cross Catholic Primary School,188,40,2,42
Liverpool,Holy Name Catholic Primary School,337,34,5,39
Liverpool,Holy Trinity Catholic Primary School,218,24,3,27
Liverpool,Much Woolton Catholic Primary School,417,41,6,47
Liverpool,Our Lady Immaculate Catholic Primary School,372,79,9,88
Liverpool,St Finbar's Catholic Primary School,192,43,3,46
Liverpool,Sacred Heart Catholic Primary School and Nursery,207,42,1,43
Liverpool,Our Lady's Bishop Eton Catholic Primary School,421,43,2,45
Liverpool,St Austin's Catholic Primary School,432,65,6,71
Liverpool,St Cecilia's Catholic Junior School,237,32,9,41
Liverpool,St Charles' Catholic Primary School,194,28,4,32
Liverpool,St Clare's Catholic Primary School,186,33,5,38
Liverpool,St Cuthbert's Catholic Primary and Nursery School,233,37,4,41
Liverpool,St Francis de Sales Catholic Junior School,435,56,11,67
Liverpool,St Francis de Sales Catholic Infant and Nursery School,404,73,10,83
Liverpool,St Hugh's Catholic Primary School,206,36,4,40
Liverpool,St Michael's Catholic Primary School,442,67,4,71
Liverpool,St Patrick's Catholic Primary School,237,65,7,72
Liverpool,St Paul's Catholic Junior School,491,95,6,101
Liverpool,St Sebastian's Catholic Primary School and Nursery,248,54,4,58
Liverpool,St Vincent de Paul Catholic Primary School,252,60,7,67
Liverpool,Our Lady of Good Help Catholic Primary School,141,33,4,37
Liverpool,St Paul's and St Timothy's Catholic Infant School,360,43,6,49
Liverpool,St Anthony of Padua Catholic Primary School,214,25,2,27
Liverpool,St Cecilia's Catholic Infant & Nursery School,197,32,2,34
Liverpool,St Gregory's Catholic Primary School,241,37,8,45
Liverpool,St Paschal Baylon Catholic Primary School,413,53,5,58
Liverpool,St Anne's Catholic Primary School,259,49,5,54
Liverpool,King David Primary School,431,51,9,60
Liverpool,Holly Lodge Girls' College,956,146,9,155
Liverpool,Calderstones School,1552,217,21,238
Liverpool,Gateacre School,1161,157,43,200
Liverpool,King David High School,758,92,34,126
Liverpool,Archbishop Blanch CofE High School,1075,140,21,161
Liverpool,Notre Dame Catholic College,1001,176,56,232
Liverpool,St Julie's Catholic High School,1061,155,12,167
Liverpool,Broughton Hall Catholic High School,1218,181,15,196
Liverpool,Cardinal Heenan Catholic High School,1360,291,34,325
Liverpool,St John Bosco Arts College,1072,172,15,187
Liverpool,Archbishop Beck Catholic College,1198,179,31,210
Liverpool,St Hilda's Church of England High School,1114,180,80,260
Liverpool,Carleton House Preparatory School,182,7,1,8
Liverpool,The Belvedere Preparatory School,154,0,1,1
Liverpool,Christian Fellowship School,172,59,6,65
Liverpool,St Vincent's School - A Specialist School for Sensory Impairment and Other Needs,47,0,47,47
Liverpool,Royal School for the Blind (Liverpool),81,14,67,81
Liverpool,Abbot's Lea School,271,0,271,271
Liverpool,Woolton High School,73,0,73,73
Liverpool,Clifford Holroyde Specialist Sen College,66,0,66,66
Liverpool,Ernest Cookson School,65,0,65,65
Liverpool,Palmerston School,149,0,149,149
Liverpool,Redbridge High School,146,0,146,146
Liverpool,Princes School,184,0,184,184
Liverpool,Millstead School,136,2,134,136
St. Helens,Pace,3,3,0,3
St. Helens,Allanson Street Primary School,454,116,9,125
St. Helens,Rivington Primary School,241,52,2,54
St. Helens,Robins Lane Community Primary School,223,20,4,24
St. Helens,Thatto Heath Community Primary School,633,124,12,136
St. Helens,Sutton Manor Community Primary School,220,21,6,27
St. Helens,Sherdley Primary School,436,61,3,64
St. Helens,Eaves Primary School,220,46,6,52
St. Helens,Ashurst Primary School,221,35,4,39
St. Helens,Willow Tree Primary School,219,43,6,49
St. Helens,Bleak Hill Primary School,553,57,4,61
St. Helens,Grange Valley Primary School,284,45,10,55
St. Helens,Newton-le-Willows Primary School,631,69,14,83
St. Helens,Lyme Community Primary School,220,52,2,54
St. Helens,Longton Lane Community Primary School,261,38,6,44
St. Helens,Garswood Primary and Nursery School,207,26,5,31
St. Helens,Chapel End Primary School,206,29,1,30
St. Helens,Rainford Brook Lodge Community Primary School,209,17,3,20
St. Helens,Oakdene Primary School,210,31,2,33
St. Helens,Legh Vale Primary School,517,101,8,109
St. Helens,Eccleston Mere Primary School,408,19,13,32
St. Helens,Merton Bank Primary School,219,40,0,40
St. Helens,Wargrave CofE Primary School,419,88,7,95
St. Helens,Eccleston Lane Ends Primary School,248,20,10,30
St. Helens,Sutton Oak CofE Primary School,316,62,5,67
St. Helens,The District CofE Primary School,375,76,2,78
St. Helens,Rectory CofE Primary School,161,18,28,46
St. Helens,St Aidan's CofE  Primary School Billinge,204,20,10,30
St. Helens,St Peter's CofE Primary School,236,36,0,36
St. Helens,St. Mary's  Catholic Primary Blackbrook,421,55,10,65
St. Helens,Holy Cross Catholic Primary School,196,44,0,44
St. Helens,St Anne's Catholic Primary School,264,63,4,67
St. Helens,St Austin's Catholic Primary School,217,31,3,34
St. Helens,"St Teresa's Catholic Primary School, Devon Street",191,28,2,30
St. Helens,St Thomas of Canterbury Catholic Primary School,211,22,3,25
St. Helens,St Peter and St Paul Catholic Primary School,199,17,3,20
St. Helens,St John Vianney Catholic Primary School,193,31,5,36
St. Helens,St Mary's Catholic Primary School,199,10,2,12
St. Helens,Corpus Christi Catholic Primary School,153,22,9,31
St. Helens,St Bartholomew's Catholic Primary School,290,31,6,37
St. Helens,St Mary's Catholic Junior School,235,28,1,29
St. Helens,St Mary's Catholic Infant School,207,27,0,27
St. Helens,Haydock English Martyrs' Primary School,294,59,5,64
St. Helens,St Julie's Catholic Primary School,235,24,6,30
St. Helens,St Theresa's Catholic Primary School,226,32,6,38
St. Helens,Cowley International College,1463,223,26,249
St. Helens,De La Salle School,1194,194,50,244
St. Helens,St Cuthbert's Catholic High School,910,177,15,192
St. Helens,Tower College,447,44,0,44
St. Helens,Nugent House School,59,0,59,59
St. Helens,Willow Bank School,60,0,60,60
Sefton,Crossens Nursery School,66,5,0,5
Sefton,Cambridge Nursery School,102,22,0,22
Sefton,Greenacre Community Nursery School,66,17,3,20
Sefton,IMPACT,65,35,1,36
Sefton,Jigsaw Primary Pupil Referral Unit,4,4,0,4
Sefton,Linacre Primary School,148,49,0,49
Sefton,Netherton Moss Primary School,215,92,3,95
Sefton,The Grange Primary School,280,35,60,95
Sefton,Birkdale Primary School,453,67,2,69
Sefton,Farnborough Road Junior School,479,63,8,71
Sefton,Farnborough Road Infant School,440,49,1,50
Sefton,Linaker Primary School,438,56,3,59
Sefton,Norwood Primary School,620,76,8,84
Sefton,Marshside Primary School,172,20,10,30
Sefton,Aintree Davenhill Primary School,451,61,8,69
Sefton,Hudson Primary School,304,28,45,73
Sefton,Waterloo Primary School,370,68,36,104
Sefton,Forefield Junior School,360,58,5,63
Sefton,Forefield Community Infant and Nursery School,323,34,5,39
Sefton,Lander Road Primary School,257,27,1,28
Sefton,Hatton Hill Primary School,381,79,8,87
Sefton,Northway Primary School,367,22,5,27
Sefton,Woodlands Primary School,374,31,1,32
Sefton,Summerhill Primary School,210,17,4,21
Sefton,Freshfield Primary School,276,37,24,61
Sefton,Green Park Primary School,252,28,1,29
Sefton,Redgate Community Primary School,269,47,39,86
Sefton,Kings Meadow Primary School and Early Years Education Centre,203,34,10,44
Sefton,Larkfield Primary School,280,46,2,48
Sefton,Melling Primary School,215,27,7,34
Sefton,Valewood Primary School,211,33,8,41
Sefton,Lydiate Primary School,238,29,2,31
Sefton,Bedford Primary School,373,84,15,99
Sefton,Christ Church Church of England Controlled Primary School,440,92,6,98
Sefton,St John's Church of England Primary School,182,43,7,50
Sefton,St Luke's Church of England Primary School,372,70,4,74
Sefton,St Philip's Church of England Controlled Primary School,201,32,3,35
Sefton,St Oswald's Church of England Primary School,233,65,0,65
Sefton,St Philip's Church of England Primary School,203,17,0,17
Sefton,Ainsdale St John's Church of England Primary School,205,21,6,27
Sefton,St Monica's Catholic Primary School,455,84,2,86
Sefton,St Robert Bellarmine Catholic Primary School,238,24,2,26
Sefton,Holy Family Catholic Primary School,202,35,2,37
Sefton,Our Lady of Lourdes Catholic Primary School,486,51,34,85
Sefton,St Patrick's Catholic Primary School,344,19,5,24
Sefton,St John's Church of England Primary School,195,26,1,27
Sefton,St Luke's Halsall Church of England Primary School,235,29,2,31
Sefton,St Nicholas Church of England Primary School,211,18,6,24
Sefton,St George's Catholic Primary School,234,23,1,24
Sefton,Great Crosby Catholic Primary School,776,42,1,43
Sefton,St Mary's Catholic Primary School,98,11,0,11
Sefton,St Edmund's and St Thomas' Catholic Primary School,330,34,3,37
Sefton,Our Lady Star of the Sea Catholic Primary School,216,60,2,62
Sefton,Our Lady of Compassion Catholic Primary School,228,11,2,13
Sefton,English Martyrs' Catholic Primary School,464,54,1,55
Sefton,St Elizabeth's Catholic Primary School,436,62,4,66
Sefton,St William of York Catholic Primary School,233,35,4,39
Sefton,Our Lady Queen of Peace Catholic Primary School,143,41,3,44
Sefton,St Gregory's Catholic Primary School,240,19,0,19
Sefton,Ursuline Catholic Primary School,410,47,4,51
Sefton,St Jerome's Catholic Primary School,203,18,5,23
Telford and Wrekin,Short Wood Primary School,566,115,9,124
Sefton,Holy Rosary Catholic Primary School,460,19,3,22
Sefton,St John Bosco Catholic Primary School,213,22,1,23
Sefton,Bishop David Sheppard Church of England Primary School,203,51,4,55
Sefton,Meols Cop High School,902,117,33,150
Sefton,Maricourt Catholic High School,1200,118,10,128
Sefton,Holy Family Catholic High School,953,132,29,161
Sefton,Christ The King Catholic High School and Sixth Form Centre,870,108,9,117
Sefton,St Mary's College,817,69,9,78
Sefton,Merchant Taylors' Boys' School,603,132,0,132
Sefton,Merchant Taylors' Girls' School,631,59,2,61
Sefton,Presfield High School and Specialist College,123,0,123,123
Sefton,Merefield School,104,0,104,104
Sefton,Crosby High School,167,0,167,167
Sefton,Newfield School,99,0,99,99
Sefton,Rowan Park School,297,0,297,297
Wirral,Somerville Nursery School,76,20,1,21
Wirral,Castleway Nursery School,68,3,4,7
Wirral,Ganneys Meadow Nursery School and Family Centre,135,38,13,51
Wirral,Bedford Drive Primary School,428,77,3,80
Wirral,Woodlands Primary School,325,59,6,65
Wirral,Devonshire Park Primary School,458,61,25,86
Wirral,New Brighton Primary School,598,89,19,108
Wirral,Mount Primary School,344,53,6,59
Wirral,Liscard Primary School,716,144,6,150
Wirral,St George's Primary School,907,78,6,84
Wirral,Riverside Primary School,257,82,6,88
Wirral,Kingsway Primary School,157,59,5,64
Wirral,Park Primary School,442,68,8,76
Wirral,Somerville Primary School,481,76,8,84
Wirral,Eastway Primary School,252,41,28,69
Wirral,Castleway Primary School,123,44,5,49
Wirral,Sandbrook Primary School,82,34,2,36
Wirral,Greenleas Primary School,297,33,7,40
Wirral,Lingham Primary School,390,76,0,76
Wirral,Higher Bebington Junior School,365,57,5,62
Wirral,Grove Street Primary School,327,96,0,96
Wirral,Thornton Hough Primary School,183,7,0,7
Wirral,Mendell Primary School,170,26,1,27
Wirral,Brookhurst Primary School,210,25,4,29
Wirral,Raeburn Primary School,465,30,5,35
Wirral,Brackenwood Infant School,165,8,0,8
Wirral,Greasby Infant School,210,4,6,10
Wirral,West Kirby Primary School,315,27,0,27
Wirral,Irby Primary School,216,39,0,39
Wirral,Black Horse Hill Infant School,166,11,3,14
Wirral,Brookdale Primary School,215,29,4,33
Wirral,Barnston Primary School,309,15,1,16
Wirral,Black Horse Hill Junior School,203,25,2,27
Wirral,Heswall Primary School,213,42,0,42
Wirral,Fender Primary School,237,82,19,101
Wirral,Manor Primary School,138,30,3,33
Wirral,Mersey Park Primary School,463,102,6,108
Wirral,Overchurch Infant School,290,32,5,37
Wirral,Rock Ferry Primary School,304,81,6,87
Wirral,Woodchurch Road Primary School,279,49,5,54
Wirral,Cathcart Street Primary School,220,58,4,62
Wirral,Well Lane Primary School,226,39,2,41
Wirral,Thingwall Primary School,210,32,6,38
Wirral,Leasowe Primary School,268,88,35,123
Wirral,Overchurch Junior School,347,43,6,49
Wirral,Bidston Avenue Primary School,455,89,1,90
Wirral,West Kirby St Bridget's CofE Primary School,426,39,2,41
Wirral,Hoylake Holy Trinity CofE Primary School,313,51,10,61
Wirral,Birkenhead Christ Church CofE Primary School,181,43,2,45
Wirral,Oxton St Saviour's CofE Aided Primary School,218,33,0,33
Wirral,Woodchurch CofE Primary School,204,25,0,25
Wirral,St Joseph's Catholic Primary School Upton,266,30,9,39
Wirral,St Peter's Catholic Primary School,191,46,5,51
Wirral,St Paul's Catholic Primary School,113,28,4,32
Wirral,Ss Peter and Paul Catholic Primary School,265,26,4,30
Wirral,St Alban's Catholic Primary School,355,79,3,82
Wirral,"St Joseph's Catholic Primary School, Wallasey",207,73,0,73
Wirral,Sacred Heart Catholic Primary School,349,40,3,43
Wirral,St Andrew's CofE Aided Primary School,206,48,2,50
Wirral,Thurstaston Dawpool CofE Primary School,219,6,5,11
Wirral,Heswall St Peter's CofE Primary School,328,28,1,29
Wirral,St John's Catholic Junior School,248,64,3,67
Wirral,Christ The King Catholic Primary School,418,40,6,46
Wirral,St John's Catholic Infant School,221,1,2,3
Wirral,Ladymount Catholic Primary School,232,14,1,15
Wirral,The Priory Parish CofE Primary School,193,40,6,46
Wirral,Our Lady and St Edward's Catholic Primary School,467,92,3,95
Wirral,Holy Cross Catholic Primary School,158,41,0,41
Wirral,St Anne's Catholic Primary School,246,90,2,92
Wirral,St Michael and All Angels Catholic Primary School,232,60,3,63
Wirral,St Werburgh's Catholic Primary School,228,57,1,58
Wirral,Ridgeway High School,873,267,46,313
Wirral,Pensby High School,884,147,6,153
Wirral,The Mosslands School,1045,208,12,220
Wirral,South Wirral High School,1040,256,24,280
Wirral,Prenton Preparatory School,124,14,5,19
Wirral,Avalon School,144,13,6,19
Wirral,Birkenhead School,958,75,3,78
Wirral,Hayfield School,161,0,161,161
Wirral,Clare Mount Specialist Sports College,285,0,285,285
Wirral,Kilgarth School,50,0,50,50
Wirral,Foxfield School,174,1,173,174
Wirral,Elleray Park School,214,0,214,214
Wirral,Meadowside School,104,0,104,104
Wirral,Gilbrook School,60,0,60,60
Greenwich,St Paul's Academy,1120,170,28,198
Wirral,West Kirby Residential School,97,0,97,97
Wirral,Stanley School,143,0,143,143
Wirral,Wirral Hospitals' School,33,29,4,33
Wirral,Orrets Meadow School,82,0,82,82
Bolton,Alexandra Nursery School,70,9,5,14
Bolton,Grosvenor Nursery School and Day Care Centre,120,30,0,30
Bolton,The Orchards Nursery School,101,17,0,17
Bolton,Brandwood Primary School,460,77,9,86
Bolton,Brownlow Fold Primary School,242,34,5,39
Bolton,Castle Hill Primary School,218,33,6,39
Bolton,Church Road Primary School,460,91,6,97
Bolton,Clarendon Primary School,456,71,11,82
Bolton,Devonshire Road Primary School,421,50,14,64
Bolton,Gaskell Community Primary School,461,52,4,56
Bolton,High Lawn Primary School,495,44,8,52
Bolton,Johnson Fold Community Primary School,248,51,4,55
Bolton,Markland Hill Primary School,314,26,7,33
Bolton,Oxford Grove Primary School,448,90,12,102
Bolton,Pikes Lane Primary School,508,76,10,86
Bolton,Sharples Primary School,248,27,13,40
Bolton,Sunning Hill Primary School,523,44,13,57
Bolton,Haslam Park Primary School,306,36,18,54
Bolton,Ladybridge Community Primary School,375,14,9,23
Bolton,Moorgate Primary School,379,67,16,83
Bolton,Heathfield Primary School,248,16,6,22
Bolton,Beaumont Primary School,214,24,3,27
Bolton,Lostock Primary School,209,14,3,17
Bolton,Blackshaw Primary School,236,36,7,43
Bolton,The Oaks Primary School,219,14,4,18
Bolton,Highfield Primary School,417,45,11,56
Bolton,Kearsley West Primary School,220,57,4,61
Bolton,Cherry Tree Primary School,406,82,18,100
Bolton,Hardy Mill Primary School,333,15,6,21
Bolton,Mytham Primary School,374,80,5,85
Bolton,Blackrod Primary School,315,25,2,27
Bolton,Egerton Primary School,214,13,6,19
Bolton,Claypool Primary School,241,16,9,25
Bolton,Spindle Point Primary School,230,27,5,32
Bolton,Gilnow Primary School,211,50,1,51
Bolton,Washacre Primary School,159,41,13,54
Bolton,Eatock Primary School,248,32,5,37
Bolton,"St Mary's CofE Primary School, Deane",477,67,11,78
Bolton,"St Matthew's CofE Primary School, Bolton",442,67,10,77
Bolton,"St James CofE Primary School, Daisy Hill",405,50,5,55
Bolton,Blackrod Anglican/Methodist Primary School,244,41,13,54
Bolton,"St Michael's CofE Primary School, Great Lever",493,78,14,92
Bolton,"St Stephen and All Martyrs' CofE School, Lever Bridge",199,21,4,25
Bolton,"St Thomas C of E Primary School, Halliwell",360,24,12,36
Bolton,Holy Infant and St Anthony RC Primary School,199,45,4,49
Bolton,St Columba's RC Primary School,233,48,4,52
Bolton,St Thomas of Canterbury RC School,411,48,5,53
Bolton,St Ethelbert's RC Primary School,230,37,3,40
Bolton,"St Joseph's RC Primary School, Halliwell, Bolton",223,18,10,28
Bolton,St Peter and St Paul RC Primary School,218,32,2,34
Bolton,St William of York Catholic Primary School,241,30,9,39
Bolton,Bolton Parish Church CofE Primary School,243,35,4,39
Bolton,"St Bernard's RC Primary School, Bolton",208,8,8,16
Bolton,Walmsley CofE Primary School,351,21,2,23
Bolton,Horwich Parish CofE Primary School,324,50,6,56
Bolton,St Thomas CofE Primary School,240,22,2,24
Bolton,"St Andrew's CofE Primary School, Over Hulton",205,40,2,42
Bolton,St Bartholomew's CofE Primary School,212,14,4,18
Bolton,All Saints CofE Primary School,261,48,6,54
Bolton,St Peter's CofE Primary School,423,49,11,60
Bolton,St Stephen's CofE Primary School,195,27,1,28
Bolton,"St John CofE Primary School, Kearsley",161,20,2,22
Bolton,"St Matthew's CofE Primary School, Little Lever",213,19,5,24
Bolton,Sacred Heart R.C. Primary School,418,21,6,27
Bolton,Our Lady of Lourdes RC Primary School,236,32,4,36
Bolton,"St Brendan's RC Primary School, Harwood, Bolton",207,19,2,21
Bolton,St Teresa's RC Primary School,128,18,14,32
Bolton,"St Saviour CofE Primary School, Ringley",208,20,6,26
Bolton,"St John the Evangelist RC Primary School, Bromley Cross, Bolton",180,17,2,19
Bolton,St Mary's RC Primary School,216,23,3,26
Bolton,Westhoughton High School,1327,122,18,140
Bolton,Turton School,1612,137,23,160
Bolton,St Joseph's RC High School,1034,54,13,67
Bolton,Mount St Joseph,898,148,42,190
Bolton,Thornleigh Salesian College,1590,120,37,157
Bolton,Lord's School,52,0,6,6
Bolton,Clevelands Prep School,142,27,1,28
Bolton,Bolton School Boys' Division,1174,119,4,123
Bolton,Bolton School Girls' Division,1033,82,0,82
Bolton,Thomasson Memorial School,77,5,72,77
Bolton,Rumworth School,327,0,327,327
Bolton,Birtenshaw,87,0,87,87
Bolton,Green Fold School,153,1,152,153
Bury,Hoyle Nursery School,96,9,7,16
Bury,Fairfield Community Primary School,243,49,5,54
Bury,Chantlers Primary School,309,24,4,28
Bury,Woodbank Primary School,301,39,17,56
Bury,Chesham Primary School,312,28,13,41
Bury,Old Hall Primary School,196,14,10,24
Bury,Lowercroft Primary School,241,48,6,54
Bury,Hazlehurst Community Primary School,208,36,8,44
Bury,Butterstile Primary School,406,48,21,69
Bury,Mersey Drive Community Primary School,194,30,16,46
Bury,Ribble Drive Community Primary School,181,20,3,23
Bury,Greenmount Primary School,231,19,5,24
Bury,Cams Lane Primary School,200,30,7,37
Bury,Heaton Park Primary School,406,47,16,63
Bury,Park View Primary School,440,24,13,37
Bury,Sedgley Park Community Primary School,305,21,7,28
Bury,Whitefield Community Primary School,180,27,8,35
Bury,Holcombe Brook Primary School,269,33,11,44
Bury,Chapelfield Primary School,285,65,6,71
Bury,Hollins Grundy Primary School,214,30,7,37
Bury,St Peter's Church of England Primary School,252,40,5,45
Bury,St Margaret's Church of England Primary School,235,7,9,16
Bury,Christ Church Ainsworth Church of England Primary School,260,28,8,36
Bury,"All Saints Church of England Primary School, Stand",238,16,5,21
Bury,"St Andrew's Church of England Primary School, Ramsbottom",243,25,7,32
Bury,"St Paul's Church of England Primary School, Bury",226,26,10,36
Bury,"Guardian Angels Roman Catholic Primary School, Bury",236,12,8,20
Bury,"St Marie's Roman Catholic Primary School, Bury",240,49,6,55
Bury,St Joseph and St Bede RC Primary School,335,30,10,40
Bury,"Our Lady of Lourdes Roman Catholic Primary School, Bury",198,17,11,28
Bury,Emmanuel Holcombe Church of England Primary School,107,16,6,22
Bury,"St Mary's Church of England Primary School, Hawkshaw",98,12,0,12
Bury,"St Mary's Church of England Aided Primary School, Prestwich",233,11,8,19
Bury,"St Joseph's Roman Catholic Primary School, Ramsbottom",197,15,6,21
Bury,"Holly Mount Roman Catholic Primary School, Bury",276,27,7,34
Bury,Our Lady of Grace RC Primary School,320,32,4,36
Bury,"St Bernadette's Roman Catholic Primary School, Whitefield",342,19,8,27
Bury,"St Michael's Roman Catholic Primary School, Whitefield",208,18,12,30
Bury,"St Andrew's Church of England Primary School, Radcliffe",238,37,16,53
Bury,St Hilda's Church of England Primary School,191,32,7,39
Bury,Bury and Whitefield Jewish Primary School,112,13,5,18
Bury,"St Mary's Roman Catholic Primary School, Radcliffe",392,77,14,91
Bury,The Elton High School,1027,138,41,179
Bury,The Derby High School,932,152,30,182
Bury,Parrenthorn High School,1011,61,30,91
Bury,Philips High School,882,109,17,126
Bury,Bury Catholic Preparatory School,80,7,0,7
Bury,Darul Uloom Al Arabiya Al Islamiya,390,0,0,0
Bury,Bury Grammar Schools,1317,118,1,119
Bury,Cloughside College,11,8,3,11
Bury,Millwood Primary Special School,160,0,160,160
Manchester,Martenscroft Nursery School & Children's Centre,71,15,0,15
Manchester,Collyhurst Nursery School,43,3,1,4
Manchester,Abbott Community Primary School,239,22,2,24
Manchester,Alma Park Primary School,467,55,23,78
Manchester,Bowker Vale Primary School,455,54,20,74
Manchester,Acacias Community Primary School,471,67,19,86
Manchester,Cavendish Primary School,702,70,26,96
Manchester,Chapel Street Community Primary School,683,87,16,103
Manchester,Charlestown Community Primary School,449,110,7,117
Manchester,Claremont Primary School,640,113,15,128
Manchester,Crosslee Community Primary School,427,72,8,80
Manchester,Crowcroft Park Primary School,241,41,3,44
Manchester,Heald Place Primary School,658,121,15,136
Manchester,Lily Lane Primary School,625,120,15,135
Manchester,Mauldeth Road Primary School,454,37,11,48
Manchester,Moston Fields Primary School,423,78,11,89
Manchester,Moston Lane Community Primary School,472,103,8,111
Manchester,New Moston Primary School,554,153,18,171
Manchester,Northenden Community School,231,12,6,18
Manchester,Plymouth Grove Primary School,408,33,10,43
Manchester,Rack House Primary School,448,48,13,61
Manchester,Ravensbury Community School,464,121,12,133
Manchester,Irk Valley Community School,461,56,20,76
Manchester,Varna Community Primary School,477,85,10,95
Manchester,Cheetwood Primary School,224,31,7,38
Manchester,Crab Lane Primary School,448,49,11,60
Manchester,Broad Oak Primary School,408,46,21,67
Manchester,Peel Hall Primary School,246,49,5,54
Manchester,Sandilands Primary School,426,79,23,102
Manchester,Pike Fold Primary School,448,68,15,83
Manchester,Higher Openshaw Community School,324,84,12,96
Manchester,Manley Park Primary School,427,54,12,66
Manchester,All Saints Primary School,230,41,6,47
Manchester,Medlock Primary School,432,95,11,106
Manchester,Baguley Hall Primary School,521,94,29,123
Manchester,Crumpsall Lane Primary School,415,42,15,57
Manchester,Chorlton CofE Primary School,223,37,10,47
Manchester,Holy Trinity CofE Primary School,468,77,16,93
Manchester,St Augustine's CofE Primary School,220,31,9,40
Manchester,St Chrysostom's CofE Primary School,478,66,14,80
Manchester,St Margaret's CofE Primary School,643,104,21,125
Manchester,St Mary's CofE Junior and Infant School,458,49,12,61
Manchester,St Wilfrid's CofE Junior and Infant School,212,45,5,50
Manchester,St Paul's CofE Primary School,338,33,8,41
Manchester,St Agnes C of E Primary School,445,80,8,88
Manchester,St Clement's CofE Primary School,234,34,2,36
Manchester,Armitage CofE Primary School,487,75,14,89
Manchester,St Luke's CofE Primary School,459,56,8,64
Manchester,St John's CofE Primary School,491,72,13,85
Manchester,All Saints C of E Primary School,222,44,7,51
Manchester,St Andrew's CofE Primary School,370,78,23,101
Manchester,"St James' CofE Primary School, Birch-in-Rusholme",229,15,5,20
Manchester,St Philip's Church of England Primary School,199,13,10,23
Manchester,Christ The King RC Primary School Manchester,424,79,7,86
Manchester,Holy Name Roman Catholic Primary School Manchester,225,24,4,28
Manchester,St Aidan's Catholic Primary School,246,54,5,59
Manchester,St Ambrose RC Primary School,196,17,5,22
Manchester,St Anne's RC Primary School Crumpsall Manchester,413,75,15,90
Manchester,St Brigid's RC Primary School,232,35,4,39
Manchester,St Catherine's RC Primary School,423,39,11,50
Manchester,St Dunstan's RC Primary School,329,18,11,29
Manchester,St Edmund's RC Primary School,238,34,7,41
Manchester,St Francis RC Primary School,248,23,3,26
Manchester,St John Bosco RC Primary School,230,39,11,50
Manchester,St Malachy's RC Primary School,230,15,6,21
Manchester,St Margaret Mary's RC Primary School Manchester,342,29,4,33
Manchester,St Mary's RC Primary School Manchester,327,78,14,92
Manchester,St Patrick's RC Primary School,196,10,7,17
Manchester,Sacred Heart Catholic Primary School,253,31,0,31
Manchester,St Peter's Catholic Primary School,253,35,5,40
Manchester,St Wilfrid's RC Primary School,225,31,2,33
Manchester,St Willibrord's RC Primary School,246,20,14,34
Manchester,St Bernard's RC Primary School Manchester,213,20,10,30
Manchester,Our Lady's RC Primary School Manchester,215,31,6,37
Manchester,St Richard's RC Primary School,474,94,16,110
Manchester,St Mary's CofE Primary School Moston,227,43,3,46
Manchester,St John's RC Primary School,394,47,12,59
Manchester,CofE School of the Resurrection,212,35,5,40
Manchester,Saviour CofE Primary School,160,32,3,35
Manchester,St Joseph's RC Primary School Manchester,243,59,6,65
Manchester,St Cuthbert's RC Primary School,259,55,11,66
Manchester,St Clare's RC Primary School,462,70,20,90
Manchester,Abraham Moss Community School,1822,280,58,338
Manchester,Loreto High School Chorlton,760,124,16,140
Manchester,Our Lady's RC High School,962,86,32,118
Manchester,The Barlow RC High School and Specialist Science College,909,95,40,135
Manchester,Moor Allerton Preparatory School,268,21,0,21
Oldham,The Chadderton Prepraratory School,104,19,3,22
Manchester,Chetham's School of Music,330,75,4,79
Manchester,The Manchester Grammar School,1659,194,3,197
Manchester,Manchester High School for Girls,974,34,0,34
Manchester,St Bede's College,761,116,0,116
Manchester,Withington Girls' School,719,80,0,80
Manchester,King of Kings,27,3,0,3
Manchester,Manchester Muslim Preparatory School,176,17,0,17
Manchester,Abbey College Manchester,211,27,1,28
Manchester,Manchester Hospital School,159,61,25,86
Manchester,Camberwell Park Specialist Support School,187,0,187,187
Manchester,Lancasterian School,183,1,182,183
Manchester,The Birches School,164,0,164,164
Manchester,Meade Hill School,172,0,172,172
Manchester,Rodney House School,72,0,72,72
Manchester,Southern Cross School,129,1,128,129
Oldham,Alexandra Park Junior School,353,40,11,51
Oldham,Beever Primary School,217,34,6,40
Oldham,Limehurst Community Primary School,324,41,4,45
Oldham,Glodwick Infant and Nursery School,329,57,6,63
Oldham,Mills Hill Primary School,658,22,9,31
Oldham,Mather Street Primary School,211,52,4,56
Oldham,Blackshaw Lane Primary & Nursery School,219,27,10,37
Oldham,South Failsworth Community Primary School,440,52,9,61
Oldham,Whitegate End Primary and Nursery School,209,25,8,33
Oldham,Rushcroft Primary School,187,50,1,51
Oldham,Propps Hall Junior Infant and Nursery School,241,43,3,46
Oldham,Diggle School,177,15,2,17
Oldham,Friezland Primary School,104,11,0,11
Oldham,Greenfield Primary School,293,19,7,26
Oldham,Springhead Infant and Nursery School,180,18,1,19
Oldham,Delph Primary School,203,15,8,23
Oldham,Knowsley Junior School,298,21,6,27
Oldham,Buckstones Primary School,206,19,2,21
Oldham,Broadfield Primary School,398,44,15,59
Oldham,Horton Mill Community Primary School,246,44,8,52
Oldham,Burnley Brow Community School,479,34,15,49
Oldham,Stanley Road Primary School,458,66,16,82
Oldham,Woodhouses Voluntary Primary School,130,11,1,12
Oldham,Holy Trinity CofE Dobcross Primary School,225,14,6,20
Oldham,Thornham St James CofE Primary School,203,5,1,6
Oldham,Christ Church CofE Primary School,100,13,3,16
Oldham,Hey-with-Zion Primary School,301,17,3,20
Oldham,St Thomas Moorside CofE (VA) Primary School,229,23,5,28
Oldham,St Thomas CofE Primary School,486,65,17,82
Oldham,St Hugh's CofE Primary School,213,54,6,60
Oldham,St Agnes CofE Primary School,103,18,4,22
Oldham,Holy Rosary RC Junior Infant and Nursery School,228,39,3,42
Oldham,St Hilda's CofE Primary School,393,57,9,66
Oldham,St Martin's CofE Junior Infant and Nursery School,243,47,9,56
Oldham,St Margaret's CofE Junior Infant and Nursery School,346,91,11,102
Oldham,Christ Church CofE Primary School,280,49,4,53
Oldham,St Luke's CofE Primary School,198,42,8,50
Oldham,St Matthew's CofE Primary School,401,52,8,60
Oldham,East Crompton St James CofE Primary School,191,15,5,20
Oldham,St Mary's CofE Primary School High Crompton,206,30,8,38
Oldham,St Thomas' Leesfield CofE Primary School,201,23,7,30
Oldham,St Anne's CofE (Aided) Primary School,286,56,7,63
Oldham,Corpus Christi RC Primary School,332,32,6,38
Oldham,St Joseph's RC Junior Infant and Nursery School,232,31,3,34
Oldham,St Edward's RC School,266,34,8,42
Oldham,Ss Aidan and Oswald's Roman Catholic Primary School,362,41,4,45
Oldham,St Herbert's RC School,340,63,9,72
Oldham,Greenfield St Mary's CofE School,195,13,5,18
Oldham,St Anne's RC Primary School,232,20,10,30
Oldham,St Patrick's RC Primary and Nursery School,213,23,4,27
Oldham,St Mary's RC Primary School,458,32,10,42
Oldham,Saddleworth School,1404,193,41,234
Oldham,The Radclyffe School,1496,114,35,149
Oldham,Oldham Hulme Grammar School,768,19,5,24
Oldham,Farrowdale House School,52,12,0,12
Oldham,Bright Futures School,15,0,15,15
Rochdale,Howard Street Nursery School,86,8,3,11
Rochdale,Sunny Brow Nursery School,59,3,1,4
Rochdale,Brimrod Community Primary School,222,18,5,23
Rochdale,Castleton Primary School,363,63,13,76
Rochdale,Shawclough Community Primary School,443,39,26,65
Rochdale,Greenbank Primary School,461,20,17,37
Rochdale,Heybrook Primary School,704,61,36,97
Rochdale,Meanwood Community Nursery and Primary School,360,59,11,70
Rochdale,Norden Community Primary School,403,68,11,79
Rochdale,Spotland Primary School,446,36,6,42
Rochdale,Lowerplace Primary School,513,89,17,106
Rochdale,Marland Hill Community Primary School,458,59,27,86
Rochdale,Caldershaw Primary School,233,31,0,31
Rochdale,Belfield Community School,406,44,11,55
Rochdale,Whittaker Moss Primary School,427,18,10,28
Rochdale,Ashfield Valley Primary School,240,10,4,14
Rochdale,Littleborough Community Primary School,363,26,7,33
Rochdale,Alkrington Primary School,483,35,16,51
Rochdale,Boarshaw Community Primary School,428,64,24,88
Rochdale,Newhey Community Primary School,312,53,18,71
Rochdale,Elm Wood Primary School,431,69,6,75
Rochdale,Hollin Primary School,352,51,15,66
Rochdale,Harwood Park Primary School,367,72,12,84
Rochdale,Heap Bridge Village Primary School,168,18,3,21
Rochdale,Hopwood Community Primary School,421,53,9,62
Rochdale,Parkfield Primary School,216,45,13,58
Rochdale,Hamer Community Primary School,321,47,11,58
Rochdale,St Edward's Church of England Primary School,337,42,11,53
Rochdale,St Peter's Church of England Primary School,462,71,7,78
Rochdale,"St Mary's Church of England Primary School, Balderstone",208,34,7,41
Rochdale,St Luke's Church of England Primary School,381,72,16,88
Rochdale,"St John's VA Church of England Primary School, Thornham",101,15,3,18
Rochdale,St Gabriel's Church of England Primary School,222,28,1,29
Rochdale,Stansfield Hall Church of England/Free Church Primary School,120,15,1,16
Rochdale,All Souls Church of England Primary School,237,48,3,51
Rochdale,Little Heaton Church of England Primary School,196,35,3,38
Rochdale,"St Michael's Church of England Primary School, Bamford",235,27,6,33
Rochdale,Holy Trinity Church of England Primary School,215,17,7,24
Rochdale,St Margaret's Church of England Primary School,203,34,11,45
Rochdale,"St Mary's Roman Catholic Primary School, Littleborough",219,24,7,31
Rochdale,"St Peter's Roman Catholic Primary School, Rochdale",230,29,4,33
Rochdale,"St Mary's Roman Catholic Primary School, Middleton",455,87,7,94
Rochdale,"St Thomas More Roman Catholic Primary School, Middleton, Rochdale",339,31,9,40
Rochdale,Middleton Parish Church School,419,60,6,66
Rochdale,"St Michael's Church of England Primary School, Alkrington",213,18,4,22
Rochdale,Milnrow Parish Church of England Primary School,207,30,3,33
Rochdale,St Thomas' Church of England Primary School,145,25,6,31
Rochdale,"St Gabriel's Roman Catholic Primary School, Rochdale",187,26,6,32
Rochdale,"St John's Roman Catholic Primary School, Rochdale",217,23,6,29
Rochdale,Sacred Heart Roman Catholic Primary School  Rochdale,230,35,11,46
Rochdale,All Saints Church of England Primary School,228,28,4,32
Rochdale,"Holy Family Roman Catholic Primary School, Rochdale",232,37,5,42
Rochdale,"St Vincent's Roman Catholic Primary School, Rochdale",375,61,4,65
Rochdale,"St Joseph's Roman Catholic Primary School, Rochdale",403,26,7,33
Rochdale,Falinge Park High School,1352,177,30,207
Rochdale,Cardinal Langley Roman Catholic High School,1204,189,45,234
Rochdale,St Cuthbert's RC High School,1118,206,24,230
Rochdale,Crossgates Primary School,317,47,8,55
Rochdale,Smithy Bridge Foundation Primary School,435,91,7,98
Rochdale,"St John Fisher Roman Catholic Primary School, Rochdale",206,22,8,30
Rochdale,Healey Foundation Primary School,208,21,7,28
Rochdale,Beech House School,185,21,8,29
Rochdale,Brownhill School,92,6,86,92
Salford,Light Oaks Junior School,351,83,6,89
Salford,Lower Kersal Community Primary School,230,48,4,52
Salford,Summerville Primary School,229,63,6,69
Salford,Brentnall Primary School,230,37,18,55
Salford,Light Oaks Infant School,307,54,1,55
Salford,The Friars Primary School,391,61,12,73
Salford,Wharton Primary School,390,74,12,86
Salford,Irlam Primary School,438,60,12,72
Salford,Clarendon Road Community Primary School,342,43,4,47
Salford,Lewis Street Primary School,432,64,18,82
Salford,Monton Green Primary School,455,48,14,62
Salford,Westwood Park Community Primary School,270,56,5,61
Salford,Beech Street Community Primary School,253,51,17,68
Salford,Clifton Primary School,300,71,10,81
Salford,Moorside Primary School,629,99,21,120
Salford,Mesne Lea Primary School,431,83,20,103
Salford,Bridgewater Primary School,441,115,8,123
Salford,Peel Hall Primary School,438,119,9,128
Salford,Hilton Lane Primary School,229,78,7,85
Salford,Moorfield Community Primary School,127,27,19,46
Salford,Fiddlers Lane Community Primary School,182,38,6,44
Salford,James Brindley Community Primary School,253,21,9,30
Salford,North Walkden Primary School,225,31,2,33
Salford,The Deans Primary School,405,81,8,89
Salford,Mossfield Primary School,351,79,2,81
Salford,St Paul's CofE Primary School,210,28,2,30
Salford,St John's CofE Primary School,395,72,9,81
Salford,St Luke's CofE Primary School,437,79,15,94
Salford,St George's CofE Primary School,231,38,6,44
Salford,St Andrew's CofE Primary School,471,39,4,43
Salford,St Andrew's CofE Primary School,228,32,4,36
Salford,Christ Church CofE Primary School,225,34,6,40
Salford,St Mary's CofE Primary School,225,20,3,23
Salford,St Paul's CofE Primary School,350,74,4,78
Salford,St Andrew's Methodist Primary School,236,61,7,68
Salford,Irlam Endowed Primary School,235,37,14,51
Salford,Wardley CofE Primary School,232,25,2,27
Salford,St Paul's Peel CofE Primary School,314,95,4,99
Salford,Boothstown Methodist Primary School,210,39,5,44
Salford,St Philip's CofE Primary School,233,34,18,52
Salford,St Paul's CofE Primary School,230,26,4,30
Salford,Godfrey Ermen Memorial CofE Primary School,427,89,6,95
Salford,St Peter's CofE Primary School,226,50,4,54
Salford,St Mark's CofE Primary School,433,54,4,58
Salford,Christ The King RC Primary School,239,33,2,35
Salford,St Teresa's RC Primary School,241,36,3,39
Salford,Holy Cross and All Saints RC Primary School,333,43,3,46
Salford,St Mary's RC Primary School,239,38,7,45
Salford,St Gilbert's RC Primary School,244,35,5,40
Salford,St Charles' RC Primary School,225,51,0,51
Salford,St Mark's RC Primary School,232,36,2,38
Salford,St Mary's RC Primary School,233,41,3,44
Salford,St Joseph the Worker RC Primary School,218,43,7,50
Salford,St Boniface RC Primary School,230,53,3,56
Salford,St Sebastian's RC Primary School,231,49,4,53
Salford,The Cathedral School of St Peter and St John RC Primary,216,37,4,41
Salford,St Joseph's RC Primary School,224,47,0,47
Salford,St Luke's RC Primary School,414,84,3,87
Salford,St Philip's RC Primary School,361,51,1,52
Salford,St Thomas of Canterbury RC Primary School,504,66,21,87
Salford,St Patrick's RC High School,936,139,28,167
Salford,St Ambrose Barlow RC High School,1082,184,15,199
Salford,Branwood Preparatory School,146,8,0,8
Salford,Bridgewater School,478,89,0,89
Salford,Talmud Torah Chinuch Norim School,356,39,0,39
Salford,Bnos Yisroel School Manchester,649,64,9,73
Bury,Prestwich Preparatory School,56,2,1,3
Salford,Mechinoh School,68,0,0,0
Salford,Clarendon Cottage Preparatory School,114,30,3,33
Salford,Tashbar of Manchester,503,82,3,85
Salford,Manchester Junior Girls' School,244,6,6,12
Salford,Oholei Yosef Yitzchok Lubavitch Schools,90,5,1,6
Stockport,Hollywood Park Nursery School,103,32,7,39
Stockport,Lark Hill Nursery School,60,13,0,13
Stockport,Reddish Vale Nursery School,138,10,0,10
Stockport,Freshfield Nursery School,79,11,0,11
Stockport,The Pendlebury Centre,0,0,0,0
Stockport,Moat House,13,6,4,10
Stockport,Adswood Primary School,331,68,23,91
Stockport,Banks Lane Infant School,304,17,6,23
Stockport,Banks Lane Junior School,353,45,10,55
Stockport,Bolshaw Primary School,210,40,6,46
Stockport,Bridge Hall Primary School,214,29,6,35
Stockport,Broadstone Hall Primary School,506,83,13,96
Stockport,Brookside Primary School,178,14,15,29
Stockport,Cheadle Primary School,263,24,5,29
Stockport,Dial Park Primary School,360,55,16,71
Stockport,Etchells Primary School,418,48,16,64
Stockport,Fairway Primary School,244,37,4,41
Stockport,Great Moor Infant School,275,27,4,31
Stockport,Great Moor Junior  School,312,34,8,42
Stockport,Greave Primary School,338,27,12,39
Stockport,High Lane Primary School,174,23,0,23
Stockport,Hursthead Infant School,257,11,2,13
Stockport,Ladybridge Primary School,165,23,11,34
Stockport,Ladybrook Primary School,239,22,4,26
Stockport,Lark Hill Primary School,158,63,11,74
Stockport,Ludworth Primary School,347,42,6,48
Stockport,Mersey Vale Primary School,217,22,3,25
Stockport,Nevill Road Infant School,275,50,4,54
Stockport,Nevill Road Junior School,341,36,5,41
Stockport,Norbury Hall Primary School,452,46,5,51
Stockport,Norris Bank Primary School,413,57,8,65
Stockport,Prospect Vale Primary School,227,7,5,12
Stockport,Queensgate Primary School,286,23,9,32
Stockport,Oak Tree Primary School,645,47,13,60
Stockport,Abingdon Primary School,295,34,16,50
Stockport,Romiley Primary School,458,35,9,44
Stockport,Rose Hill Primary School,555,64,24,88
Stockport,Thorn Grove Primary School,233,16,6,22
Stockport,Tithe Barn Primary School,208,34,11,45
Stockport,Torkington Primary School,218,21,4,25
Stockport,Vernon Park Primary School,339,56,10,66
Stockport,Warren Wood Primary School,428,67,3,70
Stockport,Whitehill Primary School,201,38,6,44
Stockport,Pownall Green Primary School,422,33,4,37
Stockport,Moss Hey Primary School,215,11,8,19
Stockport,Cale Green Primary School,340,36,6,42
Stockport,Lum Head Primary School,259,29,5,34
Stockport,Outwood Primary School,204,15,9,24
Stockport,Lane End Primary School,210,13,5,18
Stockport,Didsbury Road Primary School,472,46,2,48
Stockport,Hazel Grove Primary School,382,59,4,63
Stockport,Arden Primary School,527,77,8,85
Stockport,All Saints Church of England Primary School Marple,214,26,2,28
Stockport,All Saints Church of England Primary School Stockport,214,26,6,32
Stockport,St John's Church of England Primary School,206,25,3,28
Stockport,St Mary's Church of England Primary School,193,26,7,33
Stockport,St Paul's Church of England Primary School Brinnington,391,60,10,70
Stockport,St Thomas' Church of England Primary School Stockport,154,35,2,37
Stockport,Cheadle Catholic Infant School,282,10,12,22
Stockport,Cheadle Catholic Junior School,358,33,9,42
Stockport,North Cheshire Jewish Primary School,203,17,7,24
Stockport,Our Lady's Catholic Primary School,192,26,2,28
Stockport,St Ambrose Catholic Primary School,182,18,7,25
Stockport,St Bernadette's Catholic Primary School,224,37,7,44
Stockport,St Christopher's Catholic Primary School,208,17,9,26
Stockport,St Joseph's Stockport Catholic Primary School,127,21,6,27
Stockport,St Mary's Roman Catholic Primary School Stockport,114,27,3,30
Stockport,St Peter's Catholic Primary School,207,12,3,15
Stockport,St Philip's Catholic Primary School,184,28,5,33
Stockport,St Simon's Catholic Primary School,219,28,5,33
Stockport,St Thomas' Church of England Primary School Heaton Chapel,640,50,14,64
Stockport,"St Winifred's Roman Catholic Primary School, Stockport",394,34,6,40
Stockport,Priestnall School,1265,196,53,249
Stockport,Stockport School,1294,194,32,226
Stockport,Marple Hall School,1562,230,30,260
Stockport,Bramhall High School,1232,130,12,142
Stockport,St James' Catholic High School,807,69,24,93
Stockport,Harrytown Catholic High School,799,102,27,129
Stockport,Brabyns Preparatory School,113,31,3,34
Stockport,Greenbank Preparatory School,239,19,0,19
Stockport,Lady Barn House School,491,57,0,57
Stockport,Hulme Hall Grammar School,218,51,16,67
Stockport,Stella Maris School,49,8,1,9
Stockport,Stockport Grammar School,1552,257,3,260
Stockport,Cheadle Hulme School,1517,261,3,264
Stockport,Covenant Christian School,30,1,0,1
Stockport,Ashcroft School,70,0,70,70
Stockport,"Royal School, Manchester",54,0,54,54
Trafford,St John Vianney School,119,1,118,119
Stockport,Valley School,58,3,55,58
Stockport,Lisburne School,170,0,170,170
Stockport,Castle Hill High School,324,0,324,324
Stockport,Heaton School,99,0,99,99
Tameside,Hollingworth Primary School,183,13,7,20
Tameside,Pinfold Primary School,396,58,6,64
Tameside,Arundale Primary School,198,30,3,33
Tameside,Gorse Hall Primary and Nursery School,424,51,7,58
Tameside,Stalyhill Junior School,231,30,4,34
Tameside,Arlies Primary School,208,45,5,50
Tameside,Lyndhurst Community Primary School,242,41,6,47
Tameside,Broadbent Fold Primary School and Nursery,224,25,3,28
Tameside,Millbrook Primary School,233,36,8,44
Tameside,The Heys Primary School,234,34,6,40
Tameside,Audenshaw Primary School,207,21,5,26
Tameside,Russell Scott Primary School,457,45,7,52
Tameside,Fairfield Road Primary School,455,76,10,86
Tameside,Livingstone Primary School,225,35,6,41
Tameside,Aldwyn Primary School,438,42,5,47
Tameside,St Anne's Primary School,213,26,4,30
Tameside,Corrie Primary School,338,77,20,97
Tameside,Holden Clough Community Primary School,375,44,3,47
Tameside,Greswell Primary School and Nursery,439,93,10,103
Tameside,Stalyhill Infant School,175,5,3,8
Tameside,Gee Cross Holy Trinity CofE  (VC) Primary School,217,33,4,37
Tameside,Broadbottom Church of England Primary School,82,10,1,11
Tameside,"St John's CofE Primary School, Dukinfield",333,17,5,22
Tameside,Hurst Knoll St James' Church of England Primary School,196,39,7,46
Tameside,Milton St John's CofE Primary School,246,37,2,39
Tameside,Micklehurst All Saints CofE Primary School,215,51,6,57
Tameside,Mottram CofE Primary School,137,24,2,26
Tameside,St Paul's Catholic Primary School,216,23,3,26
Tameside,St James Catholic Primary School,197,57,5,62
Tameside,St Mary's Catholic Primary School,206,31,8,39
Tameside,St Peter's Catholic Primary School,231,37,3,40
Tameside,St Raphael's Catholic Primary School,214,10,5,15
Tameside,Holy Trinity CofE Primary School,243,17,5,22
Tameside,St Peter's CofE Primary School,205,29,10,39
Tameside,St Stephen's CofE Primary School,206,30,10,40
Tameside,St Mary's CofE Primary School,228,14,5,19
Tameside,St George's CofE Primary School,140,31,1,32
Tameside,Canon Burrows CofE Primary School,445,84,5,89
Tameside,St Mary's RC Primary School,230,32,8,40
Tameside,St Stephen's RC Primary School,410,40,11,51
Tameside,St Joseph's RC Primary School,183,19,1,20
Tameside,"St John Fisher RC Primary School, Denton",241,38,20,58
Tameside,St Christopher's RC Primary School,251,16,2,18
Tameside,St Anne's RC Primary School,240,35,4,39
Tameside,Mossley Hollins High School,888,126,29,155
Tameside,Hyde High School,1153,74,28,102
Tameside,St Damian's RC Science College,837,95,14,109
Tameside,St Thomas More RC College,778,57,44,101
Tameside,Trinity School,114,14,1,15
Tameside,Thomas Ashton School,94,1,93,94
Tameside,Cromwell High School,134,2,132,134
Tameside,Oakdale School,146,0,146,146
Trafford,Navigation Primary School,446,60,6,66
Trafford,Oldfield Brow Primary School,390,47,8,55
Trafford,Stamford Park Primary School,483,33,7,40
Trafford,Heyes Lane Primary School,644,59,17,76
Trafford,Broadheath Primary School,578,82,17,99
Trafford,Broomwood Primary School,460,84,13,97
Trafford,Well Green Primary School,238,15,4,19
Trafford,Willows Primary School,367,42,10,52
Trafford,Cloverlea Primary School,235,31,3,34
Trafford,Springfield Primary School,678,73,13,86
Trafford,Woodheys Primary School,496,42,12,54
Trafford,Worthington Primary School,452,31,14,45
Trafford,Brooklands Primary School,661,8,9,17
Trafford,Firs Primary School,478,32,22,54
Trafford,Wellfield Junior School,262,38,18,56
Trafford,Moorlands Junior School,273,22,11,33
Trafford,Templemoor Infant and Nursery School,206,13,4,17
Trafford,Wellfield Infant and Nursery School,238,17,11,28
Trafford,Urmston Primary School,503,60,12,72
Trafford,Davyhulme Primary School,513,84,14,98
Trafford,Flixton Primary School,450,35,7,42
Trafford,Gorse Hill Primary School,373,74,11,85
Trafford,Kings Road Primary School,686,49,12,61
Trafford,Moss Park Junior School,254,36,5,41
Trafford,Moss Park Infant School,214,6,4,10
Trafford,Seymour Park Community Primary School,661,49,17,66
Trafford,Victoria Park Junior School,241,30,8,38
Trafford,Victoria Park Infant School,211,0,0,0
Trafford,Highfield Primary School,312,31,4,35
Trafford,Woodhouse Primary School,234,26,1,27
Trafford,Kingsway Primary School,180,24,7,31
Trafford,St Matthew's CofE Primary School,203,33,7,40
Trafford,Bowdon CofE Primary School,622,89,10,99
Trafford,St Hugh's Catholic Primary School,659,59,11,70
Trafford,Altrincham CofE (Aided) Primary School,213,23,0,23
Trafford,St Anne's CofE Primary School,234,39,6,45
Trafford,St Mary's CofE Primary School,277,41,4,45
Trafford,Holy Family Catholic Primary School,217,43,1,44
Trafford,Our Lady of Lourdes Catholic School,206,18,5,23
Trafford,All Saints' Catholic Primary School,236,43,5,48
Trafford,St Joseph's Catholic Primary School,451,38,8,46
Trafford,St Mary's CofE Primary School,194,31,12,43
Trafford,St Michael's CofE (Aided) Primary School,245,28,4,32
Trafford,English Martyrs' RC Primary School,232,29,4,33
Trafford,St Hugh of Lincoln RC Primary School,337,42,10,52
Trafford,St Teresa's RC Primary School,170,27,2,29
Trafford,St Monica's RC Primary School,334,56,5,61
Trafford,Our Lady of the Rosary RC Primary School,235,25,5,30
Trafford,St Margaret Ward Catholic Primary School,230,32,8,40
Trafford,St Alphonsus RC Primary School,199,20,5,25
Trafford,Lostock High School,422,48,56,104
Trafford,Stretford Grammar School,949,55,5,60
Trafford,Stretford High School,945,127,49,176
Trafford,Sale High School,1017,135,41,176
Trafford,Blessed Thomas Holford Catholic College,1585,213,61,274
Trafford,Bowdon Preparatory School for Girls,273,16,1,17
Trafford,Altrincham Preparatory School,299,26,0,26
Trafford,St Ambrose Prep School,120,0,0,0
Trafford,Forest Park Preparatory School,160,28,1,29
Trafford,Hale Preparatory School,204,15,0,15
Trafford,Forest School,208,21,1,22
Trafford,Abbotsford Preparatory School,196,11,0,11
Trafford,Loreto Preparatory School,116,24,1,25
Trafford,Brentwood School,137,0,137,137
Trafford,Delamere School,124,12,112,124
Wigan,Hindley Nursery School,86,14,0,14
Wigan,Douglas Valley Nursery School,88,17,0,17
Wigan,Beech Hill Community Primary School,305,95,10,105
Wigan,Woodfield Primary School,208,20,5,25
Wigan,Marsh Green Primary School,436,154,20,174
Wigan,Wigan Worsley Mesnes Community Primary School,236,42,7,49
Wigan,Mab's Cross Primary School,478,45,3,48
Wigan,Winstanley Community Primary School,455,42,5,47
Wigan,Orrell Newfold Community Primary School,468,40,6,46
Wigan,Abram Bryn Gates Primary School,0,0,0,0
Wigan,Hindley Junior and Infant School,205,26,5,31
Wigan,Britannia Bridge Primary School,240,92,3,95
Wigan,Leigh Central Primary School,204,38,11,49
Wigan,Lowton Junior and Infant School,212,10,5,15
Wigan,Newton Westpark Primary School,211,72,10,82
Wigan,R L Hughes Primary School,428,29,5,34
Wigan,Meadowbank Primary School & Children's Centre,223,83,15,98
Wigan,Parklee Community School,336,73,2,75
Wigan,Wood Fold Primary School,421,27,5,32
Wigan,Lowton West Primary School,425,68,8,76
Wigan,Shevington Vale Primary School,191,31,3,34
Wigan,Nicol Mere School,417,42,6,48
Wigan,Gilded Hollins Community School,208,19,2,21
Wigan,Garrett Hall Primary School,473,53,8,61
Wigan,Millbrook Primary School,205,11,2,13
Wigan,Bryn St Peter's CofE Primary School,210,28,6,34
Wigan,Hindsford CofE Primary School,198,25,10,35
Wigan,Chowbent Primary School,153,29,2,31
Wigan,St Mary's CofE Primary School,269,87,7,94
Wigan,"St Thomas' CofE Primary School, Leigh",395,71,11,82
Wigan,Wigan St Andrew's CofE Junior and Infant School,204,33,4,37
Wigan,St John's CofE Primary School,201,59,2,61
Wigan,St Mary and St John Catholic Primary School,210,19,2,21
Wigan,St Patrick's Catholic Primary School,349,44,5,49
Wigan,Sacred Heart Catholic Primary School,421,68,9,77
Wigan,"St Aidan's Catholic Primary School, Wigan",344,33,5,38
Wigan,St Catharine's CofE Primary School,208,29,6,35
Wigan,St Thomas CofE Primary School,200,20,3,23
Wigan,Standish Lower Ground St Anne's CofE Primary School,153,27,5,32
Wigan,Bickershaw CofE Primary School,151,25,2,27
Wigan,Hindley All Saints CofE Primary School,225,20,0,20
Wigan,Castle Hill St Philip's CofE Primary School,200,45,16,61
Wigan,Ince CofE Primary School,401,84,11,95
Wigan,"St Michael's CofE Primary School, Howe Bridge",203,20,7,27
Wigan,Westleigh St Paul's CofE Primary School,205,45,3,48
Wigan,St Stephen's CofE Primary School,210,29,0,29
Wigan,St John's CofE Primary School Mosley Common,184,14,1,15
Wigan,St Luke's CofE Primary School,217,31,2,33
Wigan,Lowton St Mary's CofE (Voluntary Aided) Primary School,244,35,6,41
Wigan,St Thomas CofE Junior and Infant School,214,21,5,26
Wigan,St Oswald's Catholic Primary School,294,55,8,63
Wigan,Our Lady Immaculate Catholic Primary School,5,0,2,2
Wigan,Our Lady's RC Primary School Wigan,210,33,2,35
Wigan,"Holy Family Catholic Primary School, New Springs, Wigan",135,12,1,13
Wigan,St James' Catholic Primary School Orrell,401,67,3,70
Wigan,St Marie's Catholic Primary School Standish,202,20,6,26
Wigan,St Benedict's Catholic Primary School Hindley,189,40,5,45
Wigan,St William's Catholic Primary School,219,46,4,50
Wigan,St Richard's Roman Catholic Primary School Atherton,158,36,1,37
Wigan,Sacred Heart RC Primary School,183,22,9,31
Wigan,St Joseph's Catholic Primary School Leigh,205,47,4,51
Wigan,Sacred Heart Catholic Primary School Leigh,305,26,6,32
Wigan,Twelve Apostles Catholic Primary School,210,32,7,39
Wigan,Holy Family Catholic Primary School,199,15,6,21
Wigan,"All Saints Catholic Primary School, Golborne, Wigan",247,47,10,57
Wigan,St Gabriel's Catholic Primary School,346,63,14,77
Wigan,"St Catherine's Catholic Primary School, Lowton",206,18,3,21
Wigan,St Bernadette's Catholic Primary School,182,18,3,21
Wigan,St Wilfrids Catholic Primary School,203,21,4,25
Wigan,St Ambrose Barlow Catholic Primary School,210,12,3,15
Wigan,"Christ Church CofE Primary School, Pennington",204,24,4,28
Wigan,"St Philip's CofE Primary School, Atherton",413,45,2,47
Wigan,Leigh St Mary's CofE Primary School,209,38,8,46
Wigan,Leigh St John's CofE Primary,210,36,3,39
Wigan,Aspull Church Primary School,211,20,6,26
Wigan,Cansfield High School,1040,126,30,156
Wigan,Bedford High School,1081,139,21,160
Wigan,Golborne High School,1117,146,25,171
Wigan,Shevington High School,841,95,17,112
Wigan,The Deanery Church of England High School and Sixth Form College,1432,171,30,201
Wigan,St John Fisher Catholic High School,999,169,24,193
Wigan,St Peter's Catholic High School,1036,105,32,137
Wigan,St Mary's Catholic High School,1561,126,18,144
Wigan,"St Edmund Arrowsmith Catholic High School, Ashton-in-Makerfield",1208,114,34,148
Wigan,Hope School,227,13,214,227
Barnsley,Burton Road Primary School,361,45,5,50
Barnsley,Shawlands Primary School,316,35,8,43
Barnsley,Barugh Green Primary School,306,26,6,32
Barnsley,Lacewood Primary School,275,54,8,62
Barnsley,Keresforth Primary School,232,34,4,38
Barnsley,Oxspring Primary School,135,12,4,16
Barnsley,Hoylandswaine Primary School,107,18,3,21
Barnsley,Millhouse Primary School,122,17,5,22
Barnsley,Springvale Primary School,244,19,3,22
Barnsley,Thurlstone Primary School,183,12,5,17
Barnsley,Silkstone Common Junior and Infant School,135,18,2,20
Barnsley,Jump Primary School,232,38,7,45
Barnsley,Birdwell Primary School,191,19,1,20
Barnsley,Greenfield Primary School,302,33,13,46
Barnsley,Silkstone Primary School,187,14,3,17
Barnsley,Gawber Primary School,213,13,8,21
Barnsley,Joseph Locke Primary School,424,40,9,49
Barnsley,Ladywood Primary School,234,40,5,45
Barnsley,Birkwood Primary School,382,38,8,46
Barnsley,Cherry Dale Primary School,315,47,8,55
Barnsley,Thurgoland Church of England (Voluntary Controlled) Primary School,213,21,5,26
Barnsley,Cawthorne Church of England Voluntary Controlled Primary School,163,18,2,20
Barnsley,Brierley Church of England Voluntary Controlled Primary School,209,25,2,27
Barnsley,Holy Rood Catholic Primary School,221,13,2,15
Barnsley,Tankersley St Peter's CofE (Aided) Primary School,211,24,4,28
Barnsley,The Ellis Church of England (Voluntary Aided) Primary School,232,33,8,41
Barnsley,St Helen's Catholic Primary School,118,21,2,23
Barnsley,St Michael and All Angels Catholic Primary School,137,14,2,16
Barnsley,Sacred Heart Catholic Primary School,168,13,5,18
Barnsley,Penistone Grammar School,1879,182,70,252
Doncaster,The Levett School,0,0,0,0
Doncaster,Adwick Primary School,419,91,3,94
Doncaster,Arksey Primary School,75,10,2,12
Doncaster,Toll Bar Primary School,192,47,9,56
Doncaster,Barnburgh Primary School,229,25,4,29
Doncaster,Rossington Tornedale Infant School,143,31,0,31
Doncaster,Scawsby Saltersgate Infant School,343,39,3,42
Doncaster,Scawsby Saltersgate Junior School,358,41,5,46
Doncaster,Sprotbrough Orchard Infant School,212,7,1,8
Doncaster,Wadworth Primary School,132,15,1,16
Doncaster,Stainforth Kirton Lane Primary School,225,42,2,44
Doncaster,Copley Junior School,206,24,2,26
Doncaster,Tickhill Estfeld Primary School,217,10,5,15
Doncaster,Windhill Primary School,318,42,7,49
Doncaster,Park Primary School,447,22,9,31
Doncaster,Town Field Primary School,464,30,14,44
Doncaster,Bawtry Mayflower Primary School,222,24,0,24
Doncaster,Hayfield Lane Primary School,437,43,10,53
Doncaster,Scawthorpe Sunnyfields Primary School,310,25,1,26
Doncaster,Thorne King Edward Primary School,395,47,5,52
Doncaster,Bentley New Village Primary School,292,55,6,61
Doncaster,Warmsworth Primary School,463,58,17,75
Doncaster,St Francis Xavier Catholic Primary School,228,23,1,24
Doncaster,Travis St Lawrence CofE Primary School,381,38,2,40
Doncaster,Branton St Wilfrid's Church of England Primary School,190,30,6,36
Doncaster,St Joseph and St Teresa's Catholic Primary School,154,19,5,24
Doncaster,Our Lady of Perpetual Help Catholic Primary School,140,15,3,18
Doncaster,"St Mary's Catholic Primary School, Edlington",162,17,3,20
Doncaster,Tickhill St Mary's Church of England Primary and Nursery School,226,13,5,18
Doncaster,Hill House School,780,78,1,79
Doncaster,Sycamore Hall Preparatory School,22,0,0,0
Doncaster,Doncaster School for the Deaf,38,0,38,38
Rotherham,Arnold Nursery School and Children's Centre,105,36,0,36
Rotherham,Rawmarsh Nursery School and Childrens Centre,138,35,0,35
Rotherham,Aughton Early Years Centre,137,16,0,16
Rotherham,Badsley Primary School,558,165,24,189
Rotherham,Blackburn Primary School,228,40,0,40
Rotherham,Broom Valley Community School,397,70,2,72
Rotherham,Kimberworth Community Primary School,236,37,2,39
Rotherham,Thornhill Primary School,325,33,6,39
Rotherham,Herringthorpe Infant School,295,48,3,51
Rotherham,Sitwell Infant School,217,28,3,31
Rotherham,Aston Fence Junior and Infant School,209,20,4,24
Rotherham,Swallownest Primary School,214,19,5,24
Rotherham,Bramley Sunnyside Junior School,329,30,14,44
Rotherham,Brinsworth Manor Infant School,235,29,4,33
Rotherham,Rawmarsh Rosehill Junior School,228,82,5,87
Rotherham,Rawmarsh Ryecroft Infant School,160,42,6,48
Rotherham,Wales Primary School,210,17,9,26
Rotherham,Bramley Sunnyside Infant School,279,30,4,34
Rotherham,Anston Park Junior School,220,29,3,32
Rotherham,Todwick Primary School,214,26,2,28
Rotherham,Rawmarsh Thorogate Junior and Infant School,214,39,7,46
Rotherham,Our Lady and St Joseph's Catholic Primary School,236,16,9,25
Rotherham,St Joseph's Catholic Primary School,194,23,6,29
Rotherham,Saint Pius X Catholic High School A Specialist School in Humanities,684,112,36,148
Barnsley,The Robert Ogden School,129,0,129,129
Rotherham,Newman School,156,4,152,156
Rotherham,The Willows School,175,0,175,175
Sheffield,Broomhall Nursery School,90,19,4,23
Sheffield,Grace Owen Nursery School,113,26,7,33
Sheffield,Abbey Lane Primary School,545,40,3,43
Sheffield,Brightside Nursery and Infant School,227,33,2,35
Sheffield,Carter Knowle Junior School,237,42,5,47
Sheffield,Gleadless Primary School,430,73,13,86
Sheffield,Hunter's Bar Junior School,360,28,7,35
Sheffield,Hunter's Bar Infant School,269,20,1,21
Sheffield,Intake Primary School,415,70,4,74
Sheffield,Lowfield Community Primary School,405,48,3,51
Sheffield,Lydgate Junior School,481,50,7,57
Sheffield,Lydgate Infant School,354,10,8,18
Sheffield,Marlcliffe Community Primary School,503,20,3,23
Sheffield,Ecclesfield Primary School,399,50,5,55
Sheffield,Meersbrook Bank Primary School,238,23,3,26
Sheffield,Nether Green Junior School,378,54,26,80
Sheffield,Mundella Primary School,415,23,1,24
Sheffield,Ecclesall Primary School,620,48,11,59
Sheffield,Holt House Infant School,179,37,2,39
Sheffield,Nether Green Infant School,224,24,8,32
Sheffield,Bradway Primary School,412,56,10,66
Sheffield,Dobcroft Junior School,384,56,13,69
Sheffield,Beighton Nursery Infant School,281,31,2,33
Sheffield,Halfway Nursery Infant School,198,13,4,17
Sheffield,Mosborough Primary School,420,35,5,40
Sheffield,Limpsfield Junior School,228,49,2,51
Sheffield,Netherthorpe Primary School,260,53,13,66
Sheffield,Halfway Junior School,205,30,4,34
Sheffield,Ballifield Primary School,443,46,5,51
Sheffield,Dobcroft Infant School,308,35,3,38
Sheffield,Grenoside Community Primary School,325,34,3,37
Sheffield,High Green Primary School,191,50,2,52
Sheffield,Stocksbridge Junior School,292,38,9,47
Sheffield,Royd Nursery and Infant School,201,25,1,26
Sheffield,Coit Primary School,207,25,2,27
Sheffield,Waterthorpe Infant School,166,32,8,40
Sheffield,Bankwood Community Primary School,454,142,9,151
Sheffield,Brunswick Community Primary School,462,81,5,86
Sheffield,Springfield Primary School,223,61,2,63
Sheffield,Reignhead Primary School,275,45,5,50
Sheffield,Rivelin Primary School,423,39,6,45
Sheffield,Athelstan Primary School,615,58,3,61
Sheffield,Angram Bank Primary School,216,53,5,58
Sheffield,Anns Grove Primary School,373,47,2,49
Sheffield,Carfield Primary School,612,64,12,76
Sheffield,Prince Edward Primary School,446,81,12,93
Sheffield,Shooter's Grove Primary School,408,47,4,51
Sheffield,Stradbroke Primary School,478,117,36,153
Sheffield,Walkley Primary School,423,26,3,29
Sheffield,Westways Primary School,614,78,6,84
Sheffield,Greystones Primary School,621,41,16,57
Sheffield,Shortbrook Primary School,102,26,1,27
Sheffield,Norton Free Church of England Primary School,215,23,1,24
Sheffield,Parson Cross Church of England Primary School,202,32,2,34
Sheffield,Deepcar St John's Church of England Junior School,176,31,2,33
Sheffield,King Edward VII School,1776,198,18,216
Sheffield,Clifford All Saints CofE Primary School,197,42,4,46
Sheffield,Broomhill Infant School,116,9,1,10
Sheffield,St Theresa's Catholic Primary School,234,51,2,53
Sheffield,Westbourne School,402,104,2,106
Sheffield,Birkdale School,793,131,1,132
Sheffield,Mylnhurst Preparatory School and Nursery,174,28,4,32
Sheffield,Sheffield High School,777,132,3,135
Sheffield,Bethany School,94,22,0,22
Sheffield,Bents Green School,302,0,302,302
Sheffield,The Rowan School,99,0,99,99
Sheffield,Archdale School,96,0,96,96
Sheffield,Talbot Specialist School,217,0,217,217
Sheffield,Woolley Wood School,103,0,103,103
Sheffield,Mossbrook School,161,0,161,161
Bradford,Strong Close Nursery School,78,30,9,39
Bradford,Hirst Wood Nursery School,78,8,5,13
Bradford,Lilycroft Nursery School,130,0,1,1
Bradford,Abbey Green Nursery School,89,30,9,39
Bradford,Midland Road Nursery School,90,16,9,25
Bradford,St Edmund's Nursery School & Children's Centre,267,19,8,27
Bradford,Frizinghall Primary School,417,70,6,76
Bradford,Lidget Green Primary School,578,77,14,91
Bradford,Newby Primary School,447,72,8,80
Bradford,Sandy Lane Primary School,344,43,3,46
Bradford,Swain House Primary School,504,54,27,81
Bradford,Thackley Primary School,469,61,7,68
Bradford,Blakehill Primary School,414,44,15,59
Bradford,Wellington Primary School,485,71,9,80
Bradford,Wibsey Primary School,684,91,8,99
Bradford,Stocks Lane Primary School,206,21,4,25
Bradford,Farfield Primary and Nursery School,446,49,7,56
Bradford,Carrwood Primary School,331,44,16,60
Bradford,Ley Top Primary School,424,59,4,63
Bradford,Cavendish Primary School,457,82,21,103
Bradford,Worthinghead Primary School,211,23,9,32
Bradford,Poplars Farm Primary School,396,47,9,56
Bradford,Bankfoot Primary School,271,27,6,33
Bradford,Fagley Primary School,271,25,24,49
Bradford,Brackenhill Primary School,438,56,6,62
Bradford,Crossflatts Primary School,466,58,26,84
Bradford,Eldwick Primary School,546,68,5,73
Bradford,Ingrow Primary School,402,110,10,120
Bradford,Long Lee Primary School,380,67,16,83
Bradford,Stanbury Village School,118,10,2,12
Bradford,Saltaire Primary School,417,29,17,46
Bradford,Low Ash Primary School,479,31,12,43
Bradford,Silsden Primary School,631,59,5,64
Bradford,Eastburn Junior and Infant School,209,23,2,25
Bradford,Steeton Primary School,290,30,3,33
Bradford,Ashlands Primary School,356,31,13,44
Bradford,Ben Rhydding Primary School,192,23,4,27
Bradford,Hoyle Court Primary School,300,51,12,63
Bradford,Addingham Primary School,188,19,3,22
Bradford,Sandal Primary School,457,42,6,48
Bradford,Girlington Primary School,490,100,42,142
Bradford,Menston Primary School,402,50,2,52
Bradford,St Matthew's CofE Primary School and Nursery,421,46,11,57
Bradford,St Luke's CofE Primary School,210,27,5,32
Bradford,Low Moor CofE Primary School,409,46,5,51
Bradford,All Saints' CofE Primary School,355,12,6,18
Bradford,Burley and Woodhead CofE Primary School,199,11,2,13
Bradford,St Paul's CofE Primary School,205,34,2,36
Bradford,Idle CofE Primary School,417,37,12,49
Bradford,Heaton St Barnabas' CofE Aided Primary School,412,69,6,75
Bradford,St Stephen's CofE Primary School,448,53,8,61
Bradford,St. Mary's & St. Peter's Catholic Primary School,220,21,3,24
Bradford,St Matthew's Catholic Primary School,230,43,4,47
Bradford,Trinity All Saints CofE VA Primary School,227,43,0,43
Bradford,Keighley St Andrew's CofE Primary School and Nursery,358,57,9,66
Bradford,Riddlesden St Mary's CofE Primary School,435,54,13,67
Bradford,Titus Salt School,1467,237,90,327
Bradford,Killinghall Primary School,734,207,15,222
Bradford,Foxhill Primary School,235,14,2,16
Bradford,Russell Hall Primary School,225,41,7,48
Bradford,Hill Top CofE Primary School,239,15,7,22
Bradford,Myrtle Park Primary,236,24,1,25
Bradford,Keelham Primary School,118,24,2,26
Bradford,Bingley Grammar School,1915,67,23,90
Bradford,Ghyll Royd School and Pre-School,110,1,1,2
Bradford,Moorfield School & Nursery,117,8,0,8
North Yorkshire,Westville House School,141,15,1,16
Bradford,Bradford Grammar School,1057,147,0,147
Bradford,Lady Lane Park School & Nursery,145,33,0,33
Bradford,Jaamiatul Imaam Muhammad Zakaria,425,0,0,0
Bradford,Bradford Christian School,147,15,25,40
Calderdale,Ferney Lee Primary School,211,33,9,42
Calderdale,Copley Primary School,288,29,8,37
Calderdale,Savile Park Primary School,379,54,18,72
Calderdale,Northowram Primary School,439,63,17,80
Calderdale,Parkinson Lane Community Primary School,590,86,10,96
Calderdale,Salterhebble Junior and Infant School,209,16,3,19
Calderdale,Warley Town School,137,21,1,22
Calderdale,"Ling Bob Junior, Infant and Nursery School",344,50,15,65
Calderdale,Bailiffe Bridge Junior and Infant School,198,21,3,24
Calderdale,Carr Green Primary School,338,13,11,24
Calderdale,Longroyde Primary School,415,56,5,61
Calderdale,Withinfields Primary School,346,70,11,81
Calderdale,Holywell Green Primary School,180,24,3,27
Calderdale,Central Street Infant and Nursery School,71,6,13,19
Calderdale,Stubbings Infant School,51,2,0,2
Calderdale,Heptonstall Junior Infant and Nursery School,66,3,0,3
Calderdale,Colden Junior and Infant School,88,14,5,19
Calderdale,Shelf Junior and Infant School,250,40,4,44
Calderdale,Ripponden Junior and Infant School,194,15,6,21
Calderdale,Midgley School,95,5,1,6
Calderdale,New Road Primary School,159,32,5,37
Calderdale,Tuel Lane Infant School,81,5,4,9
Calderdale,Castle Hill Primary School,188,22,3,25
Calderdale,"Cornholme Junior, Infant and Nursery School",170,30,8,38
Calderdale,Shade Primary School,202,20,4,24
Calderdale,Old Town Primary School,72,15,1,16
Calderdale,Cliffe Hill Community Primary School,192,32,22,54
Calderdale,Woodhouse Primary School,420,28,5,33
Calderdale,Riverside Junior School,143,21,6,27
Calderdale,Cross Lane Primary and Nursery School,334,37,12,49
Calderdale,Ash Green Community Primary School,487,151,25,176
Calderdale,Christ Church Pellon CofE VC Primary School,171,27,21,48
Calderdale,Norland CE School,75,12,2,14
Calderdale,St Mary's CofE (VC) J and I School,97,14,0,14
Calderdale,Triangle CofE VC Primary School,190,23,0,23
Calderdale,Luddenden CofE School,112,23,3,26
Calderdale,St Andrew's CofE (VA) Junior School,208,40,4,44
Calderdale,St Andrew's Church of England (VA) Infant School,167,27,6,33
Calderdale,"Elland Church of England (Voluntary Aided) Junior, Infant and Nursery School",177,30,9,39
Calderdale,Hebden Royd CofE VA Primary School,111,11,1,12
Calderdale,Barkisland CofE VA Primary School,193,23,0,23
Calderdale,"Christ Church CofE VA Junior School, Sowerby Bridge",105,13,3,16
Calderdale,"Todmorden CofE J, I & N School",254,29,5,34
Calderdale,The Calder Learning Trust,1353,255,39,294
Calderdale,Todmorden High School,887,125,29,154
Calderdale,All Saints' CofE Primary School,212,10,6,16
Calderdale,St Michael and All Angels CofE Primary & Pre School,188,16,1,17
Calderdale,The Gleddings School,199,41,0,41
Calderdale,Rishworth School,418,87,3,90
Calderdale,Hipperholme Grammar School,266,33,2,35
Calderdale,Ravenscliffe High School,244,0,244,244
Calderdale,William Henry Smith School,78,0,78,78
Calderdale,Wood Bank School,112,0,112,112
Calderdale,Highbury School,104,0,104,104
Kirklees,Flatts Nursery School,88,9,0,9
Kirklees,Berry Brow Infant and Nursery School,147,20,2,22
Kirklees,Carlton Junior and Infant School,215,27,4,31
Kirklees,Birkby Infant and Nursery School,490,98,9,107
Kirklees,Eastborough Junior Infant and Nursery School,228,41,2,43
Kirklees,Earlsheaton Infant School,107,9,0,9
Kirklees,Shaw Cross Infant and Nursery School,240,33,5,38
Kirklees,Westmoor Primary School,478,99,12,111
Kirklees,Paddock Junior Infant and Nursery School,390,35,6,41
Kirklees,Spring Grove Junior Infant and Nursery School,237,27,8,35
Kirklees,Netherhall Learning Campus Junior School,300,41,15,56
Kirklees,Reinwood  Community Junior School,358,39,9,48
Kirklees,Reinwood Infant and Nursery School,321,22,13,35
Kirklees,Crow Lane Primary and Foundation Stage School,198,34,10,44
Kirklees,Birkby Junior School,574,95,12,107
Kirklees,Ashbrow School,419,66,10,76
Kirklees,Newsome Junior School,212,28,5,33
Kirklees,Fixby Junior and Infant School,314,21,19,40
Kirklees,Mill Lane Primary School,162,47,6,53
Kirklees,Park Road Junior Infant and Nursery School,197,31,1,32
Kirklees,Purlwell Infant and Nursery School,235,44,1,45
Kirklees,Warwick Road Primary School,384,15,3,18
Kirklees,Clough Head Junior and Infant School,83,16,4,20
Kirklees,Marsden Infant and Nursery School,122,16,2,18
Kirklees,Scapegoat Hill Junior and Infant School,82,10,0,10
Kirklees,Nields Junior Infant and Nursery School,191,19,0,19
Kirklees,Wellhouse Junior and Infant School,77,18,7,25
Kirklees,Wilberlee Junior and Infant School,78,13,3,16
Kirklees,Emley First School,139,18,2,20
Kirklees,Holmfirth Junior Infant and Nursery School,196,31,4,35
Kirklees,"Hade Edge Junior, Infant  and  Nursery School",91,11,2,13
Kirklees,Hepworth Junior and Infant School,117,9,2,11
Kirklees,Hinchliffe Mill Junior and Infant School,75,13,3,16
Kirklees,Holme Junior and Infant School,33,1,0,1
Kirklees,Netherthong Primary School,220,18,2,20
Kirklees,Scholes (Holmfirth) J & I School,187,33,4,37
Kirklees,Shepley First School,163,16,2,18
Kirklees,Grange Moor Primary School,88,16,2,18
Kirklees,Hopton Primary School,340,37,8,45
Kirklees,Gomersal Primary School,409,52,1,53
Kirklees,Hartshead Junior and Infant School,83,10,4,14
Kirklees,Hightown Junior Infant & Nursery School,214,17,7,24
Kirklees,Littletown Junior Infant and Nursery School,183,52,13,65
Kirklees,Howard Park Community School,237,21,9,30
Kirklees,Scholes Village Primary School,244,28,4,32
Kirklees,Rowley Lane Junior Infant and Nursery School,448,44,17,61
Kirklees,Lydgate Junior and Infant School,276,29,3,32
Kirklees,Upperthong Junior and Infant School,207,18,7,25
Kirklees,Hyrstmount Junior School,280,36,6,42
Kirklees,High Bank Junior Infant and Nursery School,133,49,6,55
Kirklees,Norristhorpe Junior and Infant School,414,56,9,65
Kirklees,Denby Dale First and Nursery School,101,18,0,18
Kirklees,Pentland Infant and Nursery School,151,25,4,29
Kirklees,Moldgreen Community Primary School,391,52,10,62
Kirklees,Linthwaite Clough J I & Early Years Unit,283,23,7,30
Kirklees,Golcar Junior Infant and Nursery School,402,52,3,55
Kirklees,Crossley Fields Junior and Infant School,551,67,17,84
Kirklees,Lowerhouses CofE (Voluntary Controlled) Junior Infant and Early Years School,213,26,14,40
Kirklees,Ravensthorpe Church of England Voluntary Controlled Junior School,417,146,5,151
Kirklees,Netherhall St James CofE (VC) Infant and Nursery School,215,28,10,38
Kirklees,St John's Church of England Voluntary Controlled Primary School,168,13,11,24
Kirklees,Savile Town Church of England Voluntary Controlled Infant and Nursery School,101,22,1,23
Kirklees,Thornhill Lees Church of England Voluntary Controlled Infant and Nursery School,298,38,5,43
Kirklees,Bywell Church of England Voluntary Controlled Junior School,388,54,7,61
Kirklees,Headfield Church of England Voluntary Controlled Junior School,561,99,17,116
Kirklees,Hanging Heaton Church of England Voluntary Controlled Junior and Infant School,134,10,2,12
Kirklees,Staincliffe Church of England Voluntary Controlled Junior School,342,83,4,87
Kirklees,Slaithwaite Church of England Voluntary Controlled Junior and Infant School,166,19,7,26
Kirklees,Brockholes Church of England Voluntary Controlled Junior and Infant School,210,13,4,17
Kirklees,Flockton CofE (C) First School,80,10,0,10
Kirklees,Highburton Church of England Voluntary Controlled First School,176,4,3,7
Kirklees,Thurstonland Endowed Voluntary Controlled First School,65,7,1,8
Kirklees,Meltham CofE (VC) Primary School,416,43,6,49
Kirklees,East Bierley Church of England Voluntary Controlled Primary School,202,29,4,33
Kirklees,Roberttown Church of England Voluntary Controlled Junior and Infant School,238,8,6,14
Kirklees,Farnley Tyas Church of England Voluntary Controlled First School,57,10,0,10
Kirklees,"Headlands Church of England Voluntary Controlled Junior, Infant and Nursery School",416,87,6,93
Kirklees,Crowlees Church of England Voluntary Controlled Junior and Infant School,417,25,4,29
Kirklees,All Hallows' CofE (VA) Primary School,197,37,3,40
Kirklees,Battyeford CofE (VC) Primary School,448,58,9,67
Kirklees,Birkenshaw Church of England Voluntary Controlled Primary School,454,63,5,68
Kirklees,South Crosland Church of England Voluntary Aided Junior School,218,27,0,27
Kirklees,Batley Parish Church of England Voluntary Aided Junior Infant and Nursery School,198,37,1,38
Kirklees,"St Peter's Church of England Voluntary Aided Junior, Infant and Early Years School",225,69,6,75
Kirklees,St John's Church of England Voluntary Aided Junior and Infant School,200,18,8,26
Kirklees,Linthwaite Ardron CofE (Voluntary Aided) Junior and Infant School,188,51,5,56
Kirklees,Cumberworth Church of England Voluntary Aided First School,122,8,2,10
Kirklees,Denby Church of England Voluntary Aided First School,57,8,1,9
Kirklees,Kirkburton Church of England Voluntary Aided First School,129,24,2,26
Kirklees,Gomersal St Mary's Church of England Voluntary Controlled Primary School,180,39,4,43
Kirklees,Netherhall Learning Campus High School,810,139,37,176
Kirklees,Holmfirth High School,1314,128,20,148
Kirklees,Westborough High School,930,152,21,173
Kirklees,Spen Valley High School,953,151,26,177
Kirklees,All Saints Catholic College,898,101,34,135
Kirklees,Huddersfield Grammar School,550,45,5,50
Kirklees,The Mount School,114,4,1,5
Kirklees,Madni Academy,209,13,0,13
Kirklees,The Branch Christian School,24,0,0,0
Kirklees,Hollybank School,39,6,33,39
Kirklees,Woodley School and College,138,0,138,138
Kirklees,Ravenshall School,206,0,206,206
Kirklees,Southgate School,170,0,170,170
Kirklees,Fairfield School,119,0,119,119
Leeds,Guiseley Primary School,441,48,1,49
Leeds,Rawdon Littlemoor Primary School,311,55,9,64
Leeds,Scholes (Elmet) Primary School,350,26,1,27
Leeds,Horsforth Featherbank Primary School,212,29,2,31
Leeds,Churwell Primary School,461,33,2,35
Leeds,Seven Hills Primary School,464,74,1,75
Leeds,Westroyd Primary School and Nursery,228,48,3,51
Leeds,Greenside Primary School,302,51,7,58
Leeds,Carlton Primary School,344,36,5,41
Leeds,Robin Hood Primary School,458,91,8,99
Leeds,Thorpe Primary School,241,56,6,62
Leeds,Woodlesford Primary School,435,49,1,50
Leeds,Yeadon Westfield Junior School,205,56,1,57
Leeds,Oulton Primary School,321,46,6,52
Leeds,Bramham Primary School,193,18,3,21
Leeds,Pudsey Bolton Royd Primary School,468,96,7,103
Leeds,West End Primary School,262,43,0,43
Leeds,Southroyd Primary and Nursery School,446,48,1,49
Leeds,Gildersome Primary School,374,67,1,68
Leeds,Farsley Springbank Primary School,417,51,1,52
Leeds,Victoria Junior School,163,51,3,54
Leeds,Crossley Street Primary School,235,19,3,22
Leeds,Tranmere Park Primary School,317,37,3,40
Leeds,Queensway Primary School,119,35,0,35
Leeds,Yeadon Westfield Infant School,185,26,0,26
Leeds,Horsforth Newlaithes Primary School,419,69,4,73
Leeds,Westbrook Lane Primary School,209,38,1,39
Leeds,Lowtown Primary School,208,24,1,25
Leeds,Birchfield Primary School,238,28,0,28
Leeds,Morley Victoria Primary School,467,57,3,60
Leeds,Bardsey Primary School,192,14,0,14
Leeds,Primrose Lane Primary School,221,35,3,38
Leeds,Wigton Moor Primary School,419,33,2,35
Leeds,Ninelands Primary School,454,59,1,60
Leeds,Broadgate Primary School,455,78,5,83
Leeds,Deighton Gates Primary School,210,27,0,27
Leeds,Ashfield Primary School,231,36,3,39
Leeds,Westgate Primary School,243,25,3,28
Leeds,Otley the Whartons Primary School,194,28,2,30
Leeds,Beecroft Primary School,329,54,3,57
Leeds,Blenheim Primary School,474,54,5,59
Leeds,Brudenell Primary School,265,42,2,44
Leeds,Iveson Primary School,393,54,9,63
Leeds,Kirkstall Valley Primary School,223,52,3,55
Leeds,Little London Community Primary School,395,101,3,104
Leeds,Quarry Mount Primary School,200,29,0,29
Leeds,Spring Bank Primary School,189,26,0,26
Leeds,Rosebank Primary School,364,33,1,34
Leeds,Adel Primary School,234,34,1,35
Leeds,Hawksworth Wood Primary School,332,76,3,79
Leeds,Cookridge Primary School,312,39,2,41
Leeds,Ireland Wood Primary School,417,64,22,86
Leeds,Weetwood Primary School,258,34,3,37
Leeds,Bankside Primary School,689,350,3,353
Leeds,Chapel Allerton Primary School,488,72,4,76
Leeds,Gledhow Primary School,671,79,8,87
Leeds,Talbot Primary School,499,39,5,44
Leeds,Bracken Edge Primary School,419,71,4,75
Leeds,Kerr Mackie Primary School,455,57,1,58
Leeds,Alwoodley Primary School,484,62,5,67
Leeds,Manor Wood Primary School,500,91,5,96
Leeds,Highfield Primary School,417,41,4,45
Leeds,Moor Allerton Hall Primary School,613,87,13,100
Leeds,Moortown Primary School,211,17,1,18
Leeds,Shadwell Primary School,206,22,1,23
Leeds,Beechwood Primary School,473,122,2,124
Leeds,Grange Farm Primary School,456,104,0,104
Leeds,Grimes Dyke Primary School,242,44,6,50
Leeds,Harehills Primary School,700,136,2,138
Leeds,Hovingham Primary School,726,101,4,105
Leeds,Seacroft Grange Primary School,210,51,0,51
Leeds,White Laith Primary School,234,33,0,33
Leeds,Wykebeck Primary School,378,86,2,88
Leeds,Cross Gates Primary School,256,68,2,70
Leeds,Shakespeare Primary School,731,153,1,154
Leeds,Manston Primary,208,55,1,56
Leeds,Parklands Primary School,389,105,22,127
Leeds,Swarcliffe Primary School,327,60,2,62
Leeds,Fieldhead Carr Primary School,362,66,2,68
Leeds,Beeston Primary School,677,111,2,113
Leeds,Windmill Primary School,418,79,13,92
Leeds,Greenmount Primary School,465,55,2,57
Leeds,Hunslet Carr Primary School,398,61,3,64
Leeds,Hunslet Moor Primary School,469,88,4,92
Leeds,Ingram Road Primary School,349,45,4,49
Leeds,Westwood Primary School,316,77,2,79
Leeds,Low Road Primary School,202,32,0,32
Leeds,Clapgate Primary School,447,98,0,98
Leeds,Hugh Gaitskell Primary School,583,207,5,212
Leeds,Castleton Primary School,510,96,1,97
Leeds,Cobden Primary School,233,67,0,67
Leeds,Park Spring Primary School,433,84,4,88
Leeds,Stanningley Primary School,232,43,2,45
Leeds,Summerfield Primary School,217,30,0,30
Leeds,Five Lanes Primary School,466,52,2,54
Leeds,Whingate Primary School,458,96,1,97
Leeds,Whitecote Primary School,467,147,5,152
Leeds,Lower Wortley Primary School,327,33,3,36
Leeds,Lawns Park Primary School,241,44,0,44
Leeds,Greenhill Primary School,418,80,1,81
Leeds,Swinnow Primary School,251,41,3,44
Leeds,Farsley Farfield Primary School,451,64,7,71
Leeds,Rothwell Primary School,306,42,2,44
Leeds,Sharp Lane Primary School,626,110,8,118
Leeds,Aberford Church of England Voluntary Controlled Primary School,107,18,0,18
Leeds,Rawdon St Peter's Church of England Voluntary Controlled Primary School,319,32,3,35
Leeds,Barwick-in-Elmet Church of England Voluntary Controlled Primary School,221,39,2,41
Leeds,Harewood Church of England Voluntary Controlled Primary School,101,9,1,10
Leeds,St Margaret's Church of England Voluntary Controlled Primary School,424,70,11,81
Leeds,St James' Church of England Voluntary Controlled Primary School,132,22,0,22
Leeds,Calverley Church of England Voluntary Aided Primary School,417,36,4,40
Leeds,St Mary's Church of England Controlled Primary School Boston Spa,139,22,0,22
Leeds,Pool-in-Wharfedale Church of England Voluntary Controlled Primary School,195,24,1,25
Leeds,Burley St Matthias Church of England Voluntary Controlled Primary School,188,36,4,40
Leeds,Middleton St Mary's Church of England Voluntary Controlled Primary School,406,83,2,85
Leeds,Bramley St Peter's Church of England Primary School,399,103,4,107
Leeds,St Bartholomew's CofE Voluntary Controlled Primary School,562,98,3,101
Leeds,Roundhay St John's Church of England Primary School,243,22,2,24
Leeds,St. Oswald's CofE Primary School,395,47,6,53
Leeds,Hawksworth Church of England Primary School,105,8,1,9
Leeds,"Lady Elizabeth Hastings' CofE VA Primary School, Thorp Arch",115,11,2,13
Leeds,Collingham Lady Elizabeth Hastings Church of England Voluntary Aided Primary School,208,32,0,32
Leeds,"St Edward's Catholic Primary School, Boston Spa",174,25,0,25
Leeds,"St Francis Catholic Primary School, Morley",238,37,0,37
Leeds,Rothwell St Mary's RC Primary School,210,46,0,46
Leeds,"St Joseph's Catholic Primary School, Wetherby",230,30,0,30
Leeds,"St Anthony's Catholic Primary School, Beeston",212,47,0,47
Leeds,Corpus Christi Catholic Primary School,268,57,3,60
Leeds,Holy Family Catholic Primary School,218,41,2,43
Leeds,"St Joseph's Catholic Primary School, Hunslet",201,49,0,49
Leeds,St Nicholas Catholic Primary School,314,39,4,43
Leeds,Our Lady of Good Counsel Catholic Primary School,228,43,0,43
Leeds,St Philip's Catholic Primary  School,246,44,1,45
Leeds,St Patrick Catholic Primary School,208,52,1,53
Leeds,St Theresa's Catholic Primary School,483,81,2,83
Leeds,Adel St John the Baptist Church of England Primary School,207,23,1,24
Leeds,Cookridge Holy Trinity Church of England Primary School,414,41,3,44
Leeds,Kirkstall St Stephen's Church of England (VA) Primary School,201,36,2,38
Leeds,Meanwood Church of England Primary School,213,36,2,38
Leeds,St Matthew's Church of England Aided Primary School,400,55,3,58
Leeds,All Saint's Richmond Hill Church of England Primary School,253,40,1,41
Leeds,"St Peter's Church of England Primary School, Leeds",260,46,3,49
Leeds,Whinmoor St Paul's Church of England Primary School,236,31,1,32
Leeds,Beeston Hill St Luke's Church of England Primary School,466,54,18,72
Leeds,Brodetsky Primary School,250,28,0,28
Leeds,Lawnswood School,1464,147,9,156
Leeds,Allerton High School,1600,163,30,193
Leeds,Allerton Grange School,1711,202,29,231
Leeds,Carr Manor Community School,1477,327,40,367
Leeds,Ralph Thoresby School,1042,164,15,179
Leeds,Roundhay School,2522,180,51,231
Leeds,Pudsey Grammar School,1338,181,9,190
Leeds,Benton Park School,1544,140,16,156
Leeds,Guiseley School,1396,196,12,208
Leeds,Wetherby High School,704,123,4,127
Leeds,Cardinal Heenan Catholic High School,917,92,8,100
Leeds,Mount St Mary's Catholic High School,943,133,1,134
Leeds,Lady Elizabeth Hastings CofE Primary School,130,11,2,13
Leeds,Moorlands School,151,14,1,15
Leeds,Richmond House School,230,23,0,23
Leeds,Gateways School,512,128,1,129
Leeds,The Froebelian School,153,29,1,30
Leeds,Queenswood School,20,0,0,0
Leeds,Leeds Menorah School,15,4,0,4
Leeds,The Grammar School At Leeds,2095,415,0,415
Leeds,Woodhouse Grove School,1072,7,6,13
Leeds,Fulneck School,314,52,15,67
Leeds,John Jamieson School,425,10,415,425
Leeds,"St John's Catholic Specialist School, Boston Spa",56,3,53,56
Leeds,Broomfield South SILC,224,0,224,224
Leeds,West Oaks School,410,1,409,410
Wakefield,Harewood Centre Nursery School,69,0,4,4
Wakefield,Crigglestone Nursery School,96,9,0,9
Wakefield,The Springfield Centre,71,26,8,34
Wakefield,Crofton Junior School,228,31,13,44
Wakefield,Martin Frobisher Infant School,158,11,10,21
Wakefield,Ossett Flushdyke Junior and Infant School,110,13,3,16
Wakefield,Sitlington Netherton Junior and Infant School,189,8,8,16
Wakefield,Stanley Grove Primary and Nursery School,237,27,2,29
Wakefield,Newton Hill Community School,277,22,5,27
Wakefield,West Bretton Junior and Infant School,113,13,2,15
Wakefield,Dimple Well Infant School and Nursery,211,23,7,30
Wakefield,"Streethouse, Junior, Infant and Nursery",122,36,7,43
Wakefield,Featherstone Purston Infant School,206,25,8,33
Wakefield,Featherstone North Featherstone Junior and Infant School,341,108,9,117
Wakefield,Normanton Altofts Junior School,332,39,13,52
Wakefield,Wakefield Pinders Primary (JIN) School,356,46,13,59
Wakefield,Crigglestone Mackie Hill Junior and Infant School,207,45,13,58
Wakefield,Crigglestone Dane Royd Junior and Infant School,354,51,16,67
Wakefield,The Mount Junior Infant & Nursery School,224,26,3,29
Wakefield,Wakefield Flanshaw Junior and Infant School,408,72,16,88
Wakefield,Hendal Primary School,416,74,15,89
Wakefield,Castleford Townville Infants' School,140,24,4,28
Wakefield,Castleford Wheldon Infant School and Nursery,175,38,7,45
Wakefield,Ossett Southdale Church of England Voluntary Controlled Junior School,338,53,6,59
Wakefield,Stanley St Peters Church of England Voluntary Controlled Primary School,285,67,1,68
Wakefield,Featherstone Purston St Thomas Church of England Voluntary Controlled Junior School,356,67,6,73
Wakefield,"Methodist Voluntary Controlled Junior, Infant and Nursery School: With Communication Resource",240,25,17,42
Wakefield,Alverthorpe St Paul's CofE (VA) School 3-11yrs,282,32,2,34
Wakefield,Wakefield St Johns Church of England Voluntary Aided Junior and Infant School,206,20,10,30
Wakefield,Normanton All Saints CofE Infant School,316,26,7,33
Wakefield,Ossett Holy Trinity CofE VA Primary School,360,22,8,30
Wakefield,Wakefield St Marys Church of England Voluntary Aided Primary School,257,15,10,25
Wakefield,Sandal Castle VA Community Primary School,618,159,17,176
Wakefield,Kettlethorpe High School,1646,303,29,332
Wakefield,Ackworth School,494,72,21,93
Wakefield,Silcoates School,520,106,4,110
Wakefield,Wakefield Girls' High School,777,130,1,131
Wakefield,Queen Elizabeth Grammar School,881,135,0,135
Wakefield,Wakefield independent sch,148,16,0,16
Wakefield,Highfield School,191,0,191,191
Gateshead,Bensham Grove Nursery School,59,8,2,10
Gateshead,Carr Hill Community Primary School,328,85,10,95
Gateshead,Kelvin Grove Community Primary School,378,26,11,37
Gateshead,South Street Community Primary School,221,45,6,51
Gateshead,Bede Community Primary School,198,23,14,37
Gateshead,Oakfield Junior School,240,45,5,50
Gateshead,Larkspur Community Primary School,126,52,3,55
Gateshead,Oakfield Infant School,167,21,2,23
Gateshead,Ravensworth Terrace Primary School,363,54,3,57
Gateshead,Portobello Primary School,195,28,2,30
Gateshead,Birtley East Community Primary School,207,41,6,47
Gateshead,Dunston Hill Community Primary School,415,57,6,63
Gateshead,Emmaville Primary School,489,66,12,78
Gateshead,High Spen Primary School,199,18,7,25
Gateshead,Swalwell Primary School,130,19,20,39
Gateshead,Winlaton West Lane Community Primary School,361,29,7,36
Gateshead,Greenside Primary School,180,29,0,29
Gateshead,Blaydon West Primary School,190,18,1,19
Gateshead,Front Street Community Primary School,408,44,9,53
Gateshead,Highfield Community Primary School,123,24,3,27
Gateshead,Ryton Community Infant School,130,28,2,30
Gateshead,Ryton Junior School,129,20,1,21
Gateshead,Washingwell Community Primary School,174,34,4,38
Gateshead,Bill Quay Primary School,210,25,3,28
Gateshead,Falla Park Community Primary School,204,64,6,70
Gateshead,Brandling Primary School,236,18,3,21
Gateshead,Lingey House Primary School,462,120,8,128
Gateshead,The Drive Community Primary School,170,25,1,26
Gateshead,White Mere Community Primary School,153,28,3,31
Gateshead,Clover Hill Community Primary School,206,30,2,32
Gateshead,Crookhill Community Primary School,181,18,4,22
Gateshead,Brighton Avenue Primary School,352,78,9,87
Gateshead,Lobley Hill Primary School,368,63,18,81
Gateshead,Wardley Primary School,259,59,6,65
Gateshead,Glynwood Community Primary School,442,62,4,66
Gateshead,Barley Mow Primary School,170,22,1,23
Gateshead,Windy Nook Primary School,323,60,4,64
Gateshead,Colegate Community Primary School,152,28,4,32
Gateshead,Roman Road Primary School,230,56,1,57
Gateshead,Fellside Community Primary School,236,22,1,23
Gateshead,Fell Dyke Community Primary School,283,37,5,42
Gateshead,Caedmon Community Primary School,255,43,11,54
Gateshead,Whickham Parochial Church of England Primary School,207,38,1,39
Gateshead,"St Joseph's Roman Catholic Voluntary Aided Primary School, Highfield",101,23,1,24
Gateshead,Kingsmeadow Community Comprehensive School,939,157,22,179
Gateshead,Gateshead Jewish Boarding School,119,0,4,4
Gateshead,Gateshead Jewish Primary School,209,15,5,20
Gateshead,Gateshead Jewish Nursery School,114,3,2,5
Gateshead,Emmanuel College,1444,148,10,158
Gateshead,Furrowfield School,71,0,71,71
Newcastle upon Tyne,Ashfield Nursery School,102,19,0,19
Newcastle upon Tyne,Newburn Manor Nursery School,74,11,0,11
Newcastle upon Tyne,Monkchester Road Nursery School,147,35,0,35
Newcastle upon Tyne,Dinnington First School,272,24,3,27
Newcastle upon Tyne,Archibald First School,337,24,7,31
Newcastle upon Tyne,South Gosforth First School,296,21,4,25
Newcastle upon Tyne,Regent Farm First School,333,52,11,63
Newcastle upon Tyne,Gosforth Park First School,259,12,1,13
Newcastle upon Tyne,Havannah First School,268,19,1,20
Newcastle upon Tyne,Grange First School,332,59,12,71
Newcastle upon Tyne,Throckley Primary School,349,39,3,42
Newcastle upon Tyne,Newburn Manor Primary School,202,29,4,33
Newcastle upon Tyne,West Denton Primary School,312,88,3,91
Newcastle upon Tyne,Knop Law Primary School,406,33,0,33
Newcastle upon Tyne,Milecastle Primary School,202,28,1,29
Newcastle upon Tyne,Waverley Primary School,208,61,1,62
Newcastle upon Tyne,Simonside Primary School,281,57,9,66
Newcastle upon Tyne,Lemington Riverside Primary School,171,69,6,75
Newcastle upon Tyne,Westerhope Primary School,401,40,10,50
Newcastle upon Tyne,Byker Primary School,455,100,17,117
Newcastle upon Tyne,Benton Park Primary School,459,54,17,71
Newcastle upon Tyne,Hawthorn Primary School,208,28,7,35
Newcastle upon Tyne,Canning Street Primary School,470,87,12,99
Newcastle upon Tyne,Chillingham Road Primary School,254,29,8,37
Newcastle upon Tyne,Cragside Primary School,410,29,7,36
Newcastle upon Tyne,Bridgewater Primary School,478,151,22,173
Newcastle upon Tyne,Broadwood Primary School,207,42,14,56
Newcastle upon Tyne,Ravenswood Primary School,633,63,13,76
Newcastle upon Tyne,St Johns Primary School,227,77,6,83
Newcastle upon Tyne,Wingrove Primary School,469,84,10,94
Newcastle upon Tyne,Hotspur Primary School,437,58,4,62
Newcastle upon Tyne,Moorside Primary School,447,47,14,61
Newcastle upon Tyne,Christ Church CofE Primary School,129,19,5,24
Newcastle upon Tyne,Archbishop Runcie CofE First School,176,17,6,23
Newcastle upon Tyne,St Paul's CofE Primary School,266,36,9,45
Newcastle upon Tyne,Gosforth Central Middle School,572,68,20,88
Newcastle upon Tyne,Gosforth East Middle School,512,52,9,61
Newcastle upon Tyne,Newcastle High School for Girls,660,68,0,68
Newcastle upon Tyne,Newcastle Preparatory School,289,52,0,52
Newcastle upon Tyne,Westfield School,195,26,4,30
Newcastle upon Tyne,Newcastle School for Boys,373,67,3,70
Newcastle upon Tyne,Dame Allan's Senior School,940,98,0,98
Newcastle upon Tyne,Royal Grammar School,1346,130,2,132
Newcastle upon Tyne,Northern Counties School,86,3,83,86
North Tyneside,Sir James Knott Memorial Nursery School,82,4,1,5
North Tyneside,Moorbridge,167,97,68,165
North Tyneside,Cullercoats Primary School,432,20,2,22
North Tyneside,Waterville Primary School,200,58,17,75
North Tyneside,Percy Main Primary School,214,64,20,84
North Tyneside,King Edward Primary School,484,54,6,60
North Tyneside,Spring Gardens Primary School,363,78,5,83
North Tyneside,Riverside Primary School,160,38,2,40
North Tyneside,Monkhouse Primary School,232,32,7,39
North Tyneside,Whitehouse Primary School,183,42,17,59
North Tyneside,Preston Grange Primary School,226,17,2,19
North Tyneside,Shiremoor Primary School,406,73,3,76
North Tyneside,Backworth Park Primary School,302,33,3,36
North Tyneside,Holystone Primary School,467,49,19,68
North Tyneside,Westmoor Primary School,351,17,8,25
North Tyneside,Rockcliffe First School,272,27,4,31
North Tyneside,Appletree Gardens First School,357,38,7,45
North Tyneside,Southridge First School,350,30,2,32
North Tyneside,Amberley Primary School,406,43,6,49
North Tyneside,Bailey Green Primary School,452,34,4,38
North Tyneside,South Wellfield First School,335,39,4,43
North Tyneside,Marine Park First School,503,26,1,27
North Tyneside,Coquet Park First School,179,13,3,16
North Tyneside,Langley First School,329,21,8,29
North Tyneside,Carville Primary School,206,40,1,41
North Tyneside,Wallsend Jubilee Primary School,370,23,9,32
North Tyneside,Battle Hill Primary School,295,77,3,80
North Tyneside,Richardson Dees Primary School,227,52,4,56
North Tyneside,Stephenson Memorial Primary School,379,76,10,86
North Tyneside,Redesdale Primary School,319,42,6,48
North Tyneside,Whitley Lodge First School,278,10,7,17
North Tyneside,Collingwood Primary School,335,52,5,57
North Tyneside,Balliol Primary School,164,38,5,43
North Tyneside,Benton Dene Primary School,472,139,20,159
North Tyneside,Forest Hall Primary School,161,27,2,29
North Tyneside,Ivy Road Primary School,187,23,3,26
North Tyneside,New York Primary School,393,71,6,77
North Tyneside,Denbigh Community Primary School,458,89,13,102
North Tyneside,Greenfields Community Primary School,235,29,10,39
North Tyneside,Hazlewood Community Primary School,298,38,8,46
North Tyneside,Fordley Primary School,342,62,9,71
North Tyneside,Burradon Community Primary School,178,36,10,46
North Tyneside,Christ Church CofE Primary School,189,39,2,41
North Tyneside,St Bartholomew's Church of England Primary School (Aided),212,29,6,35
North Tyneside,Wallsend St Peter's CofE Aided Primary School,140,27,6,33
North Tyneside,Marden High School,910,105,13,118
North Tyneside,Norham High School,364,72,47,119
North Tyneside,Marden Bridge Middle School,597,65,16,81
North Tyneside,Valley Gardens Middle School,772,64,19,83
North Tyneside,Monkseaton Middle School,230,41,4,45
North Tyneside,Whitley Bay High School,1695,133,28,161
North Tyneside,George Stephenson High School,1214,96,21,117
North Tyneside,Burnside College,1011,83,19,102
North Tyneside,Churchill Community College,1046,165,8,173
North Tyneside,Monkseaton  High School,490,70,9,79
North Tyneside,John Spence Community High School,846,97,39,136
North Tyneside,Longbenton High School,906,190,30,220
North Tyneside,Wellfield Middle School,354,40,7,47
Newcastle upon Tyne,Dame Allan's Junior School,313,22,0,22
North Tyneside,Woodlawn School,155,3,152,155
North Tyneside,Southlands School,169,0,169,169
North Tyneside,Benton Dene School,121,0,121,121
North Tyneside,Percy Hedley School,157,2,155,157
South Tyneside,Clervaux Nursery School,66,6,0,6
South Tyneside,Helen Gibson Nursery School,79,4,1,5
South Tyneside,Boldon Nursery School,71,6,0,6
South Tyneside,Alternative Education Service - The Beacon Centre,63,59,4,63
South Tyneside,Hadrian Primary School,281,33,4,37
South Tyneside,Laygate Community School,250,43,5,48
South Tyneside,Mortimer Primary School,613,101,5,106
South Tyneside,Marine Park Primary School,183,52,2,54
South Tyneside,Stanhope Primary School,246,65,3,68
South Tyneside,Biddick Hall Junior School,205,47,11,58
South Tyneside,Biddick Hall Infants' School,238,48,9,57
South Tyneside,Hedworth Lane Primary School,301,47,1,48
South Tyneside,Marsden Primary School,230,42,4,46
South Tyneside,East Boldon Infants' School,178,22,5,27
South Tyneside,East Boldon Junior School,234,25,4,29
South Tyneside,Bede Burn Primary School,206,25,2,27
South Tyneside,Valley View Primary School,247,50,5,55
South Tyneside,Dunn Street Primary School,133,24,3,27
South Tyneside,Simonside Primary School,265,60,4,64
South Tyneside,Hedworthfield Primary School,202,48,9,57
South Tyneside,Lord Blyton Primary School,251,39,11,50
South Tyneside,West Boldon Primary School,252,60,12,72
South Tyneside,Toner Avenue Primary School,440,82,7,89
South Tyneside,Fellgate Primary School,165,36,54,90
South Tyneside,St Oswald's CofE Aided Primary School,205,36,3,39
South Tyneside,Mortimer Community College,1074,221,8,229
South Tyneside,Boldon School,1032,218,20,238
South Tyneside,Hebburn Comprehensive School,849,206,11,217
South Tyneside,Bamburgh School,210,0,210,210
South Tyneside,Epinay Business and Enterprise School,201,0,201,201
Sunderland,Houghton Le Spring Nursery School,107,5,0,5
Sunderland,Hylton Red House Nursery School,99,9,0,9
Sunderland,Usworth Colliery Nursery School,78,19,0,19
Sunderland,Hetton Lyons Nursery School,76,11,0,11
Sunderland,Oxclose Nursery School,73,14,0,14
Sunderland,Mill Hill Nursery School,124,11,0,11
Sunderland,Pennywell Early Years Centre,129,23,3,26
Sunderland,Barnes Junior School,342,54,0,54
Sunderland,Broadway Junior School,231,61,1,62
Sunderland,Grangetown Primary School,308,56,3,59
Sunderland,Fulwell Junior School,343,27,8,35
Sunderland,Grange Park Primary School,241,54,2,56
Sunderland,Grindon Infant School,198,26,2,28
Sunderland,Southwick  Community Primary School,388,109,9,118
Sunderland,Hudson Road Primary School,347,126,5,131
Sunderland,Dame Dorothy Primary School,221,33,3,36
Sunderland,Willow Wood Community Primary School,220,55,1,56
Sunderland,Mill Hill Primary School,413,28,2,30
Sunderland,Seaburn Dene Primary School,226,35,6,41
Sunderland,Ryhope Junior School,209,36,4,40
Sunderland,Castletown Primary School,378,59,6,65
Sunderland,East Rainton Primary School,123,11,3,14
Sunderland,Easington Lane Primary School,303,45,7,52
Sunderland,Usworth Colliery Primary School,358,83,19,102
Sunderland,Hetton Primary School,191,34,4,38
Sunderland,Biddick Primary School,297,11,3,14
Sunderland,Lambton Primary School,209,43,8,51
Sunderland,Rickleton Primary School,437,56,4,60
Sunderland,Richard Avenue Primary School,427,66,4,70
Sunderland,Marlborough Primary School,170,40,0,40
Sunderland,Shiney Row Primary School,237,34,6,40
Sunderland,Thorney Close Primary School,263,39,19,58
Sunderland,Bernard Gilpin Primary School,414,57,4,61
Sunderland,Hylton Castle Primary School,226,40,9,49
Sunderland,Blackfell Primary School,180,31,1,32
Sunderland,Barmston Village Primary School,219,46,5,51
Sunderland,St Paul's CofE Primary School,290,41,9,50
Sunderland,St Benet's Roman Catholic Voluntary Aided Primary School,345,49,3,52
Sunderland,St Anne's Roman Catholic Voluntary Aided Primary School,231,45,5,50
Sunderland,Argyle House School,218,53,2,55
Sunderland,Thornhill Park School,45,0,45,45
Sunderland,Sunningdale School,121,3,118,121
Cambridgeshire,Holme Court School,51,7,44,51
Wandsworth,Wandsworth Hospital and Home Tuition Service,1,0,1,1
"Bristol, City of",St Philips Marsh Nursery School and Barton Hill Childrens Centre/Cashmore Early Years Centre,158,45,0,45
"Bristol, City of",Filton Avenue Nursery School,140,5,0,5
"Bristol, City of",Little Hayes Nursery School,94,16,4,20
"Bristol, City of",Ilminster Avenue Specialist Nursery School,160,22,5,27
"Bristol, City of",Rosemary Nursery School and Children's Centre,95,15,0,15
"Bristol, City of",Speedwell Nursery School,101,14,0,14
"Bristol, City of",St Pauls Nursery School & Children's Centre,120,15,1,16
"Bristol, City of",St Werburghs Park Nursery School,101,14,0,14
"Bristol, City of",Redcliffe Childrens Centre and Maintained Nursery School,140,12,3,15
"Bristol, City of",The Limes Nursery School,136,19,0,19
"Bristol, City of",Hartcliffe Nursery School and Children's Centre,206,15,1,16
"Bristol, City of",Brunel Field Primary School,417,45,5,50
"Bristol, City of",Ashley Down Primary School,400,37,4,41
"Bristol, City of",Ashton Gate Primary School,788,96,5,101
"Bristol, City of",Nova Primary School,283,52,5,57
"Bristol, City of",Broomhill Junior School,202,65,9,74
"Bristol, City of",Chester Park Junior School,271,37,7,44
"Bristol, City of",Chester Park Infant School,224,13,8,21
"Bristol, City of",Glenfrome Primary School,414,54,11,65
"Bristol, City of",Henleaze Infant School,223,22,1,23
"Bristol, City of",St Anne's Infant School,214,31,3,34
"Bristol, City of",Sefton Park Infant School,218,31,0,31
"Bristol, City of",Sefton Park Junior School,226,48,6,54
"Bristol, City of",Southville Primary School,616,61,6,67
"Bristol, City of",Summerhill Infant School,169,30,0,30
"Bristol, City of",Upper Horfield Primary School,192,20,1,21
"Bristol, City of",Holymead Primary School,607,82,8,90
"Bristol, City of",Brentry Primary School,208,36,4,40
"Bristol, City of",Broomhill Infant & Nursery School,191,36,13,49
Bath and North East Somerset,Twerton Infant School,162,33,14,47
South Gloucestershire,Redfield Edge Primary School,208,27,5,32
South Gloucestershire,Shield Road Primary School,205,23,8,31
South Gloucestershire,Hanham Abbots Junior School,314,38,5,43
South Gloucestershire,The Park Primary School,496,58,8,66
South Gloucestershire,Staple Hill Primary School,299,53,9,62
South Gloucestershire,Cadbury Heath Primary School,182,38,10,48
South Gloucestershire,Parkwall Primary School,106,20,6,26
South Gloucestershire,Alexander Hosea Primary School,218,22,5,27
South Gloucestershire,Hambrook Primary School,205,19,6,25
South Gloucestershire,North Road Community Primary School,106,19,3,22
South Gloucestershire,The Ridge Junior School,240,33,2,35
South Gloucestershire,Bromley Heath Junior School,233,26,6,32
South Gloucestershire,Bromley Heath Infant School,181,17,3,20
South Gloucestershire,Longwell Green Primary School,406,43,11,54
South Gloucestershire,Samuel White's Infant School,223,11,5,16
South Gloucestershire,The Tynings School,340,44,6,50
South Gloucestershire,Crossways Junior School,240,31,5,36
South Gloucestershire,St Stephen's Infant School,237,36,0,36
South Gloucestershire,Barley Close Community Primary School,278,23,5,28
South Gloucestershire,Crossways Infant School,180,14,1,15
South Gloucestershire,Courtney Primary School,185,29,4,33
South Gloucestershire,Broadway Infant School,178,8,5,13
Bath and North East Somerset,Paulton Junior School,277,50,7,57
North Somerset,Banwell Primary School,129,20,5,25
North Somerset,Kewstoke Primary School,70,13,3,16
North Somerset,Golden Valley Primary School,415,18,3,21
"Bristol, City of",Hannah More Primary School,237,54,10,64
South Gloucestershire,Wellesley Primary School,205,36,11,47
South Gloucestershire,Cherry Garden Primary School,182,40,3,43
"Bristol, City of",Bishop Road Primary School,833,53,4,57
South Gloucestershire,Elm Park Primary School,189,30,2,32
"Bristol, City of",Blaise Primary and Nursery School,436,114,7,121
South Gloucestershire,Blackhorse Primary School,416,46,43,89
South Gloucestershire,Gillingstool Primary School,166,22,6,28
"Bristol, City of",Fair Furlong Primary School,456,110,6,116
"Bristol, City of",Whitehall Primary School,612,89,13,102
South Gloucestershire,Beacon Rise Primary School,630,99,22,121
South Gloucestershire,Stanbridge Primary School,412,46,9,55
South Gloucestershire,Barrs Court Primary School,284,28,4,32
"Bristol, City of",Avonmouth Church of England Primary School and Nursery,211,22,4,26
"Bristol, City of",Horfield Church of England Primary School,411,65,3,68
"Bristol, City of",St Barnabas Church of England VC Primary School,54,9,5,14
"Bristol, City of","St Johns Church of England Primary School, Clifton",497,58,6,64
South Gloucestershire,Almondsbury Church of England Primary School,306,11,9,20
South Gloucestershire,St Helen's Church of England Primary School,204,17,7,24
South Gloucestershire,St Anne's Church of England Primary School,383,44,7,51
South Gloucestershire,Frampton Cotterell Church of England Primary School,311,44,12,56
South Gloucestershire,Hawkesbury Church of England Primary School,81,11,0,11
South Gloucestershire,Iron Acton Church of England Primary School,98,13,4,17
South Gloucestershire,Christ Church Hanham CofE Primary School,287,38,9,47
South Gloucestershire,Mangotsfield Church of England Voluntary Controlled Primary School,620,26,9,35
South Gloucestershire,"Christ Church, Church of England Junior School, Downend",288,31,11,42
South Gloucestershire,"Christ Church, Church of England Infant School, Downend",224,24,2,26
South Gloucestershire,"St Stephen's Church of England Junior School, Soundwell",345,68,7,75
South Gloucestershire,Marshfield Church of England Primary School,131,14,1,15
South Gloucestershire,Oldbury on Severn Church of England Primary School,52,10,0,10
South Gloucestershire,Olveston Church of England Primary School,184,9,1,10
South Gloucestershire,Pucklechurch CofE VC Primary School,192,23,1,24
South Gloucestershire,Rangeworthy Church of England Primary School,67,16,2,18
South Gloucestershire,St Barnabas CofE Primary School,225,26,11,37
South Gloucestershire,Old Sodbury Church of England Primary School,99,9,1,10
South Gloucestershire,The Manor Church of England Primary School,202,17,4,21
South Gloucestershire,Wick Church of England Primary School,187,25,4,29
South Gloucestershire,Frenchay Church of England Primary School,167,16,8,24
South Gloucestershire,St Chad's Patchway CofE Primary School,192,20,9,29
South Gloucestershire,Tortworth VC Primary School,68,27,2,29
South Gloucestershire,"St Andrew's Church of England Primary School, Cromhall",70,11,1,12
South Gloucestershire,Trinity Church of England Primary School,122,10,3,13
North Somerset,Churchill Church of England Primary School,205,17,9,26
South Gloucestershire,"St Michael's Church of England Primary School, Winterbourne",190,35,5,40
South Gloucestershire,"St Michael's Church of England Primary School, Stoke Gifford",631,73,9,82
South Gloucestershire,St John's Mead Church of England Primary School,342,40,6,46
North Somerset,St Joseph's Catholic Primary School,205,21,3,24
North Somerset,Worlebury St Paul's Church of England Voluntary Aided  Primary School,187,16,3,19
"Bristol, City of",School of Christ The King Catholic Primary,217,29,3,32
"Bristol, City of",Holy Cross RC Primary School,177,49,6,55
"Bristol, City of",Ss Peter and Paul RC Primary School,178,8,5,13
"Bristol, City of",St Joseph's Catholic Primary School,200,17,0,17
South Gloucestershire,Holy Trinity Primary School,194,13,5,18
"Bristol, City of","Our Lady of the Rosary Catholic Primary School, Bristol",211,26,0,26
"Bristol, City of",St Bernadette Catholic Voluntary Aided Primary School,240,44,6,50
"Bristol, City of",St Bonaventure's Catholic Primary School,400,31,7,38
Bath and North East Somerset,St John's Catholic Primary School,311,33,12,45
Bath and North East Somerset,St Mary's Catholic Primary School,198,25,5,30
South Gloucestershire,Horton CofE VA Primary School,56,14,4,18
South Gloucestershire,"St Mary's Church of England Primary School, Thornbury",205,19,2,21
South Gloucestershire,"St Mary's Church of England Primary School, Yate",331,52,12,64
South Gloucestershire,Our Lady of Lourdes Catholic Primary School,174,27,4,31
South Gloucestershire,Holy Family Catholic Primary School,209,18,7,25
South Gloucestershire,"Christ The King Catholic Primary School, Thornbury",200,38,11,49
South Gloucestershire,St Augustine of Canterbury Catholic Primary School,177,25,1,26
South Gloucestershire,St Paul's Catholic Primary School,211,49,5,54
County Durham,Woodham Burn Community Primary School,240,52,7,59
South Gloucestershire,Brimsham Green School,972,132,29,161
"Bristol, City of",St Mary Redcliffe and Temple School,1784,326,47,373
Bath and North East Somerset,Saint Gregory's Catholic College,1006,73,42,115
"Bristol, City of",St Bernadette Catholic Secondary School,754,144,14,158
"Bristol, City of",Clifton College,1332,244,2,246
"Bristol, City of",Clifton High School,733,217,14,231
"Bristol, City of",Collegiate School Bristol,806,134,0,134
"Bristol, City of",Badminton School,546,45,0,45
"Bristol, City of",Cleve House School,63,9,2,11
"Bristol, City of",Torwood House School,6,1,2,3
"Bristol, City of",Gracefield Preparatory School,67,14,1,15
"Bristol, City of",Bristol Steiner School,82,12,3,15
Bath and North East Somerset,Kingswood School,857,211,0,211
Bath and North East Somerset,Prior Park College,608,139,2,141
Bath and North East Somerset,Royal High School GDST,607,90,4,94
Bath and North East Somerset,Kingswood Preparatory School,456,99,1,100
Bath and North East Somerset,"The Paragon School, Junior School of Prior Park College",259,41,7,48
South Gloucestershire,Sheiling School,30,0,30,30
South Gloucestershire,Tockington Manor School,274,44,4,48
Bath and North East Somerset,Monkton Senior School,396,110,0,110
North Somerset,The Downs Preparatory School,267,36,2,38
North Somerset,Sidcot School,616,166,2,168
North Somerset,Fairfield PNEU School,125,7,0,7
"Bristol, City of",Bristol Grammar School,1368,245,4,249
"Bristol, City of",Queen Elizabeth's Hospital,776,100,1,101
"Bristol, City of",Redmaids' High School,763,124,0,124
Bath and North East Somerset,King Edward's School,1175,151,3,154
Bath and North East Somerset,Monkton Prep School,330,77,3,80
"Bristol, City of",Belgrave School,51,4,47,51
"Bristol, City of",Elmfield School for Deaf Children,48,1,47,48
"Bristol, City of",Kingsweston School,169,0,169,169
"Bristol, City of",Claremont School,66,0,66,66
"Bristol, City of",New Fosseway School,149,0,149,149
South Gloucestershire,Warmley Park School,161,0,161,161
North Somerset,Westhaven School,182,0,182,182
North Somerset,Ravenswood School,141,1,140,141
North Somerset,Baytree School,84,0,84,84
"Bristol, City of",Briarwood School,164,0,164,164
Bedford,Cherry Trees Nursery School,156,13,0,13
Central Bedfordshire,Willow Nursery School,96,6,0,6
Bedford,Peter Pan Nursery School,122,14,0,14
Luton,Hart Hill Nursery School,130,38,2,40
Luton,Rothesay Nursery School,129,41,3,44
Luton,Grasmere Nursery School,174,17,5,22
Luton,Chapel Street Nursery School,111,30,1,31
Central Bedfordshire,Westfield Nursery School,125,12,1,13
Luton,Pastures Way Nursery School,116,19,0,19
Central Bedfordshire,Aspley Guise Village School,121,12,5,17
Central Bedfordshire,Swallowfield Primary,399,30,3,33
Bedford,Livingstone Primary School,426,57,14,71
Bedford,Edith Cavell Primary School,270,45,9,54
Bedford,Castle Newnham School,679,33,14,47
Bedford,Priory Primary School,202,27,12,39
Central Bedfordshire,Slip End Village School,163,18,7,25
Bedford,Sheerhatch Primary School,125,12,0,12
Bedford,Eileen Wade Primary School,80,11,1,12
Central Bedfordshire,Dunstable Icknield Lower School,336,60,4,64
Bedford,Cotton End Forest School,363,58,9,67
Bedford,Pinchmill Primary School,93,18,5,23
Central Bedfordshire,Flitwick Lower School,305,23,6,29
Central Bedfordshire,Haynes Lower School,142,26,3,29
Central Bedfordshire,Derwent Primary School,247,12,12,24
Central Bedfordshire,Houghton Conquest Lower School,137,14,3,17
Central Bedfordshire,Houghton Regis Primary School,378,47,4,51
Central Bedfordshire,Husborne Crawley Lower School,49,6,6,12
Bedford,Bedford Road Primary School,369,83,14,97
Bedford,Camestone School,411,45,11,56
Bedford,Kempston Rural Primary School,440,46,8,54
Bedford,Balliol Primary School,405,79,13,92
Central Bedfordshire,Beaudesert Lower School,282,43,2,45
Central Bedfordshire,Thomas Johnson Lower School,96,13,2,15
Central Bedfordshire,Stondon Lower School,142,15,5,20
Central Bedfordshire,Shelton Lower School,0,0,0,0
Central Bedfordshire,Maulden Lower School,165,14,5,19
Central Bedfordshire,Moggerhanger Primary School,119,18,5,23
Central Bedfordshire,Potton Lower School,280,34,6,40
Central Bedfordshire,Ridgmont Lower School,28,6,0,6
Central Bedfordshire,Laburnum Primary School,214,53,10,63
Central Bedfordshire,Shefford Lower School,516,58,15,73
Central Bedfordshire,Shillington Lower School,137,12,4,16
Central Bedfordshire,Southill Lower School,62,2,9,11
Central Bedfordshire,Stanbridge Lower School,113,21,3,24
Bedford,Broadmead Lower School,202,29,4,33
Central Bedfordshire,Roecroft Lower School,401,11,7,18
Bedford,Thurleigh Primary School,81,5,2,7
Central Bedfordshire,Chalton Lower School,67,4,0,4
Bedford,Turvey Primary School,85,13,3,16
Bedford,Wilstead Primary School,198,44,11,55
Central Bedfordshire,Woburn Lower School,57,11,1,12
Bedford,Wootton Lower School,607,48,18,66
Central Bedfordshire,Russell Lower School,449,44,4,48
Central Bedfordshire,Watling Lower School,203,25,5,30
Bedford,King's Oak Primary School,767,91,19,110
Bedford,Brickhill Primary School,238,35,6,41
Central Bedfordshire,Thornhill Primary School,294,27,6,33
Bedford,Hazeldene School,436,23,9,32
Central Bedfordshire,Kingsmoor Lower School,161,45,6,51
Central Bedfordshire,The Mary Bassett Lower School,363,48,7,55
Central Bedfordshire,Leedon Lower School,435,38,7,45
Bedford,Scott Primary School,521,84,7,91
Central Bedfordshire,Heathwood Lower School,179,19,18,37
Central Bedfordshire,Linslade Lower School,168,17,0,17
Central Bedfordshire,Clipstone Brook Lower School,280,30,5,35
Central Bedfordshire,Robert Peel Primary School,391,110,31,141
Central Bedfordshire,Southcott Lower School,305,34,4,38
Central Bedfordshire,Templefield Lower School,277,37,3,40
Central Bedfordshire,Hockliffe Lower School,53,2,1,3
Luton,Denbigh Primary School,625,87,22,109
Luton,Ferrars Junior School,352,45,8,53
Luton,Maidenhall Primary School,681,166,23,189
Luton,Norton Road Primary School,369,67,8,75
Luton,St Matthew's Primary School,805,150,20,170
Luton,Stopsley Community Primary School,451,70,14,84
Luton,Parklea Primary School,539,54,10,64
Luton,The Meads Primary School,536,35,9,44
Luton,William Austin Junior School,543,122,7,129
Luton,Warden Hill Junior School,457,93,15,108
Luton,Putteridge Primary School,612,86,12,98
Luton,Downside Primary School,1019,98,18,116
Luton,Warden Hill Infant School,354,42,15,57
Luton,Surrey Street Primary School,378,54,20,74
Luton,Foxdell Primary School,559,46,7,53
Luton,Pirton Hill Primary School,416,47,8,55
Luton,Someries Junior School,240,42,4,46
Luton,Hillborough Junior School,358,47,8,55
Luton,Icknield Primary School,599,53,32,85
Luton,Hillborough Infant and Nursery School,298,38,12,50
Luton,Someries Infant School and Early Childhood Education Centre,255,33,5,38
Luton,William Austin Infant School,368,151,5,156
Central Bedfordshire,Tithe Farm Primary School,409,41,12,53
Luton,Wigmore Primary,614,94,22,116
Bedford,Kymbrook Primary School,79,7,2,9
Central Bedfordshire,Greenleas School,714,81,22,103
Luton,Bramingham Primary School,403,60,24,84
Central Bedfordshire,St Andrew's CofE VC Lower School,792,115,21,136
Central Bedfordshire,Dunton CofE VC Lower School,59,11,4,15
Bedford,Renhold VC Primary School,213,19,6,25
Central Bedfordshire,St Swithun's Church of England VC Primary School,224,26,18,44
Central Bedfordshire,Silsoe CofE VC Lower School,269,29,15,44
Central Bedfordshire,Wrestlingworth CofE VC Lower School,45,10,1,11
Bedford,Carlton CofE Primary School,94,21,2,23
Bedford,Bromham CofE Primary School,451,42,11,53
Bedford,Milton Ernest CofE Primary School,58,6,0,6
Central Bedfordshire,John Donne Church of England Primary School,120,27,2,29
Central Bedfordshire,St Mary's VA CofE Lower School,137,9,1,10
Central Bedfordshire,"St Leonards, Heath and Reach, VA Lower School",118,16,4,20
Central Bedfordshire,Pulford CofE VA Lower School,261,21,7,28
Bedford,Christopher Reeves CofE VA Primary School,80,9,1,10
Bedford,Riseley CofE Primary School,182,16,2,18
Central Bedfordshire,Sutton CofE VA Lower School,68,6,3,9
Bedford,Wilden CofE VA Primary School,42,6,4,10
Bedford,St Lawrence Church of England Primary School,149,4,2,6
Luton,Wenlock CofE Junior School,313,38,12,50
Luton,St Joseph's Catholic Primary School,732,95,11,106
Luton,Sacred Heart Primary School,391,40,6,46
Bedford,Castle Newnham School,711,59,36,95
Central Bedfordshire,Caddington Village School,310,44,8,52
Bedford,Westfield Primary School,210,27,4,31
Central Bedfordshire,Sandy Secondary School,1155,262,39,301
Central Bedfordshire,Potton Middle School,142,33,7,40
Luton,Lealands High School,1008,152,33,185
Central Bedfordshire,Leighton Middle School,598,90,21,111
Bedford,Biddenham International School and Sports College,1275,162,34,196
Central Bedfordshire,Edward Peake CofE VC Middle School,548,114,18,132
Luton,Crawley Green Infant School,236,32,7,39
Central Bedfordshire,Ashton St Peter's VA C of E School,205,29,8,37
Luton,Queen Elizabeth School,1054,105,18,123
Luton,Lea Manor High School Performing Arts College,1045,171,16,187
Bedford,Pilgrims Pre-Preparatory School,325,73,0,73
Bedford,Bedford Greenacre Independent School,673,178,15,193
Bedford,Bedford School,1116,164,0,164
Bedford,Polam School,112,17,0,17
Luton,Kings House Preparatory School and Nursery,152,0,0,0
Bedford,Bedford Girls' School,985,97,3,100
Bedford,Bedford Modern School,1288,186,4,190
Central Bedfordshire,Ivel Valley School & College,243,0,243,243
Bedford,Ridgeway School,95,0,95,95
Luton,Richmond Hill School,280,0,280,280
Luton,Woodlands Secondary School,262,0,262,262
Luton,Lady Zia Wernher School,163,36,127,163
Central Bedfordshire,The Chiltern School,300,0,300,300
Reading,Blagdon Nursery School,129,29,0,29
Reading,Blagrave Nursery School,52,5,1,6
Reading,Caversham Nursery School,52,5,0,5
Reading,Norcot Early Years Centre,103,29,4,33
Reading,New Bridge Nursery School,69,11,4,15
Windsor and Maidenhead,Cookham Nursery School,57,6,0,6
West Berkshire,Hungerford Nursery School Centre for Children,104,23,1,24
Windsor and Maidenhead,Maidenhead Nursery School,70,8,1,9
West Berkshire,Victoria Park Nursery School & Family Hub,125,34,0,34
Windsor and Maidenhead,The Lawns Nursery School,142,21,0,21
Wokingham,The Ambleside Centre,122,8,2,10
Slough,Slough Centre Nursery School,101,31,0,31
Slough,Baylis Court Nursery School,123,20,0,20
Slough,Cippenham Nursery School,116,24,0,24
Slough,Lea Nursery School,97,13,1,14
Slough,Chalvey Nursery School & Early Years Centre,89,11,2,13
Merton,Date Valley School,134,6,1,7
Reading,Alfred Sutton Primary School,687,80,4,84
Reading,Caversham Primary School,413,38,6,44
Reading,Coley Primary School,264,44,3,47
Reading,E P Collier Primary School,408,43,27,70
Reading,Geoffrey Field Junior School,357,59,11,70
Reading,Geoffrey Field Infant School,312,48,15,63
Reading,Oxford Road Community School,249,39,14,53
Reading,Redlands Primary School,227,20,8,28
Reading,The Hill Primary School,391,59,8,67
Reading,The Ridgeway Primary School,426,94,10,104
Reading,Park Lane Primary School,410,46,6,52
Reading,Wilson Primary School,455,41,14,55
Reading,Emmer Green Primary School,414,31,6,37
Reading,Southcote Primary School,585,26,14,40
Reading,St Michael's Primary School,413,49,12,61
Reading,Moorlands Primary School,337,73,9,82
Reading,Thameside Primary School,374,65,36,101
West Berkshire,Beenham Primary School,60,13,0,13
Bracknell Forest,Fox Hill Primary School,202,35,8,43
Bracknell Forest,Holly Spring Primary School,649,66,22,88
West Berkshire,Chieveley Primary School,192,21,2,23
West Berkshire,Curridge Primary School,81,7,0,7
West Berkshire,The Ilsleys Primary School,61,9,0,9
West Berkshire,Hermitage Primary School,191,23,3,26
West Berkshire,Hungerford Primary School,363,68,7,75
West Berkshire,Inkpen Primary School,52,9,1,10
Windsor and Maidenhead,Alwyn Infant  School,240,29,2,31
Windsor and Maidenhead,Courthouse Junior School,394,25,7,32
Windsor and Maidenhead,Riverside Primary School and Nursery,397,48,28,76
Windsor and Maidenhead,Wessex Primary School,404,45,16,61
West Berkshire,John Rankin Junior School,362,74,8,82
West Berkshire,John Rankin Infant and Nursery School,286,21,2,23
Windsor and Maidenhead,King's Court First School,160,19,2,21
Bracknell Forest,College Town Primary School,498,82,7,89
Wokingham,Farley Hill Primary School,270,43,3,46
Wokingham,Lambs Lane Primary School,212,13,14,27
Windsor and Maidenhead,Waltham St Lawrence Primary School,145,17,3,20
Windsor and Maidenhead,Hilltop First School,229,19,4,23
Bracknell Forest,Cranbourne Primary School,201,37,3,40
Wokingham,Bearwood Primary School,299,45,3,48
Windsor and Maidenhead,Furze Platt Junior School,363,60,15,75
Windsor and Maidenhead,South Ascot Village Primary School,164,21,6,27
West Berkshire,Birch Copse Primary School,423,27,5,32
West Berkshire,Westwood Farm Junior School,235,50,10,60
Windsor and Maidenhead,Furze Platt Infant School,265,30,9,39
Bracknell Forest,Uplands Primary School and Nursery,235,13,7,20
Wokingham,Aldryngton Primary School,315,24,12,36
West Berkshire,Long Lane Primary School,213,28,0,28
Wokingham,Emmbrook Infant School,182,17,11,28
Windsor and Maidenhead,Cookham Rise Primary School,211,8,3,11
West Berkshire,Garland Junior School,235,39,5,44
West Berkshire,Robert Sandilands Primary School and Nursery,233,40,3,43
Wokingham,Emmbrook Junior School,258,29,18,47
West Berkshire,Westwood Farm Infant School,218,21,6,27
West Berkshire,Springfield Primary School,343,35,6,41
Bracknell Forest,Ascot Heath Primary School,395,22,6,28
Wokingham,Walter Infant School,298,27,5,32
Bracknell Forest,Owlsmoor Primary School,545,62,22,84
West Berkshire,Falkland Primary School,426,72,5,77
Windsor and Maidenhead,Homer First School and Nursery,207,18,10,28
West Berkshire,Parsons Down Infant School,116,15,2,17
Wokingham,Winnersh Primary School,406,37,9,46
Wokingham,Gorse Ride Junior School,218,17,6,23
Wokingham,The Colleton Primary School,320,28,13,41
Bracknell Forest,New Scotland Hill Primary School,216,21,4,25
Windsor and Maidenhead,Alexander First School,95,17,1,18
West Berkshire,Mrs Bland's Infant School,206,28,5,33
Windsor and Maidenhead,Oldfield Primary School,420,19,13,32
Wokingham,Willow Bank Infant School,167,19,8,27
Wokingham,Willow Bank Junior School,238,27,12,39
Bracknell Forest,Birch Hill Primary School,419,24,18,42
West Berkshire,Downsway Primary School,215,27,6,33
West Berkshire,Kennet Valley Primary School,202,26,6,32
Windsor and Maidenhead,Wraysbury Primary School,351,83,9,92
Reading,Katesgrove Primary School,688,27,13,40
Wokingham,The Hawthorns Primary School,436,46,9,55
Bracknell Forest,Wooden Hill Primary and Nursery School,419,52,6,58
West Berkshire,Parsons Down Junior School,180,27,9,36
Wokingham,Gorse Ride Infants' School,109,4,3,7
Reading,Caversham Park Primary School,137,29,1,30
Reading,Micklands Primary School,345,51,6,57
Wokingham,Radstock Primary School,417,23,16,39
Wokingham,Hawkedon Primary School,632,46,12,58
Wokingham,Hillside Primary School,460,38,15,53
West Berkshire,Calcot Infant School and Nursery,259,18,4,22
West Berkshire,Calcot Junior School,279,43,4,47
West Berkshire,Spurcroft Primary School,428,44,10,54
Windsor and Maidenhead,Larchfield Primary and Nursery School,228,19,8,27
West Berkshire,Pangbourne Primary School,194,11,2,13
Bracknell Forest,Wildridings Primary School,426,59,10,69
Bracknell Forest,Meadow Vale Primary School,634,34,19,53
Slough,Wexham Court Primary School,691,90,11,101
Reading,Manor Primary School,313,66,12,78
Reading,All Saints Church of England Aided Infant School,60,6,0,6
West Berkshire,Aldermaston C.E. Primary School,122,15,3,18
West Berkshire,Basildon C.E. Primary School,177,14,3,17
West Berkshire,Beedon C.E. (Controlled) Primary School,46,14,1,15
Windsor and Maidenhead,Braywood CofE First School,125,22,3,25
West Berkshire,Brimpton C.E. Primary School,60,12,2,14
West Berkshire,Bucklebury C.E. Primary School,121,20,2,22
West Berkshire,Burghfield St Mary's C.E. Primary School,205,27,3,30
West Berkshire,Chaddleworth St Andrew's C.E. Primary School,24,8,1,9
West Berkshire,Cold Ash St Mark's CE Primary School,188,24,2,26
West Berkshire,Compton C.E. Primary School,186,24,6,30
Windsor and Maidenhead,Cookham Dean CofE Primary School,194,15,9,24
Windsor and Maidenhead,"Holy Trinity CofE Primary School, Cookham",208,12,4,16
Bracknell Forest,Crowthorne Church of England Primary School,210,15,5,20
West Berkshire,Enborne C.E. Primary School,74,9,0,9
West Berkshire,Hampstead Norreys C.E. Primary School,72,18,2,20
West Berkshire,Kintbury St Mary's C.E. Primary School,137,28,1,29
Windsor and Maidenhead,Boyne Hill CofE Infant and Nursery School,208,36,2,38
West Berkshire,Purley CofE Primary School,104,20,0,20
Bracknell Forest,"St Michael's Church of England Primary School, Sandhurst",193,11,8,19
West Berkshire,Shaw-cum-Donnington C.E. Primary School,90,13,1,14
West Berkshire,Shefford C.E. Primary School,56,14,0,14
Wokingham,Shinfield St Mary's CofE Junior School,362,46,6,52
West Berkshire,Mortimer St Mary's C.E. Junior School,238,39,6,45
West Berkshire,Mortimer St. John's C.E. Infant School,172,22,3,25
West Berkshire,Streatley C.E. Voluntary Controlled School,97,5,2,7
West Berkshire,Theale C.E. Primary School,336,42,21,63
Bracknell Forest,Warfield Church of England Primary School,450,40,7,47
West Berkshire,Welford and Wickham C.E. Primary School,72,11,1,12
Wokingham,St Paul's CofE Junior School,380,44,2,46
Wokingham,Woodley CofE Primary School,316,37,8,45
Wokingham,Robert Piggott CofE Infant School,118,11,7,18
Wokingham,Robert Piggott CofE Junior School,171,29,6,35
Bracknell Forest,Winkfield St Mary's CofE Primary School,197,17,5,22
Slough,St Mary's Church of England Primary School,677,83,8,91
Windsor and Maidenhead,Eton Wick CofE First School,97,13,2,15
Windsor and Maidenhead,The Queen Anne Royal Free CofE Controlled First School,146,21,5,26
Bracknell Forest,Binfield Church of England Primary School,415,22,4,26
Reading,St Anne's Catholic Primary School,207,24,7,31
Reading,English Martyrs' Catholic Primary School,439,69,16,85
Reading,Christ The King Catholic Primary School,312,73,32,105
West Berkshire,St Paul's Catholic Primary School,302,36,2,38
West Berkshire,Bradfield C.E. Primary School,145,25,6,31
West Berkshire,Brightwalton C.E. Aided Primary School,97,6,1,7
Bracknell Forest,St Michael's Easthampstead Church of England Voluntary Aided Primary School,213,32,7,39
West Berkshire,Englefield C.E. Primary School,111,16,2,18
Wokingham,Finchampstead CofE VA Primary School,103,12,1,13
West Berkshire,St Nicolas C.E. Junior School,253,39,2,41
Windsor and Maidenhead,The Royal First School,104,17,5,22
Wokingham,Grazeley Parochial Church of England Aided Primary School,210,33,4,37
West Berkshire,Stockcross C.E. School,90,11,2,13
Windsor and Maidenhead,"Holy Trinity CofE Primary School, Sunningdale",210,30,5,35
Windsor and Maidenhead,"St Michael's CofE Primary School, Sunninghill",202,13,1,14
Windsor and Maidenhead,Cheapside CofE Primary School,181,5,11,16
West Berkshire,Sulhamstead and Ufton Nervet School,103,5,3,8
Windsor and Maidenhead,Trinity St Stephen CofE Aided First School,139,7,5,12
West Berkshire,Woolhampton C.E. Primary School,101,13,1,14
West Berkshire,Yattendon C.E. Primary School,88,12,2,14
Bracknell Forest,"St Joseph's Catholic Primary School, Bracknell",211,28,6,34
Windsor and Maidenhead,St Edward's Catholic First School,269,27,10,37
Slough,Our Lady of Peace Catholic Primary and Nursery School,484,50,4,54
West Berkshire,St Finian's Catholic Primary School,196,25,6,31
Reading,St Martin's Catholic Primary School,135,11,2,13
Wokingham,St Dominic Savio Catholic Primary School,420,23,16,39
West Berkshire,The Willink School,1250,154,31,185
Wokingham,The Bulmershe School,1436,153,51,204
West Berkshire,Little Heath School,1660,203,26,229
Bracknell Forest,Garth Hill College,1475,247,71,318
Slough,Wexham School,1096,89,29,118
Slough,St Bernard's Catholic Grammar School,1087,50,3,53
Windsor and Maidenhead,"St Edward's Royal Free Ecumenical Middle School, Windsor",480,35,15,50
Slough,Priory School,695,113,85,198
Slough,Holy Family Catholic Primary School,451,41,6,47
West Berkshire,St John the Evangelist CofE Infant and Nursery School,201,13,4,17
West Berkshire,St Joseph's Catholic Primary School,235,20,4,24
Slough,Pippins School,200,16,3,19
West Berkshire,The Downs School,1363,118,25,143
Reading,Blessed Hugh Faringdon Catholic School,994,57,45,102
Reading,Queen Anne's School,410,76,0,76
Reading,Leighton Park School,538,107,2,109
Reading,St Joseph's College,590,104,1,105
Reading,Hemdean House School,69,19,1,20
Reading,St Edward's Prep,107,15,1,16
Bracknell Forest,Heathfield School,238,72,0,72
Windsor and Maidenhead,Papplewick School,225,58,0,58
Windsor and Maidenhead,St George's School,268,72,0,72
Windsor and Maidenhead,St Mary's School Ascot,393,81,0,81
West Berkshire,Bradfield College,825,153,0,153
West Berkshire,St Andrew's School,310,29,0,29
West Berkshire,Downe House,551,92,0,92
Windsor and Maidenhead,Herries Preparatory School,120,26,1,27
Bracknell Forest,Wellington College,1097,194,1,195
Windsor and Maidenhead,St Piran's School,443,57,0,57
West Berkshire,Brockhurst and Marlston House Schools,307,66,3,69
West Berkshire,St Gabriel's School,488,48,5,53
Windsor and Maidenhead,Upton House School,303,45,1,46
Windsor and Maidenhead,St George's School,333,14,0,14
West Berkshire,Pangbourne College,464,232,0,232
Bracknell Forest,Eagle House School,376,96,0,96
Windsor and Maidenhead,Sunningdale School,99,17,0,17
Bracknell Forest,Lambrook School,633,103,0,103
Wokingham,Luckley House School,347,86,3,89
Wokingham,Reddam House Berkshire,759,106,1,107
Wokingham,Ludgrove School Trust Limited,185,35,0,35
West Berkshire,Elstree School,272,50,0,50
Bracknell Forest,Newbold School,89,9,0,9
Wokingham,Waverley Preparatory School & Day Nursery,263,19,1,20
Windsor and Maidenhead,Highfield Preparatory School Limited,106,21,0,21
Wokingham,Holme Grange School,667,145,7,152
Wokingham,Reading Blue Coat School,790,71,0,71
Windsor and Maidenhead,The Marist School,439,55,2,57
Windsor and Maidenhead,Claires Court Schools,964,168,15,183
Wokingham,Our Lady's Preparatory School,229,30,0,30
Wokingham,Crosfields School,708,113,0,113
Windsor and Maidenhead,Eton College,1344,214,1,215
Bracknell Forest,LVS Ascot,839,156,3,159
Slough,St Bernard's Preparatory School,222,25,0,25
Windsor and Maidenhead,Eton End School Trust (Datchet) Limited,208,17,1,18
Slough,Long Close School,229,0,2,2
Wokingham,Dolphin School,235,66,0,66
Reading,The Abbey School Reading,1006,69,0,69
West Berkshire,Padworth College,84,0,0,0
Bracknell Forest,Meadowbrook Montessori School,33,8,3,11
Reading,Caversham Preparatory School,72,2,0,2
Bracknell Forest,Cressex Lodge School,15,5,10,15
West Berkshire,Mary Hare School,202,3,199,202
Wokingham,High Close School,85,0,85,85
West Berkshire,The Castle School,175,0,175,175
Windsor and Maidenhead,Manor Green School,291,6,285,291
West Berkshire,Brookfields Special School,238,0,238,238
Wokingham,Addington School,273,0,273,273
Bracknell Forest,Kennel Lane School,198,0,198,198
Reading,The Holy Brook School,35,0,35,35
Buckinghamshire,Henry Allen Nursery School,71,12,6,18
Milton Keynes,Knowles Nursery School,83,23,0,23
Buckinghamshire,Bowerdean Nursery School,178,48,4,52
Buckinghamshire,Oak Green School,704,163,40,203
Buckinghamshire,The Mary Towerton School At Studley Green,28,7,2,9
Buckinghamshire,Bledlow Ridge School,172,15,4,19
Milton Keynes,Castlethorpe First School,38,2,0,2
Buckinghamshire,Chalfont St Giles Infant School and Nursery,209,9,4,13
Buckinghamshire,Cheddington Combined School,216,28,2,30
Buckinghamshire,Chenies School,96,4,5,9
Buckinghamshire,Newtown School,226,41,8,49
Buckinghamshire,Denham Village School,78,11,3,14
Buckinghamshire,Drayton Parslow Village School,41,4,1,5
Buckinghamshire,Dropmore Infant School,61,4,0,4
Buckinghamshire,Fulmer Infant School,70,8,1,9
Buckinghamshire,Roundwood Primary School,192,23,5,28
Buckinghamshire,Haddenham Community Infant School,91,18,2,20
Milton Keynes,Hanslope Primary School,279,32,3,35
Milton Keynes,Haversham Village School,164,15,2,17
Buckinghamshire,Marsh School,168,27,6,33
Buckinghamshire,Hyde Heath Infant School,65,4,0,4
Buckinghamshire,The Iver Village Junior School,220,42,11,53
Milton Keynes,Oldbrook First School,168,24,2,26
Buckinghamshire,Jordans School,72,12,1,13
Milton Keynes,Lavendon School,159,18,0,18
Buckinghamshire,Ley Hill School,233,15,4,19
Buckinghamshire,Little Kingshill Combined School,237,25,5,30
Buckinghamshire,Prestwood Infant School,135,16,4,20
Buckinghamshire,Steeple Claydon School and Pre-School,216,32,9,41
Buckinghamshire,Stoke Mandeville Combined School,219,20,12,32
Milton Keynes,Russell Street School,215,28,2,30
Buckinghamshire,Thornborough Infant School,33,2,1,3
Buckinghamshire,Tylers Green First School,174,15,0,15
Milton Keynes,Bushfield School,413,31,4,35
Milton Keynes,Wyvern School,328,31,8,39
Buckinghamshire,Booker Hill School,241,57,3,60
Buckinghamshire,Ash Hill Primary School,229,29,5,34
Buckinghamshire,Farnham Common Junior School,232,25,13,38
Buckinghamshire,Holmer Green First School and Pre-School,174,10,5,15
Buckinghamshire,Chalfont St Peter Infant School,179,25,3,28
Buckinghamshire,Broughton Junior School,244,35,10,45
Buckinghamshire,Little Chalfont Primary School,247,20,4,24
Buckinghamshire,Carrington Junior School,239,52,12,64
Buckinghamshire,Haydon Abbey School and Pre-School,558,77,16,93
Buckinghamshire,Danesfield School,461,44,9,53
Buckinghamshire,Grendon Underwood Combined School,144,11,5,16
Buckinghamshire,Iver Heath Junior School,213,34,6,40
Buckinghamshire,Bedgrove Infant School,459,22,4,26
Buckinghamshire,Carrington Infant School,173,20,14,34
Buckinghamshire,Broughton Community Schools (Infants),178,16,2,18
Buckinghamshire,Chalfont St Giles Junior School,239,36,6,42
Buckinghamshire,Oakridge School,465,68,13,81
Buckinghamshire,Butlers Court School,415,26,12,38
Buckinghamshire,The John Hampden School,293,14,5,19
Buckinghamshire,Chestnut Lane School,208,13,1,14
Buckinghamshire,Manor Farm Community Infant School,165,27,3,30
Buckinghamshire,Chartridge Combined School,213,30,4,34
Buckinghamshire,Juniper Hill School,418,42,9,51
Buckinghamshire,Holmer Green Junior School,255,27,7,34
Buckinghamshire,Tylers Green Middle School,257,43,6,49
Buckinghamshire,Prestwood Junior School,206,38,13,51
Buckinghamshire,Thomas Hickman School,501,102,10,112
Buckinghamshire,Burford School,432,26,9,35
Buckinghamshire,Lane End Primary School,141,31,4,35
Buckinghamshire,Hannah Ball School,174,22,4,26
Buckinghamshire,Claytons Primary School,300,52,25,77
Milton Keynes,Barleyhurst Park Primary,204,29,3,32
Buckinghamshire,Hughenden Primary School,175,25,4,29
Buckinghamshire,Buckingham Primary School,368,45,6,51
Milton Keynes,Pepper Hill School,141,21,0,21
Buckinghamshire,Aston Clinton School,391,49,23,72
Buckinghamshire,Whitchurch Combined School,207,18,7,25
Buckinghamshire,Widmer End Community Combined School,211,16,8,24
Buckinghamshire,Spinfield School,205,11,8,19
Buckinghamshire,Long Crendon School,209,26,4,30
Buckinghamshire,Stokenchurch Primary School,418,64,4,68
Buckinghamshire,Iver Heath Infant School and Nursery,199,21,4,25
Buckinghamshire,Farnham Common Infant School,202,30,2,32
Milton Keynes,Greenleys First School,130,39,3,42
Buckinghamshire,Haddenham Community Junior School,368,59,11,70
Buckinghamshire,Turnfurlong Junior School,369,58,13,71
Buckinghamshire,Elangeni School,240,27,4,31
Milton Keynes,Falconhurst School,315,33,8,41
Buckinghamshire,Ashmead Combined School,711,113,29,142
Buckinghamshire,William Harding School,821,86,30,116
Buckinghamshire,Turnfurlong Infant School,308,37,11,48
Buckinghamshire,Robertswood School,394,23,5,28
Milton Keynes,Southwood School,182,15,8,23
Milton Keynes,Stanton School,311,37,4,41
Milton Keynes,Great Linford Primary School,341,39,9,48
Milton Keynes,Greenleys Junior School,225,35,6,41
Milton Keynes,Wood End Infant & Pre-School,69,7,3,10
Milton Keynes,Bradwell Village School,242,49,5,54
Milton Keynes,Downs Barn School,90,2,2,4
Buckinghamshire,Iver Village Infant School,156,26,5,31
Milton Keynes,Germander Park School,82,9,6,15
Buckinghamshire,Waddesdon Village Primary School,220,27,3,30
Milton Keynes,The Willows School and Early Years Centre,183,23,9,32
Milton Keynes,Priory Common School,81,13,0,13
Milton Keynes,Giffard Park Primary School,300,28,9,37
Milton Keynes,Heelands School,81,16,4,20
Milton Keynes,Summerfield School,340,69,7,76
Milton Keynes,Willen Primary School,367,48,10,58
Buckinghamshire,Halton Community Combined School,212,26,14,40
Buckinghamshire,Naphill and Walters Ash School,323,33,3,36
Milton Keynes,Caroline Haslett Primary School,419,39,7,46
Milton Keynes,Green Park School,298,42,6,48
Buckinghamshire,Holtspur School & Pre-School,230,19,19,38
Milton Keynes,Cedars Primary School,306,40,4,44
Milton Keynes,Glastonbury Thorn School,178,32,1,33
Milton Keynes,Abbeys Primary School,271,53,3,56
Buckinghamshire,Highworth Combined School and Nursery,458,57,25,82
Milton Keynes,Cold Harbour Church of England School,199,35,3,38
Milton Keynes,Newton Blossomville Church of England School,16,2,0,2
Milton Keynes,North Crawley CofE School,32,3,0,3
Milton Keynes,Sherington Church of England School,18,0,0,0
Milton Keynes,Stoke Goldington Church of England School,26,4,0,4
Buckinghamshire,St James and St John CofE Primary School,147,23,5,28
Buckinghamshire,Marsh Gibbon CofE Primary School,170,22,5,27
Buckinghamshire,North Marston Church of England School,98,16,6,22
Buckinghamshire,St Michael's Church of England Combined School,196,24,3,27
Buckinghamshire,Whaddon CofE  School,55,23,2,25
Buckinghamshire,Bierton Church of England Combined School,370,27,17,44
Buckinghamshire,High Ash Church of England Primary School,282,35,4,39
Buckinghamshire,Stone Church of England Combined School,209,37,9,46
Buckinghamshire,Wendover Church of England Junior School,360,44,8,52
Buckinghamshire,Weston Turville Church of England School,199,29,11,40
Buckinghamshire,Wingrave Church of England Combined School,211,31,3,34
Buckinghamshire,St George's Church of England Infant School,176,18,1,19
Buckinghamshire,Coleshill Church of England Infant School,40,8,2,10
Buckinghamshire,Lee Common Church of England School,26,1,2,3
Buckinghamshire,Marlow Church of England Infant School,179,15,2,17
Buckinghamshire,Monks Risborough CofE Primary School,204,30,14,44
Buckinghamshire,St Mary's Farnham Royal CofE Primary School,269,57,4,61
Buckinghamshire,Twyford C of E School,109,12,1,13
Buckinghamshire,Maids Moreton Church of England School,72,3,0,3
Milton Keynes,St Mary's Wavendon CofE Primary,381,33,4,37
Buckinghamshire,Newton Longville Church of England Primary School,204,27,5,32
Buckinghamshire,Westcott Church of England School,64,14,4,18
Milton Keynes,St Andrew's CofE Infant School,14,0,0,0
Buckinghamshire,Mursley Church of England School,44,5,1,6
Buckinghamshire,Hawridge and Cholesbury Church of England School,195,24,4,28
Buckinghamshire,Haddenham St Mary's Church of England School,180,12,5,17
Buckinghamshire,Quainton Church of England School,164,17,3,20
Buckinghamshire,Oakley Church of England Combined School,96,14,7,21
Buckinghamshire,Winslow Church of England School,375,43,10,53
Buckinghamshire,St Peter's Church of England Primary School,266,42,8,50
Buckinghamshire,Swanbourne Church of England VA School,115,19,2,21
Buckinghamshire,Cuddington and Dinton CofE School,184,21,5,26
Buckinghamshire,Marsworth Church of England Infant School,25,6,0,6
Buckinghamshire,"St Mary's CofE Primary School, Amersham",333,43,7,50
Buckinghamshire,Little Missenden Church of England School,42,5,2,7
Buckinghamshire,St Mary and All Saints CofE Primary School,395,32,4,36
Buckinghamshire,Cadmore End CofE School,77,25,2,27
Buckinghamshire,Frieth Church of England Combined School,120,1,3,4
Buckinghamshire,Hazlemere Church of England Combined School,200,35,9,44
Buckinghamshire,High Wycombe Church of England Combined School,209,15,2,17
Buckinghamshire,Ibstone CofE Primary School,85,11,3,14
Buckinghamshire,Little Marlow CofE School,59,13,0,13
Buckinghamshire,Radnage Church of England Primary School,85,4,6,10
Buckinghamshire,Speen CofE VA School,41,1,0,1
Buckinghamshire,"St Paul's Church of England Combined School, Wooburn",238,23,3,26
Buckinghamshire,Holy Trinity Church of England (Aided) School,348,45,14,59
Milton Keynes,St Thomas Aquinas Catholic Primary School,265,33,1,34
Milton Keynes,Bishop Parker Catholic School,187,21,2,23
Milton Keynes,St Monica's Catholic Primary School,397,63,5,68
Milton Keynes,St Mary Magdalene Catholic Primary School,390,71,3,74
Buckinghamshire,Buckingham School,1176,202,36,238
Buckinghamshire,The Grange School,1404,180,41,221
Buckinghamshire,Cressex Community School,762,127,32,159
Buckinghamshire,St Michael's Catholic School,2101,238,57,295
Milton Keynes,St Paul's Catholic School,1861,139,83,222
Buckinghamshire,Brookmead School,317,31,10,41
Buckinghamshire,Overstone Combined School,212,24,5,29
Buckinghamshire,Castlefield School,475,92,14,106
Buckinghamshire,Brushwood Junior School,256,41,10,51
Buckinghamshire,Loudwater Combined School,205,18,2,20
Milton Keynes,The Radcliffe School,1223,157,33,190
Buckinghamshire,The Cottesloe School,1111,130,49,179
Buckinghamshire,Akeley Wood Senior School,493,163,5,168
Buckinghamshire,Davenies School,334,33,0,33
Buckinghamshire,High March School,282,16,0,16
Buckinghamshire,Heatherton School,158,0,15,15
Buckinghamshire,Caldicott School,245,54,0,54
Buckinghamshire,Gayhurst School,361,47,2,49
Buckinghamshire,Maltman's Green School,328,27,0,27
Buckinghamshire,St Mary's School,425,173,7,180
Buckinghamshire,Pipers Corner School,613,78,2,80
Buckinghamshire,Godstowe Preparatory School,428,14,0,14
Buckinghamshire,Wycombe Abbey,650,80,0,80
Buckinghamshire,Stowe School,902,86,0,86
Buckinghamshire,Thornton College,408,46,2,48
Buckinghamshire,Beachborough School,379,0,2,2
Buckinghamshire,Swanbourne House School,272,28,3,31
Buckinghamshire,Chesham Preparatory School,383,62,2,64
Buckinghamshire,The Beacon School,516,80,1,81
Buckinghamshire,Dair House School,113,33,2,35
Buckinghamshire,Thorpe House School,276,40,2,42
Buckinghamshire,Gateway School,259,29,0,29
Buckinghamshire,Crown House School,112,17,0,17
Buckinghamshire,Griffin House School,176,23,5,28
Buckinghamshire,Ashfold School,300,45,2,47
Buckinghamshire,Macintyre School,29,0,29,29
Milton Keynes,Milton Keynes Preparatory School,346,8,1,9
Milton Keynes,The Webber Independent School,335,27,1,28
Buckinghamshire,Teikyo School UK,28,5,0,5
Milton Keynes,The Grove Independent School,208,16,0,16
Milton Keynes,White Spire School,157,0,157,157
Buckinghamshire,Pebble Brook School,161,0,161,161
Buckinghamshire,Chiltern Wood School,199,0,199,199
Buckinghamshire,Stony Dean School,211,0,211,211
Milton Keynes,Romans Field School,63,0,63,63
Buckinghamshire,Stocklake Park Community School,100,0,100,100
Buckinghamshire,Heritage House School,111,1,110,111
Milton Keynes,The Walnuts School,198,0,198,198
Buckinghamshire,Furze Down School,193,0,193,193
Milton Keynes,Slated Row School,226,0,226,226
Buckinghamshire,Booker Park Community School,238,0,238,238
Milton Keynes,The Redway School,171,0,171,171
Cambridgeshire,The Fields Nursery School,71,5,0,5
Cambridgeshire,Homerton Early Years Centre,117,0,2,2
Cambridgeshire,Histon Early Years Centre,115,6,3,9
Cambridgeshire,Brunswick Nursery School,77,13,0,13
Cambridgeshire,Colleges Nursery School,103,13,1,14
Cambridgeshire,Huntingdon Nursery School,85,14,1,15
Peterborough,Caverstede Nursery School,136,18,3,21
Cambridgeshire,Bassingbourn Primary School,386,28,11,39
Cambridgeshire,Caldecote Primary School,202,8,4,12
Cambridgeshire,Cottenham Primary School,479,57,18,75
Cambridgeshire,Fen Drayton Primary School,112,20,6,26
Cambridgeshire,Fowlmere Primary School,90,12,0,12
Cambridgeshire,Foxton Primary School,91,16,4,20
Cambridgeshire,Great Abington Primary School,136,21,3,24
Cambridgeshire,Harston and Newton Community Primary School,118,20,5,25
Cambridgeshire,Melbourn Primary School,402,44,19,63
Cambridgeshire,Meldreth Primary School,209,34,9,43
Cambridgeshire,Over Primary School,213,9,6,15
Cambridgeshire,Pendragon Community Primary School,368,34,13,47
Cambridgeshire,Swavesey Primary School,303,34,11,45
Cambridgeshire,Waterbeach Community Primary School,490,35,8,43
Cambridgeshire,Willingham Primary School,342,38,7,45
Cambridgeshire,Meridian Primary School,212,21,2,23
Cambridgeshire,Benwick Primary School,99,13,7,20
Cambridgeshire,Townley Primary School,102,17,11,28
Cambridgeshire,Coates Primary School,201,28,4,32
Cambridgeshire,Lionel Walden Primary School,208,19,5,24
Cambridgeshire,Friday Bridge Community Primary School,89,22,1,23
Cambridgeshire,Robert Arkenstall Primary School,286,21,5,26
Cambridgeshire,Littleport Community Primary School,409,45,10,55
Cambridgeshire,Manea Community Primary School,241,26,13,39
Cambridgeshire,Beaupre Community Primary School,190,24,0,24
Cambridgeshire,Alderman Payne Primary School,100,14,9,23
Cambridgeshire,Stretham Community Primary School,178,23,4,27
Cambridgeshire,Clarkson Infants School,193,37,8,45
Cambridgeshire,Morley Memorial Primary School,398,31,8,39
Cambridgeshire,Newnham Croft Primary School,230,8,2,10
Cambridgeshire,Shirley Community Primary School,377,72,19,91
Cambridgeshire,Arbury Primary School,371,49,6,55
Cambridgeshire,Colville Primary School,237,53,26,79
Cambridgeshire,Mayfield Primary School,404,35,24,59
Cambridgeshire,The Grove Primary School,251,41,12,53
Cambridgeshire,Hauxton Primary School,96,14,6,20
Cambridgeshire,Fenstanton and Hilton Primary School,228,24,7,31
Cambridgeshire,Hemingford Grey Primary School,283,35,6,41
Cambridgeshire,Houghton Primary School,177,25,12,37
Peterborough,Old Fletton Primary School,440,46,10,56
Cambridgeshire,The Ashbeach Primary School,122,17,8,25
Cambridgeshire,Priory Park Infant School & Playgroup,238,19,7,26
Peterborough,Southfields Primary School,578,111,17,128
Cambridgeshire,Westfield Junior School,271,28,13,41
Cambridgeshire,Priory Junior School,329,32,15,47
Cambridgeshire,Wyton on the Hill Community Primary School,175,47,10,57
Peterborough,The Duke of Bedford Primary School,216,26,6,32
Cambridgeshire,Eastfield Infant and Nursery School,205,17,7,24
Peterborough,Oakdale Primary School,357,37,3,40
Cambridgeshire,Yaxley Infant School,131,12,6,18
Cambridgeshire,Sawtry Infants' School,184,12,11,23
Cambridgeshire,The Newton Community Primary School,61,10,4,14
Peterborough,Brewster Avenue Infant School,196,8,7,15
Peterborough,Queen's Drive Infant School,241,32,4,36
Cambridgeshire,Little Paxton Primary School,324,33,10,43
Peterborough,Norwood Primary School,208,32,9,41
Peterborough,Leighton Primary School,364,60,5,65
Cambridgeshire,Bewick Bridge Community Primary School,213,11,13,24
Peterborough,Winyates Primary School,203,34,2,36
Cambridgeshire,Hardwick and Cambourne Community Primary School,494,66,15,81
Cambridgeshire,St Matthew's Primary School,666,103,17,120
Cambridgeshire,Fourfields Community Primary School,448,67,24,91
Peterborough,The Beeches Primary School,613,105,10,115
Cambridgeshire,Burwell Village College (Primary),394,32,4,36
Cambridgeshire,Fulbourn Primary School,281,40,7,47
Cambridgeshire,Spring Meadow Infant School,144,18,21,39
Cambridgeshire,Kinderley Primary School,84,13,3,16
Cambridgeshire,Queen Edith Primary School,428,36,11,47
Cambridgeshire,The Spinney Primary School,207,30,3,33
Cambridgeshire,Fawcett Primary School,402,85,7,92
Cambridgeshire,Kettlefields Primary School,107,9,2,11
Cambridgeshire,Stukeley Meadows Primary School,401,38,17,55
Cambridgeshire,Ely St John's Community Primary School,374,26,15,41
Cambridgeshire,Kings Hedges Primary School,385,61,13,74
Peterborough,Paston Ridings Primary School,434,97,8,105
Cambridgeshire,Barrington CofE VC Primary School,132,8,6,14
Cambridgeshire,Burrough Green CofE Primary School,84,15,3,18
Cambridgeshire,Castle Camps Church of England (Controlled) Primary School,136,10,3,13
Cambridgeshire,Cheveley CofE Primary School,141,16,2,18
Cambridgeshire,Coton Church of England (Voluntary Controlled) Primary School,107,13,8,21
Cambridgeshire,Dry Drayton CofE (C) Primary School,69,15,1,16
Cambridgeshire,Fordham CofE Primary School,418,57,11,68
Cambridgeshire,Great Wilbraham CofE Primary School,96,15,1,16
Cambridgeshire,Isleham Church of England Primary School,207,40,5,45
Cambridgeshire,Steeple Morden CofE VC Primary School,172,51,2,53
Cambridgeshire,William Westley Church of England VC Primary School,203,18,6,24
Cambridgeshire,Haslingfield Endowed Primary School,143,15,3,18
Cambridgeshire,Duxford Church of England Community Primary School,182,17,4,21
Cambridgeshire,Cherry Hinton Church of England Voluntary Controlled Primary School,193,26,8,34
Cambridgeshire,Sutton CofE VC Primary School,255,31,16,47
Cambridgeshire,Little Thetford CofE Primary School,92,15,6,21
Cambridgeshire,Wilburton CofE Primary School,116,19,8,27
Cambridgeshire,The Rackham Church of England Primary School,308,43,17,60
Cambridgeshire,Alconbury CofE Primary School,204,41,10,51
Cambridgeshire,Folksworth CofE Primary School,94,21,2,23
Cambridgeshire,Great Gidding CofE Primary School,44,7,0,7
Cambridgeshire,Barnabas Oley CofE Primary School,149,21,1,22
Cambridgeshire,Great Paxton CofE Primary School,109,8,1,9
Cambridgeshire,Holywell CofE Primary School,205,22,3,25
Cambridgeshire,Eynesbury CofE C Primary School,227,13,7,20
Peterborough,Barnack CofE (Controlled) Primary School,170,17,3,20
Peterborough,Castor CofE Primary School,195,17,6,23
Peterborough,Eye CofE Primary School,450,41,4,45
Peterborough,Newborough CofE Primary School,202,30,11,41
Cambridgeshire,Brington CofE Primary School,106,13,3,16
Cambridgeshire,Barton CofE VA Primary School,103,5,6,11
Cambridgeshire,Elsworth CofE VA Primary School,124,7,3,10
Cambridgeshire,Great and Little Shelford CofE (Aided) Primary School,211,15,6,21
Cambridgeshire,Linton CofE Infant School,156,6,3,9
Cambridgeshire,Teversham CofE VA Primary School,181,32,7,39
Cambridgeshire,Petersfield CofE Aided Primary School,125,12,1,13
Cambridgeshire,Park Street CofE Primary School,117,18,3,21
Cambridgeshire,St Pauls CofE VA Primary School,168,18,1,19
Cambridgeshire,St Philip's CofE Aided Primary School,270,37,4,41
Cambridgeshire,St Alban's Catholic Primary School,210,16,4,20
Cambridgeshire,The Elton CofE Primary School of the Foundation of Frances and Jane Proby,138,11,2,13
Cambridgeshire,Abbots Ripton CofE Primary School,95,4,0,4
Peterborough,Peakirk-Cum-Glinton CofE Primary School,198,18,3,21
Peterborough,All Saints' CofE (Aided) Primary School,420,43,12,55
Peterborough,St Augustine's CofE (Voluntary Aided) Junior School,228,38,8,46
Peterborough,St John's Church School,468,84,6,90
Peterborough,Ken Stimpson Community School,1082,155,39,194
Cambridgeshire,St Helen's Primary School,183,20,5,25
Peterborough,St John Fisher Catholic High School,797,62,29,91
Peterborough,The Peterborough School,551,64,2,66
Cambridgeshire,King's College School,405,82,0,82
Cambridgeshire,St Mary's School,677,222,0,222
Cambridgeshire,St Faith's School,575,76,3,79
Cambridgeshire,The Leys School,567,120,0,120
Cambridgeshire,St John's College School,458,70,8,78
Cambridgeshire,King's Ely,1100,54,1,55
Cambridgeshire,Aurora Meldreth Manor School,37,0,37,37
Cambridgeshire,Sancton Wood School,389,93,3,96
Cambridgeshire,The Perse School,1705,322,1,323
Cambridgeshire,The Stephen Perse Foundation,1665,132,3,135
Cambridgeshire,Kimbolton School,1065,144,1,145
Cambridgeshire,Wisbech Grammar School,568,95,3,98
Cambridgeshire,Whitehall School,111,8,2,10
Cambridgeshire,Mander Portman Woodward,220,71,1,72
Cambridgeshire,St. Andrew's College Cambridge,128,8,0,8
Cambridgeshire,Cambridge Arts and Sciences (CATS and CSVPA),493,14,0,14
Peterborough,Marshfields School,171,0,171,171
Peterborough,Heltwate School,207,0,207,207
Cambridgeshire,Samuel Pepys School,119,0,119,119
Cheshire East,Westminster Nursery School,68,9,0,9
Warrington,Sandy Lane Nursery and Forest School,104,28,0,28
Halton,Aspiring Foundations Federated Nursery Schools - Ditton Nursery School,48,6,0,6
Halton,Birchfield Nursery School,90,13,1,14
Halton,Aspiring Foundations Federated Nursery Schools - Warrington Road Nursery School,63,7,2,9
Warrington,Bewsey Lodge Primary School,358,34,21,55
Warrington,Dallam Community Primary School,271,61,30,91
Cheshire West and Chester,Newton Primary School,418,61,3,64
Cheshire West and Chester,J H Godwin Primary School,174,42,10,52
Cheshire West and Chester,Neston Primary School,186,28,4,32
Warrington,Bradshaw Community Primary School,193,14,4,18
Halton,Moore Primary School,206,27,6,33
Halton,Victoria Road Primary School,200,30,0,30
Cheshire West and Chester,Aston by Sutton Primary School,99,19,6,25
Cheshire West and Chester,Kingsley Community Primary School and Nursery,197,22,7,29
Warrington,Stockton Heath Primary School,402,16,2,18
Warrington,Thelwall Community Junior School,172,22,1,23
Warrington,The Cobbs Infant and Nursery School,306,22,4,26
Halton,Weston Point Community Primary School,142,22,11,33
Cheshire West and Chester,Alvanley and Manley Village School,102,9,4,13
Cheshire West and Chester,Helsby Hillside Primary School,206,21,1,22
Cheshire East,Alderley Edge Community Primary School,203,19,11,30
Cheshire East,Styal Primary School,117,31,5,36
Cheshire East,Lower Park School,280,25,4,29
Cheshire East,Lindow Community Primary School,190,11,13,24
Cheshire East,Buglawton Primary School,200,18,8,26
Cheshire East,Scholar Green Primary School,236,25,2,27
Cheshire East,Havannah Primary School,246,28,13,41
Cheshire West and Chester,Moulton School,205,49,2,51
Cheshire West and Chester,Charles Darwin Community Primary School,338,72,7,79
Cheshire West and Chester,Weaverham Forest Primary School,240,40,9,49
Cheshire West and Chester,Byley Primary School and Nursery,96,10,3,13
Cheshire West and Chester,Wimboldsley Community Primary School,126,7,8,15
Cheshire West and Chester,Winsford High Street Community Primary School,560,74,14,88
Cheshire East,Brierley Primary School,235,55,10,65
Cheshire East,Sound and District Primary School,137,12,5,17
Cheshire East,Wrenbury Primary School,130,14,5,19
Cheshire East,Millfields Primary School and Nursery,245,18,6,24
Cheshire East,The Dingle Primary School,382,26,15,41
Cheshire West and Chester,Mickle Trafford Village School,203,22,5,27
Cheshire West and Chester,Cambridge Road Community Primary and Nursery School,249,89,12,101
Cheshire West and Chester,William Stockton Community Primary School,364,54,3,57
Cheshire West and Chester,Whitby Heath Primary School,409,36,6,42
Cheshire West and Chester,Huntington Community Primary School,412,63,12,75
Cheshire East,High Legh Primary School,158,13,4,17
Cheshire West and Chester,Upton Westlea Primary School,209,35,15,50
Cheshire West and Chester,Sutton Green Primary School,275,19,14,33
Cheshire West and Chester,Waverton Community Primary School,195,9,5,14
Cheshire West and Chester,Farndon Primary School,298,7,10,17
Cheshire West and Chester,Tattenhall Park Primary School,245,20,4,24
Cheshire West and Chester,Ashton Hayes Primary School,137,1,4,5
Cheshire West and Chester,Rossmore School,182,29,3,32
Halton,Weston Primary School,207,18,8,26
Halton,Castle View Primary School,177,17,4,21
Cheshire West and Chester,Hartford Primary School,418,33,8,41
Halton,The Brow Community Primary School,144,53,27,80
Halton,Woodside Primary School,111,16,14,30
Cheshire West and Chester,Parkgate Primary School,170,8,2,10
Cheshire West and Chester,Horn's Mill Primary School,203,34,2,36
Cheshire West and Chester,Darnhall Primary School,432,94,17,111
Warrington,Appleton Thorn Primary School,185,19,6,25
Halton,Pewithall  School,215,25,6,31
Cheshire East,Vine Tree Primary School,205,36,4,40
Cheshire West and Chester,Hartford Manor Primary School & Nursery,450,61,4,65
Cheshire East,Dean Valley Community Primary School,206,28,5,33
Cheshire West and Chester,Christleton Primary School,214,18,5,23
Warrington,Cherry Tree School,220,22,4,26
Cheshire East,Rode Heath Primary School,246,11,4,15
Cheshire West and Chester,Wincham Community Primary School,312,14,4,18
Cheshire East,Weaver Primary School,209,0,9,9
Halton,Hillview Primary School,191,40,1,41
Cheshire East,Edleston Primary School,212,45,5,50
Cheshire East,Goostrey Community Primary School,213,13,7,20
Halton,Murdishaw West Community Primary School,131,45,3,48
Halton,Beechwood Primary School,158,27,14,41
Halton,Gorsewood Primary School,180,73,7,80
Halton,Windmill Hill Primary School,159,66,6,72
Warrington,Culcheth Community Primary School,217,19,4,23
Halton,Moorfield Primary School,278,27,3,30
Warrington,Newchurch Community Primary School,191,27,2,29
Warrington,Twiss Green Community Primary School,205,12,2,14
Halton,Fairfield Primary School,615,111,5,116
Halton,Lunts Heath Primary School,418,34,3,37
Warrington,Brook Acre Community Primary School,233,66,1,67
Cheshire East,Rainow Primary School,177,7,9,16
Warrington,Locking Stumps Community Primary School,399,58,9,67
Cheshire West and Chester,Cherry Grove Primary School,293,56,5,61
Halton,Hallwood Park Primary School and Nursery,104,20,2,22
Cheshire East,Beechwood Primary School and Nursery,472,44,15,59
Cheshire West and Chester,Winnington Park Community Primary and Nursery School,381,16,3,19
Warrington,Callands Community Primary School,409,50,5,55
Cheshire East,Mablins Lane Community Primary School,598,77,35,112
Halton,Astmoor Primary School,120,36,4,40
Cheshire West and Chester,Dee Point Primary School,468,151,30,181
Cheshire East,Pebble Brook Primary School,295,34,15,49
Cheshire West and Chester,Elton Primary School,211,30,5,35
Cheshire East,Ashdene Primary School,412,10,5,15
Halton,Halton Lodge Primary School,199,37,7,44
Cheshire West and Chester,Oldfield Primary School,209,8,11,19
Cheshire East,Hurdsfield Community Primary School,171,13,10,23
Warrington,Barrow Hall Community Primary School,639,48,8,56
Cheshire West and Chester,Meadow Community Primary School,420,20,13,33
Cheshire West and Chester,Frodsham Manor House Primary School,215,13,6,19
Halton,Westfield Primary School,102,21,3,24
Halton,Halebank CofE Primary School,101,35,0,35
Cheshire West and Chester,Willaston CofE Primary School,208,7,3,10
Cheshire West and Chester,Antrobus St Mark's CofE Primary School,70,1,0,1
Cheshire West and Chester,Frodsham CofE Primary School,226,9,2,11
Cheshire West and Chester,Great Budworth CofE Primary School,56,1,1,2
Cheshire West and Chester,Norley CofE VA Primary School,105,9,2,11
Cheshire East,Bollington Cross CofE Primary School,189,24,8,32
Cheshire East,Chelford CofE Primary School,71,5,5,10
Cheshire East,Woodcocks' Well CofE Primary School,107,15,2,17
Cheshire East,Elworth CofE Primary School,367,38,15,53
Cheshire West and Chester,Tarporley CofE Primary School,283,29,5,34
Cheshire West and Chester,St. Chad's Church of England Primary and Nursery School,209,25,5,30
Cheshire West and Chester,Over St John's CofE Primary School,136,29,4,33
Cheshire East,Bickerton Holy Trinity CofE Primary School,143,9,1,10
Cheshire West and Chester,Barrow CofE Primary School,48,6,3,9
Cheshire West and Chester,Capenhurst CofE Primary School,100,5,1,6
Cheshire West and Chester,Dodleston CofE Primary School,86,9,1,10
Cheshire West and Chester,Guilden Sutton CofE Primary School,207,10,6,16
Cheshire East,Mobberley CofE Primary School,197,16,4,20
Cheshire West and Chester,Duddon St Peter's CofE Primary School,88,19,1,20
Cheshire West and Chester,Malpas Alport Endowed Primary School,276,41,7,48
Cheshire West and Chester,Shocklach Oviatt CofE Primary School,74,12,1,13
Cheshire West and Chester,Tilston Parochial CofE Primary School,114,5,2,7
Cheshire West and Chester,Tushingham With Grindley CofE Primary School,118,9,2,11
Cheshire West and Chester,Huxley CofE Primary School,34,7,1,8
Cheshire East,St Anne's Fulshaw C of E Primary School,120,26,2,28
Cheshire West and Chester,Lostock Gralam CofE Primary School,200,23,7,30
Cheshire West and Chester,Overleigh St Mary's CofE Primary School,525,38,11,49
Halton,Hale Church of England Voluntary Controlled Primary School,186,35,6,41
Warrington,St Elphin's (Fairfield) CofE Voluntary Aided Primary School,370,25,5,30
Warrington,Warrington St Ann's CofE Primary School,206,44,2,46
Warrington,Warrington St Barnabas CofE Primary School,161,31,2,33
Warrington,St Andrew's CofE Primary School,207,39,1,40
Warrington,Birchwood CofE Primary School,174,22,2,24
Warrington,Our Lady's Catholic Primary School,173,32,6,38
Warrington,Sacred Heart Catholic Primary School,197,47,6,53
Warrington,St Alban's Catholic Primary School,219,28,1,29
Warrington,St Benedict's Catholic Primary School,227,47,4,51
Warrington,St Augustine's Catholic Primary School,171,31,3,34
Warrington,St Stephen's Catholic Primary School,208,34,4,38
Cheshire West and Chester,St Clare's Catholic Primary School,185,36,2,38
Cheshire West and Chester,Bishop Wilson Church of England Primary School,77,9,1,10
Cheshire West and Chester,St Winefride's Catholic Primary School,165,18,2,20
Halton,Runcorn All Saints CofE Primary School,115,24,4,28
Warrington,Grappenhall St Wilfrid's CofE Primary School,422,24,6,30
Halton,St Mary's Church of England Primary School,192,41,2,43
Cheshire West and Chester,Kingsley St John's CofE (VA) Primary School,71,11,10,21
Warrington,St Thomas' CofE Primary School,239,10,6,16
Halton,St Edward's Catholic Primary School,126,22,4,26
Halton,St Clement's Catholic Primary School,204,21,5,26
Halton,The Holy Spirit Catholic Primary School,109,31,2,33
Warrington,St Monica's Catholic Primary School,167,30,3,33
Cheshire East,St Benedict's Catholic Primary School,210,26,9,35
Cheshire East,Bollington St John's CofE Primary School,107,10,6,16
Cheshire East,Prestbury CofE Primary School,350,19,9,28
Cheshire East,Wincle CofE Primary School,66,10,5,15
Cheshire East,St Gregory's Catholic Primary School,47,2,4,6
Cheshire East,Marton and District CofE Aided Primary School,180,14,6,20
Cheshire East,St John the Evangelist CofE Primary School Macclesfield,287,27,9,36
Cheshire East,St John's CofE Primary School,187,27,21,48
Cheshire West and Chester,Crowton Christ Church CofE Primary School,43,4,0,4
Cheshire West and Chester,Lower Peover CofE Primary School,204,23,3,26
Cheshire West and Chester,Whitegate CofE Primary School,166,20,3,23
Cheshire East,St Gabriel's Catholic Primary School,210,12,7,19
Cheshire East,St Mary's Catholic Primary School,194,20,9,29
Cheshire West and Chester,"St Bede's Catholic Primary School, Weaverham",192,21,2,23
Cheshire East,"St Mary's Catholic Primary School, Crewe",595,39,20,59
Cheshire East,Bridgemere CofE Primary School,93,5,1,6
Cheshire East,St Anne's Catholic Primary School,204,16,2,18
Cheshire West and Chester,Eccleston CofE Primary School,102,12,7,19
Cheshire West and Chester,Saighton Church of England Primary School & Pre-School,113,5,3,8
Cheshire West and Chester,Ellesmere Port Christ Church CofE Primary School,200,16,6,22
Cheshire West and Chester,St Mary of the Angels Catholic Primary School,209,12,4,16
Cheshire East,St Vincent De Paul Catholic Primary School,198,14,8,22
Cheshire East,Bollinbrook CofE (A) Primary School,161,14,7,21
Warrington,Christ Church CofE Primary School Padgate,345,51,6,57
Warrington,Winwick CofE Primary School,204,19,5,24
Warrington,Woolston CofE Aided Primary School,214,23,3,26
Warrington,St Paul of the Cross Catholic Primary School,143,24,5,29
Warrington,St Lewis Catholic Primary School,133,12,1,13
Warrington,St Oswald's Catholic Primary School,216,30,3,33
Warrington,St Peter's Catholic Primary School,209,22,3,25
Halton,St Bede's Catholic Junior School,309,56,5,61
Halton,St Bede's Catholic Infant School,229,34,2,36
Warrington,St Joseph's Catholic Primary School,271,25,5,30
Warrington,St Vincent's Catholic Primary School,129,21,4,25
Warrington,St Bridget's Catholic Primary School,194,47,2,49
Halton,Our Lady Mother of the Saviour Catholic Primary School,187,46,4,50
Cheshire West and Chester,St Luke's Catholic Primary School,121,13,2,15
Halton,St Martin's Catholic Primary School,199,34,2,36
Warrington,Cinnamon Brow CofE Primary School,309,43,3,46
Warrington,Stretton St Matthew's CofE Primary School,213,22,1,23
Halton,St Berteline's CofE Primary School,285,49,5,54
Cheshire West and Chester,St Werburgh's and St Columba's Catholic Primary School,329,31,6,37
Warrington,St Philip (Westbrook) CofE Aided Primary School,606,30,6,36
Cheshire West and Chester,St. Joseph's Catholic Primary School,334,10,16,26
Cheshire West and Chester,Davenham CofE Primary School,324,30,2,32
Cheshire West and Chester,St Theresa's Catholic Primary School,185,28,4,32
Cheshire West and Chester,Witton Church Walk CofE Aided Nursery and Primary School,279,47,9,56
Halton,St Basil's Catholic Primary School,269,65,2,67
Halton,St Gerard's Catholic Primary and Nursery School,232,38,3,41
Halton,St John Fisher Catholic Primary School,217,37,6,43
Halton,St Michaels Catholic Primary School,240,52,6,58
Halton,Farnworth Church of England Controlled Primary School,419,12,9,21
Cheshire West and Chester,"Blacon High School, A Specialist Sports College",716,157,36,193
Cheshire West and Chester,Weaverham High School,1161,158,18,176
Cheshire East,Ruskin Community High School,703,81,20,101
Cheshire East,Malbank School and Sixth Form College,1176,125,42,167
Cheshire West and Chester,Upton-by-Chester High School,1737,206,27,233
Cheshire West and Chester,Bishop Heber High School,1279,67,20,87
Cheshire West and Chester,The Whitby High School,1541,164,13,177
Warrington,Culcheth High School,1181,131,32,163
Cheshire West and Chester,Helsby High School,1338,155,17,172
Cheshire East,Wilmslow High School,2157,190,81,271
Cheshire West and Chester,St Nicholas Catholic High School,1208,62,33,95
Cheshire West and Chester,Ellesmere Port Catholic High School,936,156,43,199
Warrington,St Gregory's Catholic High School,1207,165,53,218
Warrington,Cardinal Newman Catholic High School,819,112,17,129
Halton,Saints Peter and Paul Catholic High School,1282,40,17,57
Cheshire East,Kettleshulme St James CofE (VA) Primary School,63,15,2,17
Cheshire West and Chester,St Wilfrid's Catholic Primary School,207,8,7,15
Cheshire East,Pott Shrigley Church School,35,10,2,12
Cheshire East,The Ryleys School,264,17,7,24
Cheshire West and Chester,The Firs School,122,18,1,19
Cheshire West and Chester,The Grange School,1218,105,1,106
Cheshire East,Terra Nova School,258,57,2,59
Cheshire East,The King's School In Macclesfield,1292,285,6,291
Cheshire East,Beech Hall School,219,54,62,116
Cheshire East,Wilmslow Preparatory School,127,12,3,15
Cheshire East,Alderley Edge School for Girls,448,122,1,123
Cheshire East,Yorston Lodge School,73,5,0,5
Cheshire East,Pownall Hall School,290,27,3,30
Cheshire West and Chester,The Hammond,232,24,3,27
Cheshire West and Chester,Cransley School,252,74,7,81
Cheshire West and Chester,Abbey Gate College,510,193,2,195
Cheshire West and Chester,The King's School,1134,205,1,206
Cheshire West and Chester,The Queen's School,450,98,1,99
Cheshire West and Chester,Dee Banks School,117,0,117,117
Warrington,Green Lane Community Special School,221,0,221,221
Warrington,Fox Wood Special School,124,0,124,124
Warrington,Chaigeley School,41,0,41,41
Cheshire East,David Lewis School,18,0,18,18
Warrington,Woolston Brook School,58,0,58,58
Cheshire West and Chester,Greenbank School,116,0,116,116
Cheshire West and Chester,Oaklands School,171,0,171,171
Cheshire West and Chester,Hebden Green Community School,133,1,132,133
Cheshire East,Springfield School,213,0,213,213
Cheshire East,Park Lane School,116,0,116,116
Cheshire West and Chester,Hinderton School,48,0,48,48
Cheshire West and Chester,Dorin Park School & Specialist SEN College,142,0,142,142
Cheshire West and Chester,Rosebank School,52,0,52,52
Halton,Chesnut Lodge Special School,89,0,88,88
Halton,Ashley High School,116,0,116,116
Cheshire West and Chester,Archers Brook SEMH Residential School,83,0,83,83
Stockton-on-Tees,High Clarence Primary School,80,22,3,25
Stockton-on-Tees,Billingham South Community Primary School,436,84,28,112
Redcar and Cleveland,Lingdale Primary School,109,25,1,26
Redcar and Cleveland,Lockwood Primary School,186,16,2,18
Stockton-on-Tees,Mill Lane Primary School,227,80,11,91
Stockton-on-Tees,Bowesfield Primary School,283,55,4,59
Stockton-on-Tees,Whitehouse Primary School,365,47,17,64
Stockton-on-Tees,The Glebe Primary School,416,55,7,62
Stockton-on-Tees,Durham Lane Primary School,198,12,6,18
Middlesbrough,Beech Grove Primary School,457,65,12,77
Middlesbrough,Newport Primary School,362,42,3,45
Hartlepool,Golden Flatts Primary School,109,26,2,28
Middlesbrough,Newham Bridge Primary School,326,45,2,47
Middlesbrough,Acklam Whin Primary School,488,26,4,30
Middlesbrough,Breckon Hill Primary School,634,191,5,196
Hartlepool,Lynnfield Primary School,296,28,4,32
Hartlepool,Fens Primary School,468,36,2,38
Hartlepool,Kingsley Primary School,484,110,21,131
Hartlepool,Throston Primary School,459,68,2,70
Hartlepool,Clavering Primary School,379,67,3,70
Redcar and Cleveland,Hummersea Primary School,315,72,3,75
Middlesbrough,Berwick Hills Primary School,357,96,6,102
Middlesbrough,Park End Primary School,648,57,8,65
Redcar and Cleveland,Newcomen Primary School,385,69,3,72
Hartlepool,Rift House Primary School,268,56,5,61
Stockton-on-Tees,Oxbridge Lane Primary School,361,54,3,57
Stockton-on-Tees,Tilery Primary School,315,30,6,36
Hartlepool,Grange Primary School,398,47,12,59
Redcar and Cleveland,Belmont Primary School,412,39,3,42
Stockton-on-Tees,"Prior's Mill Church of England Controlled Primary School, Billingham",511,39,7,46
Stockton-on-Tees,St John the Baptist Church of England Voluntary Controlled Primary School,321,27,32,59
Stockton-on-Tees,William Cassidi Church of England Aided Primary School,160,10,2,12
Stockton-on-Tees,Northfield School and Sports College,1484,147,36,183
Hartlepool,High Tunstall College of Science,1352,258,72,330
Stockton-on-Tees,Red House School,338,64,0,64
Stockton-on-Tees,Teesside High School,307,50,3,53
Stockton-on-Tees,Yarm School,795,182,1,183
Stockton-on-Tees,Yarm Preparatory School,394,14,0,14
Middlesbrough,Beverley School,160,6,154,160
Middlesbrough,Holmwood School,94,0,94,94
Redcar and Cleveland,Kirkleatham Hall School,183,13,170,183
Cornwall,Camborne Nursery School,73,31,3,34
Cornwall,Truro Nursery School,90,15,2,17
Cornwall,Trythall Community Primary School,67,12,1,13
Cornwall,Marazion School,123,18,2,20
Cornwall,Heamoor Community Primary School,190,15,12,27
Cornwall,St Ives Junior School,241,34,2,36
Cornwall,St Levan Primary School,39,4,1,5
Cornwall,Germoe Community Primary School,66,24,0,24
Cornwall,Mylor Community Primary School,142,22,4,26
Cornwall,Boskenwyn Community Primary School,93,31,2,33
Cornwall,St Day and Carharrack Community School,156,26,9,35
Cornwall,Treleigh Community Primary School,312,20,8,28
Cornwall,Gwinear Community Primary School,108,21,2,23
Cornwall,Penpol School,406,50,12,62
Cornwall,Stithians Community Primary School,173,18,4,22
Cornwall,Kea Community Primary School,204,32,1,33
Cornwall,Perran-Ar-Worthal Community Primary School,161,12,2,14
Cornwall,Goonhavern Primary School,205,24,1,25
Cornwall,St Erme with Trispen Community Primary School,148,20,3,23
Cornwall,Devoran School,198,23,0,23
Cornwall,Bosvigo School,318,40,10,50
Cornwall,Cubert School,188,23,2,25
Cornwall,Gorran School,113,16,0,16
Cornwall,Nanpean Community Primary School,156,23,3,26
Cornwall,St Wenn School,65,2,1,3
Cornwall,Port Isaac Community Primary School,60,8,0,8
Cornwall,Nanstallon Community Primary School,116,11,2,13
Cornwall,Boscastle Community Primary School,59,8,1,9
Cornwall,Kilkhampton Junior and Infant School,150,11,6,17
Cornwall,Trekenner Community Primary School,57,9,3,12
Cornwall,Whitstone Primary School,99,8,0,8
Cornwall,South Petherwin Community Primary School,114,17,2,19
Cornwall,Tregadillett Primary School,187,37,2,39
Cornwall,Calstock Community Primary School,64,12,0,12
Cornwall,Fourlanesend Community Primary School,90,7,2,9
Cornwall,Pensilva Primary School,107,22,0,22
Cornwall,St Neot Community Primary School,96,3,1,4
Cornwall,St Stephens (Saltash) Community Primary School,389,60,14,74
Cornwall,Stoke Climsland School,197,28,4,32
Cornwall,Torpoint Nursery and Infant School,235,40,2,42
Cornwall,Carbeile Junior School,336,53,7,60
Cornwall,Burraton Community Primary School,395,44,27,71
Cornwall,Menheniot Primary School,161,21,0,21
Cornwall,Marlborough School,210,15,3,18
Cornwall,St Germans Primary School,78,13,3,16
Cornwall,Stratton Primary School,384,56,8,64
Cornwall,Flushing School,95,14,1,15
Cornwall,"St Mary's CofE School, Truro",207,30,5,35
Cornwall,Madron Daniel CofE (VA) School,39,12,0,12
Cornwall,"St Mary's CofE Primary School, Penzance",133,19,1,20
Cornwall,Mawnan CofE VA Primary School,135,10,3,13
Cornwall,Bishop Cornish CofE VA Primary School,194,33,6,39
Cornwall,Torpoint Community College,752,131,10,141
Cornwall,Budehaven Community School,1161,159,21,180
Cornwall,Redruth School,1452,306,45,351
Cornwall,Richard Lander School,1508,207,53,260
Cornwall,Humphry Davy School,809,190,16,206
Cornwall,St Josephs School,248,43,1,44
Cornwall,Polwhele House School,91,7,1,8
Cornwall,Truro School,829,238,0,238
Cornwall,Truro High School,403,61,0,61
Cornwall,Truro School Preparatory School,298,73,0,73
Cornwall,St Piran's School (Gb) Ltd,78,16,0,16
Cumbria,Cleator Moor Nursery School,37,1,0,1
Cumbria,Parkview Nursery School,49,7,0,7
Cumbria,Frizington Nursery School,42,6,0,6
Cumbria,Kendal Nursery School,79,0,2,2
Cumbria,Hindpool Nursery School,80,9,2,11
Cumbria,Gillford Centre,42,28,14,42
Cumbria,West Cumbria Learning Centre,26,21,5,26
Cumbria,Newbridge House PRU,44,26,18,44
Cumbria,Allonby Primary School,20,1,1,2
Cumbria,Alston Primary School,100,20,1,21
Cumbria,Armathwaite School,75,17,0,17
Cumbria,Bewcastle School,19,3,1,4
Cumbria,Blennerhasset School,69,13,2,15
Cumbria,Burgh by Sands School,108,3,2,5
Cumbria,Cummersdale School,104,8,2,10
Cumbria,Cumwhinton School,192,13,5,18
Cumbria,Great Orton Primary School,30,9,1,10
Cumbria,Greystoke Primary School,47,3,0,3
Cumbria,Holme St Cuthbert School,32,6,1,7
Cumbria,Irthington Village School,66,8,0,8
Cumbria,Kirkbride Primary School,87,8,3,11
Cumbria,Nenthead Primary School,20,3,1,4
Cumbria,Brunswick School,157,39,6,45
Cumbria,North Lakes School,198,39,15,54
Cumbria,Penruddock Primary School,53,7,2,9
Cumbria,Plumpton School,102,12,2,14
Cumbria,Skelton School,82,7,0,7
Cumbria,Stoneraise School,156,9,2,11
Cumbria,Thursby Primary School,116,8,3,11
Cumbria,Thomlinson Junior School,235,28,12,40
Cumbria,Wigton Nursery and Infant School,191,17,11,28
Cumbria,Richmond Hill School,188,23,4,27
Cumbria,Broughton Moor Primary School,72,2,2,4
Cumbria,Grasslot Infant School,84,28,4,32
Cumbria,Ewanrigg Junior School,122,18,5,23
Cumbria,Netherton Infant School,67,10,0,10
Cumbria,Oughterside Primary School,64,12,0,12
Cumbria,St Michael's Nursery and Infant School,65,7,4,11
Cumbria,Victoria Infant and Nursery School,312,37,10,47
Cumbria,Victoria Junior School,264,56,12,68
Cumbria,Ashfield Infant & Nursery School,208,9,6,15
Cumbria,Ashfield Junior School,254,28,11,39
Cumbria,Bookwell Primary School,208,15,6,21
Cumbria,Frizington Community Primary School,135,27,5,32
Cumbria,Haverigg Primary School,159,15,8,23
Cumbria,Lowca Community School,55,10,2,12
Cumbria,Millom Infant School,79,12,4,16
Cumbria,Black Combe Junior School,111,21,4,25
Cumbria,Moor Row Community Primary School,82,12,2,14
Cumbria,Moresby Primary School,113,14,4,18
Cumbria,Seascale Primary School,117,20,7,27
Cumbria,St Bees Village Primary School,193,12,7,19
Cumbria,Thwaites School,45,9,1,10
Cumbria,Bransty Primary School,226,39,12,51
Cumbria,Kells Infant School,117,12,5,17
Cumbria,Monkwray Junior School,107,16,6,22
Cumbria,Jericho Primary School,435,50,13,63
Cumbria,Bolton Primary School,65,10,0,10
Cumbria,Brough Community Primary School,79,6,1,7
Cumbria,Clifton Primary School,83,11,1,12
Cumbria,Holme Primary School,136,17,3,20
Cumbria,Kirkby Stephen Primary School,231,19,2,21
Cumbria,Kirkby Thore School,34,5,0,5
Cumbria,Long Marton School,88,11,2,13
Cumbria,Milburn School,9,1,0,1
Cumbria,Milnthorpe Primary School,178,14,2,16
Cumbria,Heron Hill Primary School,441,46,5,51
Cumbria,Goodly Dale Primary School,92,16,3,19
Cumbria,Chapel Street Infants and Nursery School,119,4,4,8
Cumbria,Lindal and Marton Primary School,65,5,5,10
Cumbria,Hawkshead Esthwaite Primary School,49,2,1,3
Cumbria,Croftlands Infant School,185,2,5,7
Cumbria,Croftlands Junior School,137,22,8,30
Cumbria,Brisbane Park Infant School,106,35,4,39
Cumbria,Greengate Junior School,161,39,21,60
Cumbria,Roose School,199,8,5,13
Cumbria,Ramsden Infant School,118,19,8,27
Cumbria,Victoria Infant and Nursery School,214,18,2,20
Cumbria,South Walney Junior School,194,40,7,47
Cumbria,South Walney Infant and Nursery School,191,27,2,29
Cumbria,Dane Ghyll Community Primary School and Nursery,275,20,9,29
Cumbria,Inglewood Junior School,248,41,16,57
Cumbria,Inglewood Infant School,238,29,16,45
Cumbria,Norman Street Primary School,329,8,6,14
Cumbria,Newlaithes Junior School,238,35,3,38
Cumbria,Newlaithes Infant School,215,27,4,31
Cumbria,Belle Vue Primary School,435,39,12,51
Cumbria,Kingmoor Junior School,332,37,7,44
Cumbria,Kingmoor Nursery and Infant School,289,46,11,57
Cumbria,Brook Street Primary School,207,18,2,20
Cumbria,Sir John Barrow School,223,34,16,50
Cumbria,Sedbergh Primary School,152,12,4,16
Cumbria,George Romney Junior School,94,13,3,16
Cumbria,Silloth Primary School,181,25,7,32
Cumbria,Barrow Island Community Primary School,141,35,8,43
Cumbria,Fellview Primary School,43,12,1,13
Cumbria,Derwent Vale Primary and Nursery School,93,14,7,21
Cumbria,North Walney Primary & Nursery School,24,0,2,2
Cumbria,Robert Ferguson Primary School,431,76,19,95
Cumbria,Upperby Primary School,376,18,16,34
Cumbria,Newbarns Primary & Nursery  School,440,79,14,93
Cumbria,Boltons CofE School,78,19,2,21
Cumbria,St Michael's CofE Primary School,202,25,4,29
Cumbria,High Hesket CofE School,158,16,4,20
Cumbria,Holm Cultram Abbey CofE School,55,10,0,10
Cumbria,Houghton CofE School,193,18,10,28
Cumbria,Ireby CofE School,31,1,0,1
Cumbria,Kirkbampton CofE School,107,12,0,12
Cumbria,Kirkoswald CofE School,63,0,0,0
Cumbria,Lanercost CofE Primary School,88,12,0,12
Cumbria,Langwathby CofE Primary School,144,18,1,19
Cumbria,Walton & Lees Hill CofE School,24,4,1,5
Cumbria,Raughton Head CofE School & Nursery,59,2,0,2
Cumbria,Rockcliffe CofE School,142,25,9,34
Cumbria,Shankhill CofE Primary School,47,6,0,6
Cumbria,Levens CofE School,94,7,2,9
Cumbria,Old Hutton CofE School,114,12,6,18
Cumbria,Staveley CofE School,97,18,4,22
Cumbria,Storth CofE School,96,25,5,30
Cumbria,Temple Sowerby CofE Primary School,47,5,2,7
Cumbria,Asby Endowed School,12,2,1,3
Cumbria,Vicarage Park CofE Primary School,101,15,1,16
Cumbria,Bridekirk Dovenby CofE Primary School,141,13,4,17
Cumbria,St Bridget's CofE School,89,9,3,12
Cumbria,All Saints' CofE School,203,37,20,57
Cumbria,Crosscanonby St John's CofE School,55,5,2,7
Cumbria,Maryport CofE Primary School,284,19,13,32
Cumbria,Plumbland CofE School,54,1,2,3
Cumbria,Seaton St. Paul's CofE Junior School,208,23,2,25
Cumbria,Coniston CofE Primary School,65,15,4,19
Cumbria,Grange CofE Primary School,175,17,1,18
Cumbria,Burlington CofE School,72,11,5,16
Cumbria,Allithwaite CofE Primary School,111,7,2,9
Cumbria,Cartmel CofE Primary School,60,9,4,13
Cumbria,Pennington CofE School,196,26,5,31
Cumbria,Lindale CofE Primary School,55,6,5,11
Cumbria,Broughton CofE Primary and Nursery School,135,23,0,23
Cumbria,St George's CofE School,253,48,16,64
Cumbria,Captain Shaw's CofE School,33,12,0,12
Cumbria,Ennerdale and Kinniside CofE Primary School,54,5,2,7
Cumbria,Gosforth CofE Primary School,115,12,1,13
Cumbria,St Bridget's CofE School,70,22,3,25
Cumbria,St James' CofE Infant and Nursery School,138,14,5,19
Cumbria,St James' CofE Junior School,160,20,4,24
Cumbria,Low Furness CofE Primary School,143,7,5,12
Cumbria,Blackford CofE Primary School,51,4,3,7
Cumbria,Calthwaite CofE School,68,7,3,10
Cumbria,Culgaith CofE School,40,4,3,7
Cumbria,Ivegill CofE School,84,16,0,16
Cumbria,St Catherine's Catholic Primary School,111,17,4,21
Cumbria,Rosley CofE School,61,6,0,6
Cumbria,Stainton CofE Primary School,130,9,4,13
Cumbria,St Matthew's CofE School,56,7,0,7
Cumbria,Wiggonby CofE School,76,16,1,17
Cumbria,St Cuthbert's Catholic Primary School,115,24,3,27
Cumbria,Beetham CofE Primary School,52,13,0,13
Cumbria,St Oswald's CofE Primary School,90,11,1,12
Cumbria,Crosby Ravensworth CofE School,23,5,0,5
Cumbria,Crosscrake CofE Primary School,63,13,1,14
Cumbria,Crosthwaite CofE School,96,17,1,18
Cumbria,St Patrick's CofE School,84,6,3,9
Cumbria,Grasmere CofE Primary School,83,13,2,15
Cumbria,Grayrigg CofE School,91,24,3,27
Cumbria,Langdale CofE School,25,7,3,10
Cumbria,St Thomas's CofE Primary School,227,40,6,46
Cumbria,St Mary's CofE Primary School,235,32,5,37
Cumbria,Morland Area CofE Primary School,113,7,2,9
Cumbria,St Mark's CofE Primary School,161,18,4,22
Cumbria,Patterdale CofE Primary School,35,4,1,5
Cumbria,Selside Endowed CofE Primary School,38,5,1,6
Cumbria,Shap Endowed CofE Primary School,93,15,3,18
Cumbria,Dent CofE Voluntary Aided Primary School,41,8,2,10
Cumbria,St Michael's CofE Primary School,51,5,3,8
Cumbria,Borrowdale CofE Primary School,29,9,1,10
Cumbria,St Mary's Catholic Primary School,204,27,6,33
Cumbria,St Patrick's Catholic Primary School,201,20,6,26
Cumbria,Lowther Endowed School,55,3,0,3
Cumbria,Dean Barwick Primary School,62,25,2,27
Cumbria,Beckermet CofE School,73,18,2,20
Cumbria,St Bridget's Catholic Primary School,207,35,3,38
Cumbria,St Bega's CofE Primary School,25,5,1,6
Cumbria,St Joseph's Catholic Primary School,44,12,5,17
Cumbria,St James' Catholic Primary School,178,23,13,36
Cumbria,Waberthwaite CofE School,57,10,2,12
Cumbria,St Mary's Catholic Primary School,197,15,5,20
Cumbria,St Begh's Catholic Junior School,242,12,15,27
Cumbria,St Gregory and St Patrick's Catholic Infant School,278,31,6,37
Cumbria,Leven Valley CofE Primary School,67,8,0,8
Cumbria,Church Walk CofE Primary School,99,20,2,22
Cumbria,St James' CofE Junior School,123,13,5,18
Cumbria,St Columba's School,204,29,10,39
Cumbria,Holy Family Catholic Primary School,224,6,7,13
Cumbria,St Bede's Catholic Primary School,230,40,10,50
Cumbria,Warcop CofE Primary School,81,6,6,12
Cumbria,Beacon Hill Community School,147,56,9,65
Cumbria,Solway Community School,137,55,9,64
Cumbria,Samuel King's School,81,21,3,24
Cumbria,The Lakes School,469,41,9,50
Cumbria,Netherhall School,794,56,28,84
Cumbria,Dowdales School,797,87,22,109
Cumbria,John Ruskin School,241,41,21,62
Cumbria,Ulverston Victoria High School,1339,158,35,193
Cumbria,Millom School,503,65,25,90
Cumbria,Ullswater Community College,1520,193,60,253
Cumbria,The Nelson Thomlinson School,1219,130,25,155
Cumbria,St Benedict's Catholic High School,1086,77,52,129
Cumbria,St John Henry Newman Catholic School,644,75,17,92
Cumbria,Hayton CofE Primary School,134,17,2,19
Cumbria,Scotby CofE Primary School,246,49,4,53
Cumbria,Warwick Bridge Primary School,161,18,2,20
Cumbria,Brampton Primary School,209,17,11,28
Cumbria,St Paul's CofE Junior School,68,22,4,26
Cumbria,Appleby Primary School,193,29,10,39
Cumbria,Askam Village School,167,14,4,18
Cumbria,Flookburgh CofE Primary School,72,4,2,6
Cumbria,Dalton St Mary's CofE Primary School,228,37,5,42
Cumbria,Bowness-on-Solway Primary School,47,8,0,8
Cumbria,Ireleth St Peter's CofE Primary School,73,11,3,14
Cumbria,Hallbankgate Village School,58,6,2,8
Cumbria,Orton CofE School,55,11,0,11
Cumbria,Fir Ends Primary School,104,18,1,19
Cumbria,Beaconside CofE Primary School,480,50,18,68
Cumbria,Lime House School,169,11,2,13
Cumbria,"Casterton, Sedbergh Preparatory School",195,32,0,32
Cumbria,Windermere School,328,64,4,68
Cumbria,Sedbergh School,580,183,1,184
Cumbria,Oversands School,59,3,56,59
Cumbria,Austin Friars,361,73,4,77
North Yorkshire,Cedar House School,88,9,79,88
Cumbria,Hunter Hall School,101,12,1,13
Cumbria,Underley Garden School,78,1,77,78
Cumbria,Mayfield School,218,0,218,218
Cumbria,Sandgate School,118,4,114,118
Cumbria,Sandside Lodge School,84,0,84,84
Derbyshire,Hadfield Nursery School,102,38,0,38
Derbyshire,Gamesley Early Excellence Centre,51,13,0,13
Derby,Lord Street Nursery School,68,11,1,12
Derby,Central Community Nursery School,77,22,3,25
Derby,Harrington Nursery School,73,16,0,16
Derby,Walbrook Nursery School,85,19,0,19
Derby,Stonehill Nursery School,84,12,0,12
Derbyshire,New Mills Nursery School,46,3,0,3
Derbyshire,Ripley Nursery School,113,6,2,8
Derby,Ashgate Nursery School,64,25,0,25
Derby,Whitecross Nursery School,77,1,0,1
Derbyshire,Flagg Nursery School,56,6,0,6
Derbyshire,Pinxton Nursery School,67,2,1,3
Derbyshire,South Normanton Nursery School,78,9,0,9
Derbyshire,Alfreton Nursery School,98,33,0,33
Derbyshire,Leys Junior School,185,41,7,48
Derbyshire,Croft Infant School,154,60,6,66
Derbyshire,Woodbridge Junior School,220,60,4,64
Derbyshire,Riddings Infant and Nursery School,219,60,3,63
Derbyshire,Swanwick Primary School,398,58,7,65
Derbyshire,Ashover Primary School,220,20,3,23
Derbyshire,Aston-on-Trent Primary School,189,22,0,22
Derbyshire,Bramley Vale Primary School,152,49,1,50
Derbyshire,Bamford Primary School,69,21,0,21
Derbyshire,Barlborough Primary School,203,27,3,30
Derbyshire,Blackwell Community Primary and Nursery School,121,21,1,22
Derbyshire,Newton Primary School,139,18,1,19
Derbyshire,Westhouses Primary School,67,26,0,26
Derbyshire,New Bolsover Primary and Nursery School,269,57,4,61
Derbyshire,Brockley Primary School,133,27,3,30
Derbyshire,Bolsover Infant School,231,47,0,47
Derbyshire,Bradwell Junior School,42,10,0,10
Derbyshire,Cutthorpe Primary School,104,12,2,14
Derbyshire,Wigley Primary School,50,11,0,11
Derbyshire,Brassington Primary School,46,9,1,10
Derbyshire,Firfield Primary School,403,42,8,50
Derbyshire,Henry Bradley Infant School,164,29,2,31
Derbyshire,Burbage Primary School,348,39,4,43
Derbyshire,Buxton Junior School,238,58,5,63
Derbyshire,Buxton Infant School,160,23,2,25
Derbyshire,Harpur Hill Primary School,287,48,6,54
Derbyshire,Combs Infant School,35,3,0,3
Derbyshire,Buxworth Primary School,104,8,1,9
Derbyshire,Chinley Primary School,246,93,3,96
Derbyshire,Holmgate Primary School and Nursery,248,35,1,36
Derbyshire,Clowne Junior School,353,66,3,69
Derbyshire,Clowne Infant and Nursery School,300,27,3,30
Derbyshire,Crich Junior School,77,45,0,45
Derbyshire,Curbar Primary School,74,4,0,4
Derbyshire,Lea Primary School,136,12,1,13
Derbyshire,Doveridge Primary School,75,8,0,8
Derbyshire,Draycott Community Primary School,165,15,2,17
Derbyshire,Dronfield Junior School,351,64,2,66
Derbyshire,Dronfield Infant School,240,12,0,12
Derbyshire,William Levick Primary School,205,25,2,27
Derbyshire,Birk Hill Infant & Nursery School,110,17,0,17
Derbyshire,Marsh Lane Primary School,143,23,2,25
Derbyshire,Renishaw Primary School,211,41,0,41
Derbyshire,Ridgeway Primary School,189,28,1,29
Derbyshire,Egginton Primary School,60,14,0,14
Derbyshire,Creswell Junior School,256,60,5,65
Derbyshire,Etwall Primary School,313,46,2,48
Derbyshire,Grindleford Primary School,57,14,1,15
Derbyshire,Findern Primary School,207,23,2,25
Derbyshire,Padfield Community Primary School,115,24,2,26
Derbyshire,Grassmoor Primary School,247,85,3,88
Derbyshire,Hayfield Primary School,198,16,1,17
Derbyshire,Marlpool Junior School,120,18,3,21
Derbyshire,Marlpool Infant School,49,7,0,7
Derbyshire,Coppice Primary School,239,114,8,122
Derbyshire,Penny Acres Primary School,55,5,0,5
Derbyshire,Hope Primary School,53,11,1,12
Derbyshire,Cotmanhay Junior School,296,84,9,93
Derbyshire,Cotmanhay Infant and Nursery School,275,67,4,71
Derbyshire,Granby Junior School,316,44,6,50
Derbyshire,Hallam Fields Junior School,221,52,2,54
Derbyshire,Charlotte Nursery and Infant School,297,55,0,55
Derbyshire,Kilburn Infant and Nursery School,126,15,0,15
Derbyshire,Killamarsh Junior School,124,51,1,52
Derbyshire,Killamarsh Infant School,148,34,1,35
Derbyshire,Little Eaton Primary School,218,22,2,24
Derbyshire,Harrington Junior School,232,37,0,37
Derbyshire,Parklands Infant and Nursery School,212,15,2,17
Derbyshire,Grange Primary School,432,103,5,108
Derbyshire,Longmoor Primary School,425,57,7,64
Derbyshire,Marston Montgomery Primary School,31,4,0,4
Derbyshire,Darley Dale Primary School,202,15,1,16
Derbyshire,Tansley Primary School,83,16,0,16
Derbyshire,Melbourne Junior School,259,26,6,32
Derbyshire,Melbourne Infant School,175,6,3,9
Derbyshire,Morley Primary School,80,6,0,6
Derbyshire,Morton Primary School,106,5,1,6
Derbyshire,New Mills Primary School,210,49,0,49
Derbyshire,Newtown Primary School (High Peak Federation),83,12,1,13
Derbyshire,Thornsett Primary School (High Peak Federation),80,24,0,24
Derbyshire,Overseal Primary School,207,28,2,30
Derbyshire,Parwich Primary School,20,4,0,4
Derbyshire,Pilsley Primary School,217,44,11,55
Derbyshire,Park House Primary School,203,28,3,31
Derbyshire,Anthony Bek Community Primary School,231,46,1,47
Derbyshire,Ripley Junior School,330,42,10,52
Derbyshire,Ripley Infant School,169,19,2,21
Derbyshire,Ladycross Infant School,239,8,4,12
Derbyshire,Scarcliffe Primary School,92,8,0,8
Derbyshire,Palterton Primary School,98,13,3,16
Derbyshire,Brookfield Primary School,167,57,5,62
Derbyshire,Shirland Primary School,166,28,3,31
Derbyshire,Stonebroom Primary and Nursery School,218,40,1,41
Derbyshire,The Brigg Infant School,177,26,5,31
Derbyshire,Glebe Junior School,391,105,6,111
Derbyshire,South Wingfield Primary School,137,25,3,28
Derbyshire,Staveley Junior School,149,33,7,40
Derbyshire,Speedwell Infant School,140,22,0,22
Derbyshire,Duckmanton Primary School,185,42,3,45
Derbyshire,Sudbury Primary School,53,8,2,10
Derbyshire,Arkwright Primary School,106,19,4,23
Derbyshire,Newhall Community Junior School,298,71,5,76
Derbyshire,Newhall Infant School,221,36,2,38
Derbyshire,Stanton Primary School,157,14,1,15
Derbyshire,Town End Junior School,173,29,3,32
Derbyshire,Tibshelf Infant School,186,19,2,21
Derbyshire,Unstone Junior School,49,22,0,22
Derbyshire,Unstone St Mary's Infant School,42,11,0,11
Derbyshire,Wessington Primary School,89,7,4,11
Derbyshire,Whaley Bridge Primary School,129,23,15,38
Derbyshire,Furness Vale Primary and Nursery School,94,2,5,7
Derbyshire,Whitwell Primary School,265,44,4,48
Derbyshire,Deer Park Primary School,345,14,5,19
Derbyshire,Wirksworth Junior School,125,30,1,31
Derbyshire,Wirksworth Infant School,19,1,1,2
Derbyshire,Middleton Community Primary School,94,26,1,27
Derbyshire,Woodville Infant School,243,22,4,26
Derbyshire,Peak Dale Primary School,76,16,2,18
Derbyshire,Cavendish Junior School,94,15,0,15
Derbyshire,Spire Nursery and Infant School,210,38,1,39
Derbyshire,Spire Junior School,186,38,2,40
Derbyshire,Hasland Junior School,379,36,3,39
Derbyshire,Hasland Infant School,341,29,1,30
Derbyshire,Hady Primary School,334,27,4,31
Derbyshire,Highfield Hall Primary School,432,47,8,55
Derbyshire,Abercrombie Primary School,240,35,6,41
Derbyshire,The Park Infant & Nursery School,215,31,0,31
Derbyshire,Brockwell Nursery and Infant School,212,13,0,13
Derbyshire,Dallimore Primary & Nursery School,380,63,3,66
Derbyshire,Mickley Village Primary & Nursery School,43,11,0,11
Derbyshire,Eureka Primary School,140,34,3,37
Derbyshire,Ashbourne Primary School,208,40,4,44
Derbyshire,Heath Fields Primary School,214,41,4,45
Derbyshire,Holmesdale Infant School,147,13,1,14
Derbyshire,The Park Junior School,274,46,6,52
Derbyshire,Northfield Junior School,177,21,3,24
Derbyshire,Ashbourne Hilltop Primary and Nursery School,138,18,3,21
Derbyshire,Copthorne Community Infant School,104,15,3,18
Derbyshire,Ashbrook Infant School,161,26,1,27
Derbyshire,Duffield the Meadows Primary School,319,36,3,39
Derbyshire,Brockwell Junior School,245,37,1,38
Derbyshire,Hadfield Infant School,143,25,0,25
Derbyshire,Lenthall Infant and Nursery School,74,9,0,9
Derbyshire,Hunloke Park Primary School,276,40,6,46
Derbyshire,Dronfield Stonelow Junior School,147,17,2,19
Derbyshire,Fairfield Infant and Nursery School,204,27,0,27
Derbyshire,Willington Primary School,212,37,2,39
Derbyshire,Norbriggs Primary School,189,52,3,55
Derbyshire,Simmondley Primary School,303,22,3,25
Derbyshire,Larklands Infant School,162,31,0,31
Derbyshire,Lons Infant School,78,6,6,12
Derby,Becket Primary School,245,35,7,42
Derby,Dale Community Primary School,549,38,16,54
Derby,Pear Tree Infant School,267,33,2,35
Derby,Rosehill Infant and Nursery School,189,16,1,17
Derby,Markeaton Primary School,418,43,25,68
Derby,Portway Infant School,190,24,0,24
Derby,Alvaston Infant and Nursery School,324,42,8,50
Derby,Shelton Infant School,223,27,7,34
Derby,Cavendish Close Infant School,253,60,3,63
Derby,Meadow Farm Community Primary School,164,19,4,23
Derby,Gayton Junior School,363,60,17,77
Derby,Ridgeway Infant School,270,55,15,70
Derby,Wren Park Primary School,384,44,12,56
Derby,Ravensdale Infant and Nursery School,283,83,1,84
Derby,Silverhill Primary School,421,48,11,59
Derby,Oakwood Infant and Nursery School,311,71,7,78
Derby,Redwood Primary School,651,62,18,80
Derbyshire,Heage Primary School,173,22,12,34
Derbyshire,Stenson Fields Primary Community School,355,36,9,45
Derbyshire,Long Row Primary School,251,18,3,21
Derbyshire,Ambergate Primary School,79,10,2,12
Derbyshire,Pottery Primary School,318,39,3,42
Derbyshire,Milford Primary School,99,22,2,24
Derbyshire,Herbert Strutt Primary School,192,41,1,42
Derby,Mickleover Primary School,428,63,7,70
Derbyshire,St Oswald's CofE Primary School,205,27,0,27
Derbyshire,Barlow CofE Primary School,85,17,0,17
Derbyshire,St Anne's CofE Primary School,125,19,1,20
Derbyshire,Bradley CofE Primary School,27,9,4,13
Derbyshire,Bradwell CofE (Controlled) Infant School,36,5,0,5
Derbyshire,Brailsford CofE Primary School,146,28,4,32
Derbyshire,Breadsall CofE VC Primary School,116,9,3,12
Derbyshire,Fairfield Endowed CofE (C) Junior School,199,38,20,58
Derbyshire,Castleton CofE Primary School,22,5,0,5
Derbyshire,Dove Holes CofE Primary School,47,13,0,13
Derbyshire,Clifton CofE Primary School,100,14,1,15
Derbyshire,Coton-in-the-Elms Cof E Primary School,139,21,0,21
Derbyshire,Edale CofE Primary School,22,4,0,4
Derbyshire,Creswell CofE Controlled Infant and Nursery,257,57,6,63
Derbyshire,Elton CofE Primary School,25,9,5,14
Derbyshire,Eyam CofE Primary School,64,20,0,20
Derbyshire,St Luke's CofE Primary School,213,11,8,19
Derbyshire,Whitfield St James' CofE (VC) Primary School,303,41,9,50
Derbyshire,Great Hucklow CE Primary,26,13,0,13
Derbyshire,Rowsley CofE (Controlled) Primary School,58,12,2,14
Derbyshire,Earl Sterndale CofE Primary School,33,9,0,9
Derbyshire,Biggin CofE Primary School,19,1,1,2
Derbyshire,Hartington CofE Primary School,23,9,1,10
Derbyshire,Hartshorne CofE Primary School,112,17,4,21
Derbyshire,Corfield CofE Infant School,86,16,1,17
Derbyshire,Langley Mill Church of England Infant School and Nursery,130,27,4,31
Derbyshire,Mundy CofE Junior School,184,44,3,47
Derbyshire,Horsley CofE (Controlled) Primary School,89,11,0,11
Derbyshire,Hulland CofE Primary School,56,5,2,7
Derbyshire,Kirk Ireton C of E Primary School,40,10,1,11
Derbyshire,Kirk Langley CofE Primary School,95,1,0,1
Derbyshire,Kniveton CofE Primary School,55,11,1,12
Derbyshire,Mapperley CofE Controlled Primary School,65,4,1,5
Derbyshire,Cromford Church of England Primary School,68,18,3,21
Derbyshire,Matlock Bath Holy Trinity CofE Controlled Primary School,45,8,0,8
Derbyshire,South Darley CofE Primary School,55,7,0,7
Derbyshire,Monyash CofE Primary School,40,12,0,12
Derbyshire,Netherseal St Peter's CofE (C) Primary School,57,9,0,9
Derbyshire,Norbury CofE Primary School,74,24,3,27
Derbyshire,Long Lane Church of England Primary School,28,3,0,3
Derbyshire,Osmaston CofE (VC) Primary School,154,16,1,17
Derbyshire,Peak Forest Church of England Voluntary Controlled Primary School,29,4,0,4
Derbyshire,Ripley St John's Church of England Primary School and Nursery,358,108,4,112
Derbyshire,Risley Lower Grammar CE (VC) Primary School,109,25,0,25
Derbyshire,Rosliston CofE Primary School,67,1,0,1
Derbyshire,St Andrew's CofE Primary School,94,13,1,14
Derbyshire,Stanley Common CofE Primary School,57,10,0,10
Derbyshire,Stanton-in-Peak CofE Primary School,62,5,1,6
Derbyshire,Stoney Middleton CofE (C) Primary School,11,8,0,8
Derbyshire,Stretton Handley Church of England Primary School,51,13,0,13
Derbyshire,Mugginton CofE Primary School,51,6,0,6
Derbyshire,Winster CofE Primary School,23,4,0,4
Derbyshire,Wirksworth CofE Infant School,41,3,1,4
Derbyshire,Woodville CofE Junior School,318,54,9,63
Derbyshire,Crich Carr CofE Primary School,39,5,2,7
Derbyshire,Crich Church of England Infant School,59,7,0,7
Derbyshire,Duke of Norfolk CofE Primary School,315,33,6,39
Derbyshire,St Andrew's CofE Junior School,230,45,4,49
Derbyshire,Bakewell Methodist Junior School,68,14,1,15
Derbyshire,Church Broughton CofE Primary School,75,3,4,7
Derbyshire,Taxal and Fernilee CofE Primary School,216,29,3,32
Derbyshire,St John's CofE Primary School and Nursery,428,50,4,54
Derbyshire,Calow CofE VC Primary School,170,25,6,31
Derbyshire,Charlesworth Voluntary Controlled Primary School,110,11,3,14
Derbyshire,Carsington and Hopton Primary School,41,14,0,14
Derbyshire,Fritchley CofE (Aided) Primary & Nursery School,87,15,0,15
Derbyshire,Denby Free CofE VA Primary School,123,29,0,29
Derbyshire,Camms CofE (Aided) Primary School,224,28,1,29
Derbyshire,Fitzherbert CofE (Aided) Primary School,61,10,0,10
Derbyshire,Dinting Church of England Voluntary Aided Primary School,137,11,0,11
Derbyshire,Hathersage St Michael's CofE (Aided) Primary School,148,11,0,11
Derbyshire,Litton CofE Primary School,47,11,1,12
Derbyshire,Longstone CofE Primary School,104,15,1,16
Derbyshire,Bonsall CofE (A) Primary School,53,23,1,24
Derbyshire,Newton Solney CofE (Aided) Infant School,40,10,0,10
Derbyshire,Pilsley CofE Primary School,76,8,1,9
Derbyshire,Taddington and Priestcliffe School,59,8,1,9
Derbyshire,Weston-on-Trent CofE (VA) Primary School,149,38,4,42
Derbyshire,St Mary's Catholic Primary,420,39,7,46
Derbyshire,St Andrew's CofE Methodist (Aided) Primary School,218,16,2,18
Derby,St James' Church of England Aided Infant School,110,17,8,25
Derbyshire,Tintwistle CofE (Aided) Primary School,120,15,2,17
Derbyshire,"Youlgrave, All Saints' CofE (VA) Primary School",67,8,0,8
Derbyshire,Chapel-en-le-Frith High School,931,117,62,179
Derbyshire,New Mills School,670,153,13,166
Derbyshire,Tibshelf Community School,809,157,36,193
Derby,The Bemrose School,1304,195,56,251
Derby,Littleover Community School,1828,146,29,175
Derbyshire,Whittington Green School,537,107,10,117
Derbyshire,Parkside Community School,585,119,18,137
Derbyshire,Anthony Gell School,858,143,27,170
Derbyshire,Dronfield Henry Fanshawe School,1868,181,45,226
Derbyshire,Buxton Community School,1055,97,19,116
Derbyshire,Belmont Primary School,392,66,4,70
Derbyshire,Repton Primary School,206,7,3,10
Derbyshire,Linton Primary School,288,52,2,54
Derbyshire,The Curzon CofE Primary School,128,26,0,26
Derbyshire,Fairmeadows Foundation Primary School,235,56,11,67
Derby,Shelton Junior School,286,47,12,59
Derbyshire,Belper School and Sixth Form Centre,1182,114,28,142
Derby,Murray Park Community School,1107,248,23,271
Derbyshire,Lady Manners School,1386,53,20,73
Derbyshire,St Anselm's School,150,22,0,22
Derbyshire,Abbotsholme School,284,45,8,53
Derbyshire,Trent College,1252,184,1,185
Derbyshire,St Wystan's School,73,8,0,8
Derbyshire,Repton School,631,125,0,125
Derbyshire,Mount St Mary's College,347,88,7,95
Derby,Old Vicarage School,117,6,1,7
Derbyshire,St Peter and St Paul School,116,23,1,24
Derby,Derby High School,640,63,0,63
Derbyshire,Barlborough Hall School,206,14,1,15
Derbyshire,Bladon House School,45,0,44,44
Derbyshire,Alderwasley Hall School,123,0,123,123
Derbyshire,Repton Preparatory School,413,66,4,70
Derbyshire,Dame Catherine Harpur's School,34,16,0,16
Derby,Emmanuel School (Derby) Limited,61,14,0,14
Derbyshire,Eastwood Grange School,41,0,41,41
Derby,Derby Grammar School,223,35,0,35
Derbyshire,Brackenfield Special School,161,3,158,161
Derbyshire,Swanwick School and Sports College,96,0,96,96
Derbyshire,Alfreton Park Community Special School,123,0,123,123
Derby,Royal School for the Deaf Derby,103,1,102,103
Devon,Chestnut Nursery,69,2,0,2
Plymouth,Ham Drive Nursery School and Day Care,88,9,0,9
Plymouth,Plym Bridge Nursery and Day Care,48,17,1,18
Devon,Bow Community Primary School,111,9,10,19
Devon,Cheriton Fitzpaine Primary School,99,10,2,12
Devon,Clyst Hydon Primary School,18,2,0,2
Devon,Clyst St Mary Primary School,176,27,8,35
Devon,Copplestone Primary School,143,10,10,20
Devon,Hayward's Primary School,404,84,16,100
Devon,Culmstock Primary School,140,27,8,35
Devon,Countess Wear Community School,252,58,17,75
Devon,Ladysmith Infant & Nursery School,330,21,5,26
Devon,Ladysmith Junior School,344,55,16,71
Devon,Montgomery Primary School,399,57,13,70
Devon,Newtown Primary School,131,22,5,27
Devon,Stoke Hill Infant and Nursery School,279,25,7,32
Devon,Stoke Hill Junior School,354,53,14,67
Devon,Exeter Road Community Primary School,239,48,13,61
Devon,Marpool Primary School,402,73,19,92
Devon,Honiton Primary School,408,44,19,63
Devon,Kilmington Primary School,77,7,3,10
Devon,Newton Poppleford Primary School,184,18,9,27
Devon,Newton St Cyres Primary School,129,9,2,11
Devon,Ottery St Mary Primary School,419,120,12,132
Devon,West Hill Primary School,205,10,5,15
Devon,Sandford School,106,14,8,22
Devon,Seaton Primary School,373,42,14,56
Devon,Shute Community Primary School,83,3,1,4
Devon,Upottery Primary School,90,14,3,17
Devon,Whimple Primary School,126,9,2,11
Devon,Willand School,383,59,16,75
Devon,Landscore Primary School,266,24,6,30
Devon,Bassetts Farm Primary School,412,67,14,81
Devon,Spreyton School,20,4,1,5
Devon,Appledore School,246,14,4,18
Devon,Ashwater Primary School,34,4,0,4
Devon,Pilton Infants' School,170,13,3,16
Devon,East-the-Water Community Primary School,449,56,22,78
Devon,West Croft School,561,71,14,85
Devon,Bishops Nympton Primary School,83,12,3,15
Devon,Bishops Tawton Primary School,164,8,1,9
Devon,Caen Community Primary School,412,74,7,81
Devon,Southmead School,383,78,14,92
Devon,Buckland Brewer Primary School,64,5,1,6
Devon,East Anstey Primary School,28,3,0,3
Devon,Filleigh Community Primary School,88,4,3,7
Devon,Halwill Community Primary School,89,9,0,9
Devon,Hartland Primary School,122,14,3,17
Devon,Horwood and Newton Tracey Community Primary School,107,20,1,21
Devon,Ilfracombe Infant and Nursery School,263,57,8,65
Devon,Instow Community Primary and Pre-School,142,19,4,23
Devon,Kentisbury Primary School,41,4,0,4
Devon,Kings Nympton Community Primary School,29,3,0,3
Devon,Langtree Community School and Nursery Unit,90,11,1,12
Devon,Marwood School,104,9,1,10
Devon,Monkleigh Primary School,124,27,4,31
Devon,Parkham Primary School,63,14,1,15
Devon,St Giles-on-the-Heath Community School,92,9,0,9
Devon,Shebbear Community School,74,11,1,12
Devon,Shirwell Community Primary School,48,11,3,14
Devon,South Molton Community Primary School,247,51,7,58
Devon,West Down School,115,21,3,24
Devon,Winkleigh Primary School,212,29,2,31
Devon,Woolsery Primary School,121,16,4,20
Devon,Kingsacre Primary School,200,24,5,29
Devon,Abbotskerswell Primary School,110,9,0,9
Devon,Bishopsteignton School,195,29,10,39
Devon,Bovey Tracey Primary School,258,32,6,38
Devon,Denbury Primary School,93,12,3,15
Devon,Doddiscombsleigh Primary  School,36,5,2,7
Devon,Exminster Community Primary,424,75,15,90
Devon,Ipplepen Primary School,178,43,6,49
Devon,Kingsbridge Community Primary School,373,44,11,55
Devon,Loddiswell Primary School,98,15,2,17
Devon,Decoy Primary School,424,82,6,88
Devon,Highweek Community Primary and Nursery School,320,75,11,86
Torbay,White Rock Primary School,714,95,19,114
Devon,Stokeinteignhead School,104,19,4,23
Devon,Stokenham Area Primary School,210,15,3,18
Devon,Hazeldown School,420,28,12,40
Torbay,Homelands Primary School,225,21,5,26
Torbay,Watcombe Primary School,230,33,17,50
Devon,The Grove School,307,46,9,55
Torbay,Sherwell Valley Primary School,681,65,13,78
Devon,Bradley Barton Primary School and Nursery Unit,456,88,17,105
Devon,Canada Hill Community Primary School,339,39,14,53
Devon,Gulworthy Primary School,69,5,3,8
Devon,Hatherleigh Community Primary School,184,29,7,36
Devon,Horrabridge Primary & Nursery School,204,16,12,28
Devon,The Erme Primary School,99,11,6,17
Devon,Milton Abbot School,58,8,7,15
Devon,Shaugh Prior Primary School,28,8,4,12
Devon,Mary Tavy and Brentor Community Primary School,67,11,0,11
Devon,Tavistock  Primary & Nursery School,387,67,17,84
Plymouth,College Road Primary School,205,34,5,39
Plymouth,Laira Green Primary School,235,47,6,53
Plymouth,Pennycross Primary School,394,48,7,55
Plymouth,Lipson Vale Primary School,405,64,9,73
Plymouth,Yealmpstone Farm Primary School,223,35,10,45
Devon,Modbury Primary School,169,18,2,20
Devon,Halberton Primary School,105,19,3,22
Devon,Castle Primary School,314,38,21,59
Devon,Two Moors Primary School,413,62,12,74
Devon,Heathcoat Primary School,376,57,17,74
Devon,Brampford Speke Church of England Primary School,57,4,1,5
Devon,Branscombe Church of England Primary School,24,6,2,8
Devon,Broadhembury Church of England Primary School,32,5,3,8
Devon,St Martin's CofE Primary & Nursery School,470,123,30,153
Devon,Withycombe Raleigh Church of England Primary School,606,115,23,138
Devon,Kentisbeare Church of England Primary School,152,24,7,31
Devon,Lympstone Church of England Primary School,178,38,11,49
Devon,Offwell Church of England Primary School,73,10,1,11
Devon,Payhembury Church of England Primary School,103,18,0,18
Devon,Plymtree Church of England Primary School,56,11,7,18
Devon,Silverton Church of England Primary School,114,2,5,7
Devon,Stoke Canon Church of England Primary School and Pre-School,69,14,1,15
Devon,Thorverton Church of England Primary School,98,14,2,16
Devon,Uplowman Church of England Primary School,78,7,0,7
Devon,Littleham Church of England Primary School,104,20,14,34
Devon,Berrynarbor Church of England Primary School,79,22,0,22
Devon,Georgeham Church of England (VC) Primary School,85,12,4,16
Devon,Goodleigh Church of England Primary School,85,29,4,33
Devon,Great Torrington Bluecoat Church of England Primary School,497,138,23,161
Devon,Holsworthy Church of England Primary School,323,53,10,63
Devon,Ilfracombe Church of England Junior School,399,90,29,119
Devon,Parracombe Church of England Primary School,39,3,0,3
Devon,St Mary's Church of England Primary School,409,40,10,50
Devon,Chudleigh Church of England Community Primary School,409,54,11,65
Devon,Kingskerswell Church of England Primary School,349,24,10,34
Devon,Malborough with South Huish Church of England Primary School,74,10,3,13
Devon,St Michael's Church of England Primary School,446,75,12,87
Devon,Cornwood Church of England Primary School,85,19,2,21
Devon,Lamerton Church of England Voluntary Controlled Primary School,43,6,0,6
Plymouth,Compton CofE Primary School,432,41,5,46
Plymouth,St Andrew's Cof E VA Primary School,207,27,1,28
Plymouth,Mary Dean's CofE Primary School,334,58,4,62
Devon,Awliscombe Church of England Primary School,95,17,0,17
Devon,St Peter's Church of England Primary School,316,38,5,43
Devon,The Beacon Church of England (VA) Primary School,168,38,5,43
Devon,Farway Church of England Primary School,39,7,5,12
Devon,Feniton Church of England Primary School,229,29,8,37
Devon,Tipton St John Church of England Primary School,73,23,3,26
Devon,Woodbury Church of England Primary School,188,30,3,33
Devon,Woodbury Salterton Church of England Primary School,50,16,0,16
Devon,Pinhoe Church of England Primary School & Nursery,471,64,17,81
Devon,Lynton Church of England Primary School,83,6,0,6
Devon,St Margaret's Church of England (Aided) Junior School,214,47,5,52
Devon,South Molton United Church of England Primary School,228,37,8,45
Devon,Swimbridge Church of England Primary School,88,12,0,12
Devon,St George's Church of England (VA) Infant and Nursery School,157,23,7,30
Devon,St Catherine's CofE Primary School,135,24,12,36
Devon,Marldon Church of England Primary School,205,34,5,39
Devon,Wolborough Church of England (Aided) Nursery and Primary School,216,44,6,50
Devon,St Mary's Church of England Primary School,103,24,5,29
Devon,St Andrew's Church of England Primary School,186,15,4,19
Devon,Bickleigh Down Church of England Primary School,411,29,6,35
Devon,Rackenford Church of England Primary School,74,16,5,21
Devon,Cullompton Community College,745,146,32,178
Devon,Sidmouth College,899,118,35,153
Devon,South Molton Community College,657,71,16,87
Torbay,The Spires College,1159,219,59,278
Plymouth,Sir John Hunt Community Sports College,793,164,25,189
Devon,Tiverton High School,1183,176,50,226
Torbay,St Cuthbert Mayne School,1030,165,22,187
Devon,St Peter's Church of England Aided School,1295,213,67,280
Devon,Exeter Cathedral School,271,31,7,38
Torbay,Abbey School,134,44,1,45
Devon,St Wilfrid's School,48,6,9,15
Devon,Vranch House School,58,0,58,58
Devon,Mount Kelly,640,159,3,162
Devon,Trinity School,278,47,20,67
Devon,Blundell's School,620,77,0,77
Devon,Blundell's Preparatory School,257,2,0,2
Devon,Stover School,522,188,3,191
Devon,St John's School,174,26,1,27
Devon,St Peter's Preparatory School,298,73,2,75
Plymouth,Fletewood School at Derry Villas,50,5,0,5
Plymouth,King's School,306,36,0,36
Devon,South Devon Steiner School,234,25,2,27
Devon,Kingsley School,404,80,42,122
Devon,Shebbear College,274,29,4,33
Devon,West Buckland School,657,197,1,198
Devon,Exeter School,961,241,1,242
Devon,The Maynard School,470,97,1,98
Plymouth,Plymouth College,552,128,0,128
Devon,Quay View School,37,0,37,37
Devon,Park School,56,14,2,16
Devon,Sands School,73,37,2,39
Devon,Magdalen Court School,63,1,62,63
Devon,The New School,60,3,0,3
Devon,St Christophers School,73,1,5,6
Devon,Ellen Tinkham School,238,0,238,238
Devon,Southbrook School,144,0,144,144
Devon,Mill Water School,120,0,120,120
Devon,Barley Lane School,80,0,80,80
Devon,The Lampard Community School,150,0,150,150
Devon,Pathfield School,187,0,187,187
Torbay,Mayfield School,266,4,262,266
Devon,Bidwell Brook School,158,0,158,158
Plymouth,Woodlands School,88,0,88,88
Plymouth,Cann Bridge School,95,0,95,95
Plymouth,Brook Green Centre for Learning,103,0,103,103
Plymouth,Mount Tamar School,100,0,100,100
Plymouth,Longcause Community Special School,126,0,126,126
Plymouth,Mill Ford School,125,0,125,125
Devon,Exeter Royal Academy for Deaf Education,46,0,46,46
Dorset,Downlands Community School,265,54,8,62
Dorset,Broadmayne First School,136,20,1,21
Dorset,Charmouth Primary School,89,23,2,25
Dorset,Cheselbourne Village School,51,8,2,10
Dorset,Hazelbury Bryan Primary School,86,13,3,16
Dorset,Stower Provost Community School,84,17,5,22
Dorset,Sturminster Marshall First School,86,13,1,14
Dorset,William Barnes Primary School,178,31,5,36
Dorset,Swanage Primary School,199,32,8,40
Dorset,Rushcombe First School,306,39,3,42
Dorset,Wyke Regis Infant School and Nursery,286,55,5,60
Dorset,Bincombe Valley Primary School,313,55,17,72
Dorset,Radipole Primary School,435,54,12,66
Dorset,Southill Primary School,208,18,5,23
"Bournemouth, Christchurch and Poole",Christchurch Infant School,324,32,2,34
"Bournemouth, Christchurch and Poole",Somerford Primary School,216,67,7,74
"Bournemouth, Christchurch and Poole",Mudeford Community Infants' School,180,20,4,24
"Bournemouth, Christchurch and Poole",Mudeford Junior School,258,23,7,30
Dorset,Wyke Primary School,189,23,8,31
Dorset,The Prince of Wales School,159,27,11,38
Dorset,Stoborough Church of England Primary School,198,20,3,23
Dorset,"St George's Church of England School, Bourton",120,13,4,17
Dorset,Cerne Abbas CofE VC First School,73,19,1,20
Dorset,"Maiden Newton, Greenford Church of England Primary School",142,37,4,41
Dorset,All Saints Church of England Voluntary Controlled Primary School,130,21,2,23
Dorset,Pimperne Church of England VC Primary School,191,27,6,33
Dorset,Broadwindsor Church of England Voluntary Controlled Primary School,102,10,8,18
Dorset,"St Mary's Church of England First School, Charminster",164,30,3,33
Dorset,Wyke Regis Church of England Junior School,354,60,12,72
"Bournemouth, Christchurch and Poole",Burton Church of England Primary School,323,44,6,50
Dorset,"St Nicholas Church of England Voluntary Aided Primary School, Child Okeford",130,29,5,34
Dorset,Sticklands Church of England Voluntary Aided Primary School,82,21,2,23
Dorset,Milton-on-Stour Church of England Primary School,127,19,2,21
Dorset,Hampreston Church of England Voluntary Aided First School,143,19,0,19
Dorset,"St George's Church of England Primary School, Langton Matravers",84,12,2,14
Dorset,"Thorner's Church of England School, Litton Cheney",110,11,0,11
Dorset,"St Gregory's Church of England Primary School, Marnhull",89,7,1,8
Dorset,Parrett and Axe Church of England Voluntary Aided Primary School,132,20,3,23
Dorset,Salway Ash Church of England Voluntary Aided Primary School,112,18,2,20
Dorset,Powerstock Church of England Voluntary Aided Primary School,62,23,1,24
Dorset,Symondsbury Church of England Voluntary Aided Primary School,104,15,4,19
Dorset,Sandford St Martin's Church of England Voluntary Aided Primary School,365,44,10,54
Dorset,Winterbourne Valley Church of England Aided First School,69,14,2,16
"Bournemouth, Christchurch and Poole",St Katharine's Church of England Primary School,437,45,7,52
"Bournemouth, Christchurch and Poole",Corpus Christi Catholic Primary School,434,60,9,69
"Bournemouth, Christchurch and Poole",The Priory Church of England Primary School,210,30,7,37
"Bournemouth, Christchurch and Poole","St Joseph's Catholic Primary School, Christchurch",215,29,5,34
Dorset,"The Abbey CofE VA Primary School, Shaftesbury",192,25,8,33
Dorset,"St Michael's Church of England Voluntary Aided Primary School, Lyme Regis",98,26,0,26
Dorset,Cranborne Middle School,339,45,12,57
Dorset,Ferndown Upper School,1030,138,31,169
Dorset,West Moors Middle School,241,40,24,64
Dorset,Lytchett Minster School,1549,147,28,175
Dorset,Sturminster Newton High School,643,148,16,164
Dorset,Gillingham School,1755,114,43,157
Dorset,Beaminster School,663,155,29,184
Dorset,The Blandford School,1108,176,24,200
"Bournemouth, Christchurch and Poole","St Edward's Roman Catholic/Church of England School, Poole",1099,164,33,197
"Bournemouth, Christchurch and Poole",St. Walburga's Catholic Primary School,419,37,3,40
Dorset,Stalbridge Church of England Primary School,187,17,5,22
Dorset,The Woodroffe School,1042,91,23,114
"Bournemouth, Christchurch and Poole",Poole High School,1859,361,18,379
Dorset,Bryanston School,805,190,0,190
Dorset,Hanford School,81,4,0,4
Dorset,Clayesmore School,395,121,6,127
Dorset,Yarrells Preparatory School,264,25,0,25
Dorset,Port Regis Preparatory School,289,43,0,43
Dorset,Sherborne Preparatory School,204,36,0,36
Dorset,Sherborne School,583,204,1,205
Dorset,Sherborne School for Girls,489,167,0,167
Dorset,Leweston School,615,127,3,130
"Bournemouth, Christchurch and Poole",Canford School,646,219,0,219
Dorset,Dumpton School,325,32,3,35
Dorset,Sunninghill Preparatory School,130,26,1,27
"Bournemouth, Christchurch and Poole",Bournemouth Collegiate Preparatory School,260,29,2,31
Dorset,Castle Court School,282,59,2,61
Dorset,Milton Abbey School,189,124,6,130
"Bournemouth, Christchurch and Poole",Bournemouth Collegiate School,402,84,4,88
"Bournemouth, Christchurch and Poole",Park School,372,23,0,23
"Bournemouth, Christchurch and Poole",St Martin's School,94,26,2,28
"Bournemouth, Christchurch and Poole",Talbot House School,121,20,0,20
"Bournemouth, Christchurch and Poole",Portfield School,110,0,110,110
Dorset,Ringwood Waldorf School,233,33,0,33
"Bournemouth, Christchurch and Poole",Talbot Heath School,581,64,0,64
Dorset,Clayesmore Preparatory School,143,41,1,42
Dorset,Purbeck View School,15,0,15,15
Dorset,Sheiling School,37,0,37,37
"Bournemouth, Christchurch and Poole",Victoria Education Centre,101,0,101,101
"Bournemouth, Christchurch and Poole",Winchelsea School,219,0,219,219
Dorset,Beaucroft Foundation School,191,2,189,191
Dorset,Mountjoy School,102,0,102,102
Dorset,Westfield Arts College,220,0,220,220
"Bournemouth, Christchurch and Poole",Linwood School,395,0,395,395
Dorset,Yewstock School,165,0,165,165
County Durham,Oxhill Nursery School,113,12,0,12
County Durham,Wingate Community Nursery School,89,4,2,6
County Durham,Aclet Close Nursery School,65,8,1,9
County Durham,Oxclose Nursery School,76,5,0,5
County Durham,Seaham Harbour Nursery School,96,14,0,14
County Durham,Etherley Lane Nursery School,41,3,1,4
County Durham,Langley Moor Nursery School,44,3,0,3
Darlington,Borough Road Nursery School,98,14,0,14
Darlington,George Dent Nursery School,118,12,1,13
County Durham,Beechdale Nursery School,69,9,0,9
County Durham,Horden Nursery School,105,7,0,7
County Durham,Rosemary Lane Nursery School,104,17,1,18
County Durham,Tudhoe Moor Nursery School,42,5,0,5
County Durham,The Woodlands,126,40,1,41
County Durham,Ropery Walk Primary School,258,37,5,42
County Durham,Westlea Primary School,249,68,4,72
County Durham,Edmondsley Primary School,167,17,2,19
County Durham,Lumley Junior School,178,22,3,25
County Durham,Lumley Infant and Nursery School,182,24,3,27
County Durham,West Pelton Primary School,74,14,3,17
County Durham,Nettlesworth Primary School,113,6,10,16
County Durham,Red Rose Primary School,306,36,7,43
County Durham,Woodlea Primary School,225,18,4,22
County Durham,Cestria Primary School,407,65,2,67
County Durham,Bournmoor Primary School,90,15,1,16
County Durham,Cotherstone Primary School,54,15,1,16
County Durham,Beamish Primary School,51,24,0,24
County Durham,Collierley Nursery and Primary School,136,20,9,29
County Durham,Catchgate Primary School,268,59,2,61
County Durham,Stanley Burnside Primary School,192,31,0,31
County Durham,Burnopfield Primary School,379,29,7,36
County Durham,Shotley Bridge Primary School,375,14,1,15
County Durham,Leadgate Primary School - Split Site,182,40,3,43
County Durham,Castleside Primary School,77,14,4,18
County Durham,Benfieldside Primary School,227,35,1,36
County Durham,The Grove Primary School,195,29,4,33
County Durham,Delves Lane Primary School,307,88,3,91
County Durham,Consett Junior School,224,48,6,54
County Durham,Consett Infant School,160,5,4,9
County Durham,Hamsterley Primary School,36,6,0,6
County Durham,Hunwick Primary School,112,9,1,10
County Durham,Tow Law Millennium Primary School,95,29,6,35
County Durham,Crook Primary School,396,83,9,92
County Durham,Peases West Primary School,96,33,4,37
County Durham,Stanley (Crook) Primary School,136,17,2,19
County Durham,Sunnybrow Primary School,72,17,6,23
County Durham,Frosterley Primary School,39,8,3,11
County Durham,Rookhope Primary School,9,4,0,4
County Durham,St John's Chapel Primary School,20,6,1,7
County Durham,Wearhead Primary School,18,4,0,4
County Durham,Willington Primary School,192,25,1,26
County Durham,Wolsingham Primary School,181,23,3,26
County Durham,Oakley Cross Primary School and Nursery,164,32,2,34
County Durham,Byers Green Primary School,78,12,1,13
County Durham,Kirk Merrington Primary School,157,19,3,22
County Durham,Cassop Primary School,142,30,2,32
County Durham,Ferryhill Station Primary School,64,22,3,25
County Durham,West Cornforth Primary School,219,32,2,34
County Durham,Coxhoe Primary School,320,45,6,51
County Durham,Kelloe Primary School,134,13,0,13
County Durham,Dean Bank Primary and Nursery School,193,49,2,51
County Durham,Bowburn Primary School,361,32,4,36
County Durham,Ox Close Primary School,310,47,8,55
County Durham,Fishburn Primary School,153,20,4,24
County Durham,Broom Cottages Primary & Nursery School,278,53,3,56
County Durham,Etherley Lane Primary School,234,31,7,38
County Durham,Ramshaw Primary School,62,14,0,14
County Durham,Aycliffe Village Primary and Nursery School,184,37,7,44
County Durham,Butterknowle Primary School,50,11,2,13
County Durham,Escomb Primary School,190,31,3,34
County Durham,St Helen Auckland Community Primary School,207,37,8,45
County Durham,Thornhill Primary School,206,32,1,33
County Durham,Toft Hill Primary School,188,23,4,27
County Durham,Woodland Primary School,27,4,1,5
County Durham,Middleton-in-Teesdale Nursery and Primary School,107,15,1,16
County Durham,Cockton Hill Junior School,218,57,3,60
County Durham,Cockton Hill Infant School,164,10,4,14
County Durham,Timothy Hackworth Primary School,368,55,9,64
County Durham,Cockfield Primary School,107,20,3,23
County Durham,Montalbo Nursery & Primary School,200,22,4,26
County Durham,Langley Moor Primary School,195,13,1,14
County Durham,Witton Gilbert Primary School,200,19,3,22
County Durham,Pittington Primary School,204,19,4,23
County Durham,Ludworth Primary School,108,29,1,30
County Durham,Sherburn Primary School,166,43,1,44
County Durham,West Rainton Primary School,137,10,2,12
County Durham,Bearpark Primary School,84,20,3,23
County Durham,Neville's Cross Primary School and Nursery,295,31,4,35
County Durham,Durham Newton Hall Infants' School,152,2,0,2
County Durham,Esh Winning Primary School,283,57,7,64
County Durham,Belmont Cheveley Park Primary School,225,29,7,36
County Durham,Laurel Avenue Community Primary School,122,45,2,47
County Durham,Hesleden Primary School,96,12,2,14
County Durham,Deaf Hill Primary School,169,14,1,15
County Durham,Thornley Primary School,177,39,2,41
County Durham,Wheatley Hill Community Primary School,415,143,67,210
County Durham,Wingate Primary School,347,87,4,91
County Durham,Cotsford Primary School,164,21,2,23
County Durham,Shotton Primary School,295,63,3,66
County Durham,Acre Rigg Infant School,279,64,4,68
County Durham,Sedgefield Primary School,216,34,0,34
Darlington,Red Hall Primary School,217,77,11,88
County Durham,Copeland Road Primary School,134,28,5,33
County Durham,St Andrew's Primary School,148,20,6,26
County Durham,Byerley Park Primary School,207,21,1,22
County Durham,Horndale Infants' School,74,19,0,19
County Durham,Yohden Primary School,158,45,3,48
County Durham,Howletch Lane Primary School,373,73,10,83
County Durham,Blackhall Primary School,322,69,2,71
County Durham,Vane Road Primary School,415,54,11,65
County Durham,Sugar Hill Primary School,465,46,4,50
County Durham,Roseberry Primary and Nursery School,265,54,5,59
County Durham,Bullion Lane Primary School,285,52,2,54
County Durham,Easington Colliery Primary School,552,103,12,115
County Durham,Durham Gilesgate Primary School,129,17,8,25
County Durham,Chester-Le-Street CofE (Controlled) Primary School,284,72,13,85
County Durham,Ebchester CofE Primary School,96,4,1,5
County Durham,St Stephen's Church of England Primary School,214,30,2,32
County Durham,Green Lane Church of England Controlled Primary School,212,31,1,32
County Durham,St Anne's CofE Primary School,235,28,4,32
County Durham,Gainford CofE Primary School and Preschool,54,9,2,11
County Durham,Staindrop CofE (Controlled) Primary School,172,21,2,23
County Durham,Belmont CofE (Controlled) Primary School,272,42,0,42
County Durham,St Oswald's Church of England Aided Primary and Nursery School,139,13,1,14
County Durham,Shincliffe CofE (Controlled) Primary School,203,7,2,9
County Durham,St Margaret's Church of England Primary School,415,19,5,24
County Durham,Easington CofE Primary School,128,13,1,14
County Durham,Hutton Henry CofE (Controlled) Primary School,62,9,1,10
County Durham,Bowes Hutchinson's CofE (Aided) School,66,19,2,21
County Durham,St Francis CofE (Aided) Junior School,111,12,5,17
County Durham,"St Hild's College Church of England Aided Primary School, Durham",163,37,1,38
County Durham,Blue Coat CofE (Aided) Junior School,222,12,3,15
County Durham,"St Joseph's Catholic Primary School, Murton",159,9,1,10
County Durham,Our Lady Star of the Sea Roman Catholic Voluntary Aided Primary,106,12,1,13
County Durham,"St John's Church of England Aided Primary School, Shildon",237,73,6,79
County Durham,"Greenfield Community College, A Specialist Arts and Science School",698,141,5,146
County Durham,Belmont Community School,814,101,18,119
County Durham,Durham Sixth Form Centre,1679,43,2,45
County Durham,Durham Johnston Comprehensive School,1673,170,14,184
County Durham,Wellfield School,923,187,17,204
County Durham,Durham High School for Girls,326,64,2,66
County Durham,Durham Cathedral Schools Foundation,736,123,5,128
County Durham,Barnard Castle School,717,130,2,132
County Durham,Elemore Hall School,180,0,180,180
County Durham,Croft Community School,230,0,230,230
County Durham,Walworth School,80,0,80,80
County Durham,Villa Real School,124,0,124,124
County Durham,Durham Trinity School & Sports College,227,0,227,227
Brighton and Hove,Tarnerland Nursery School,116,38,0,38
Brighton and Hove,Royal Spa Nursery School,93,19,2,21
Brighton and Hove,Coombe Road Primary School,166,41,5,46
Brighton and Hove,Downs Junior School,508,83,20,103
Brighton and Hove,Downs Infant School,345,31,12,43
Brighton and Hove,Hertford Infant School,98,25,2,27
Brighton and Hove,Middle Street Primary School,184,41,4,45
Brighton and Hove,Patcham Junior School,352,51,9,60
Brighton and Hove,Patcham Infant School,306,30,7,37
Brighton and Hove,St Luke's Primary School,626,59,13,72
Brighton and Hove,Stanford Junior School,310,20,7,27
Brighton and Hove,Stanford Infant School,240,22,5,27
Brighton and Hove,Westdene Primary School,520,80,9,89
Brighton and Hove,Carlton Hill Primary School,214,37,9,46
Brighton and Hove,Balfour Primary School,709,65,13,78
Brighton and Hove,Hertford Junior School,139,32,10,42
Brighton and Hove,Coldean Primary School,333,79,8,87
East Sussex,Alfriston School,94,12,0,12
East Sussex,Brede Primary School,111,14,1,15
East Sussex,Chiddingly Primary School,103,22,2,24
East Sussex,Ashdown Primary School,417,21,6,27
East Sussex,Grovelands Community Primary School,697,123,16,139
East Sussex,Hamsey Community Primary School,97,21,0,21
East Sussex,Hankham Primary School,124,10,1,11
East Sussex,Hellingly Community Primary School,198,27,5,32
Brighton and Hove,Goldstone Primary School,684,64,15,79
Brighton and Hove,Hangleton Primary School,450,55,4,59
Brighton and Hove,Hove Junior School,695,131,15,146
East Sussex,Laughton Community Primary School,95,14,1,15
East Sussex,Wallands Community Primary and Nursery School,256,58,13,71
East Sussex,Western Road Community Primary School,207,13,1,14
East Sussex,Maynards Green Community Primary School,208,21,2,23
East Sussex,Park Mead Primary School,105,25,0,25
East Sussex,Plumpton Primary School,127,18,3,21
Brighton and Hove,St Peter's Community Primary School,131,21,8,29
Brighton and Hove,Benfield Primary School,235,27,9,36
Brighton and Hove,Brackenbury Primary School,167,38,6,44
East Sussex,Punnetts Town Community Primary School,103,10,2,12
East Sussex,Ringmer Primary and Nursery School,352,37,4,41
East Sussex,Rotherfield Primary School,210,14,2,16
East Sussex,Seaford Primary School,413,31,3,34
East Sussex,Westfield School,198,27,7,34
East Sussex,Willingdon Primary School,418,45,20,65
East Sussex,St Michael's Primary School,75,10,1,11
East Sussex,Wivelsfield Primary School,221,26,3,29
Brighton and Hove,West Blatchington Primary and Nursery School,252,50,25,75
East Sussex,Chantry Community Primary School,204,30,0,30
Brighton and Hove,West Hove Infant School,482,64,9,73
East Sussex,Little Common School,625,55,4,59
Brighton and Hove,Mile Oak Primary School,423,86,12,98
East Sussex,Denton Community Primary School and Nursery,239,34,9,43
East Sussex,Cradle Hill Community Primary School,654,93,12,105
East Sussex,Polegate Primary School,696,111,12,123
East Sussex,Manor Primary School,395,89,15,104
East Sussex,Harbour Primary and Nursery School,481,92,7,99
Brighton and Hove,Peter Gladwin Primary School,213,38,9,47
Brighton and Hove,Brunswick Primary School,771,90,17,107
East Sussex,Sandown Primary School and Nursery,514,86,5,91
East Sussex,Tollgate Community Junior School,391,42,9,51
East Sussex,Motcombe Infants' School,250,23,1,24
East Sussex,Pashley Down Infant School,260,38,2,40
East Sussex,West Rise Community Infant School,270,46,3,49
East Sussex,West Rise Junior School,356,96,10,106
East Sussex,Rocks Park Primary School,207,25,1,26
East Sussex,Bourne Primary School,447,78,7,85
East Sussex,Meridian Community Primary School and Nursery,493,89,6,95
Brighton and Hove,Elm Grove Primary School,408,55,10,65
Brighton and Hove,Queen's Park Primary School,329,44,13,57
Brighton and Hove,Saltdean Primary School,571,79,14,93
Brighton and Hove,Woodingdean Primary School,374,69,12,81
East Sussex,Parkside Community Primary School,237,29,4,33
East Sussex,Stone Cross School,414,25,4,29
Brighton and Hove,Bevendean Primary School and Nursery,340,69,18,87
Brighton and Hove,Rudyard Kipling Primary School & Nursery,350,101,15,116
Brighton and Hove,Fairlight Primary School,337,71,14,85
East Sussex,Barcombe Church of England Primary School,136,15,3,18
East Sussex,Battle and Langton Church of England Primary School,422,62,8,70
East Sussex,Beckley Church of England Primary School,96,18,0,18
East Sussex,"All Saints Church of England Primary School, Bexhill",302,30,14,44
East Sussex,Burwash CofE School,160,24,2,26
East Sussex,Buxted CofE Primary School,183,34,3,37
East Sussex,Catsfield Church of England Primary School,102,14,0,14
East Sussex,Chailey St Peter's Church of England Primary School,113,24,3,27
East Sussex,Cross-in-Hand Church of England Primary School,382,51,3,54
East Sussex,Crowhurst CofE Primary School,98,11,3,14
East Sussex,Dallington Church of England Primary School,113,9,1,10
East Sussex,Danehill Church of England Primary School,89,9,2,11
East Sussex,East Hoathly CofE Primary School,119,23,0,23
East Sussex,Etchingham Church of England Primary School,109,12,1,13
East Sussex,Fletching Church of England Primary School,68,17,4,21
East Sussex,Forest Row Church of England Primary School,162,27,6,33
East Sussex,Frant Church of England Primary School,100,16,2,18
East Sussex,Herstmonceux Church of England Primary School,207,26,2,28
East Sussex,High Hurstwood Church of England Primary School,101,8,1,9
East Sussex,South Malling CofE Primary and Nursery School,262,54,2,56
East Sussex,Southover CofE Primary School,309,44,4,48
East Sussex,Bonners CofE School,161,10,2,12
East Sussex,Mayfield Church of England Primary School,158,15,0,15
East Sussex,Netherfield CofE Primary School,144,21,0,21
East Sussex,Ninfield Church of England Primary School,146,19,1,20
East Sussex,Nutley Church of England Primary School,83,7,0,7
East Sussex,Peasmarsh Church of England Primary School,75,20,2,22
East Sussex,Pevensey and Westham CofE Primary School,414,27,4,31
East Sussex,St Michael's Church of England Primary School,87,15,1,16
East Sussex,Salehurst Church of England Primary School,189,23,3,26
East Sussex,Stonegate Church of England Primary School,110,24,1,25
East Sussex,Ticehurst and Flimwell Church of England Primary School,113,28,2,30
East Sussex,Firle Church of England Primary School,79,12,1,13
East Sussex,Five Ashes CofE Primary School,50,7,0,7
East Sussex,Icklesham Church of England Primary School,128,14,0,14
East Sussex,Newick Church of England Primary School,210,28,1,29
East Sussex,Bodiam Church of England Primary School,80,8,0,8
East Sussex,Iford and Kingston Church of England Primary School,164,15,1,16
East Sussex,Staplecross Methodist Primary School,96,6,3,9
East Sussex,Wadhurst CofE Primary School and Nursery,321,19,0,19
East Sussex,St Andrew's Church of England Infants School,264,34,3,37
Brighton and Hove,"St Margaret's CofE Primary School, Rottingdean",180,26,6,32
Brighton and Hove,St Bartholomew's CofE Primary School,135,33,12,45
Brighton and Hove,St Martin's CofE Primary School,196,42,4,46
Brighton and Hove,St John the Baptist Catholic Primary School,195,23,10,33
Brighton and Hove,St Mary Magdalen Catholic Primary School,192,32,8,40
Brighton and Hove,St Joseph's Catholic Primary School,160,28,4,32
Brighton and Hove,St Paul's CofE Primary School,179,10,9,19
Brighton and Hove,Our Lady of Lourdes RC School,194,30,6,36
Brighton and Hove,St Mark's CofE Primary School,165,40,15,55
Brighton and Hove,St Bernadette's Catholic Primary School,213,27,4,31
East Sussex,Blackboys Church of England Primary School,132,8,0,8
East Sussex,St John's Church of England Primary School,205,18,2,20
East Sussex,Framfield Church of England Primary School,94,10,2,12
East Sussex,Guestling Bradshaw Church of England Primary School,212,14,6,20
East Sussex,St Mark's Church of England Primary School,89,12,2,14
East Sussex,St Mary the Virgin Church of England Primary School,90,24,3,27
East Sussex,All Saints' and St Richard's Church of England Primary School,96,16,4,20
Brighton and Hove,Aldrington CofE Primary School,423,69,8,77
Brighton and Hove,St Andrew's CofE (Aided) Primary School,640,218,19,237
East Sussex,Little Horsted Church of England Primary School,90,15,1,16
East Sussex,Mark Cross Church of England Aided Primary School,94,7,0,7
East Sussex,Groombridge St Thomas' Church of England Primary School,178,15,1,16
Brighton and Hove,St Nicolas CofE Primary School,424,75,8,83
East Sussex,Holy Cross Church of England Primary School,62,19,0,19
East Sussex,St Thomas' Church of England Aided Primary School,135,19,1,20
East Sussex,St Peter and St Paul CofE Primary School,419,25,2,27
East Sussex,St Mary Magdalene Catholic Primary School,209,20,2,22
East Sussex,St Marys Catholic Primary School,218,22,4,26
Brighton and Hove,Cottesmore St Mary's Catholic Primary School,421,48,8,56
East Sussex,St Pancras Catholic Primary School,109,28,2,30
East Sussex,St Philip's Catholic Primary School,185,25,4,29
Brighton and Hove,St Mary's Catholic Primary School,209,25,7,32
East Sussex,St Mary Star of the Sea Catholic Primary School,194,19,1,20
East Sussex,"Sacred Heart Catholic Primary School, Hastings",239,33,4,37
East Sussex,St Thomas A Becket Catholic Primary School,440,63,4,67
Brighton and Hove,Varndean School,1498,293,65,358
Brighton and Hove,Dorothy Stringer School,1640,171,48,219
Brighton and Hove,Longhill High School,875,175,36,211
East Sussex,Claverham Community College,1137,71,18,89
East Sussex,Heathfield Community College,1470,84,36,120
East Sussex,Robertsbridge Community College,754,35,35,70
East Sussex,Uckfield  College,1583,126,30,156
East Sussex,Willingdon Community School,1019,70,32,102
East Sussex,Chailey School,827,73,26,99
East Sussex,Priory School,1152,164,33,197
Brighton and Hove,Blatchington Mill School,1621,189,32,221
Brighton and Hove,Hove Park School and Sixth Form Centre,1123,183,57,240
Brighton and Hove,Patcham High School,1118,200,46,246
Brighton and Hove,Cardinal Newman Catholic School,2497,320,40,360
East Sussex,St Richard's Catholic College,1036,92,21,113
Brighton and Hove,Brighton College,1268,203,0,203
Brighton and Hove,Roedean School,700,79,0,79
Brighton and Hove,Windlesham School,194,20,1,21
Brighton and Hove,Hamilton Lodge School and College for Deaf Children,37,0,37,37
Brighton and Hove,"Brighton College Nursery, Pre-Prep and Prep School",510,81,0,81
East Sussex,Battle Abbey School,506,47,0,47
West Sussex,Cumnor House School,415,91,0,91
East Sussex,Michael Hall School,421,99,1,100
Brighton and Hove,Lancing College Preparatory School At Hove,288,23,0,23
East Sussex,Mayfield School,421,145,0,145
East Sussex,Vinehall School,188,40,0,40
East Sussex,Skippers Hill Manor Preparatory School,205,25,1,26
East Sussex,Lewes Old Grammar School,702,130,4,134
East Sussex,Frewen College,136,3,133,136
East Sussex,Sacred Heart School,139,31,2,33
Brighton and Hove,St Christopher's School,286,71,1,72
East Sussex,Claremont School,627,14,9,23
East Sussex,Northease Manor School,117,3,114,117
East Sussex,Darvell School,49,2,0,2
East Sussex,Eastbourne College,651,167,0,167
East Sussex,St Andrew's Prep,364,46,0,46
East Sussex,Bede's Prep School,357,59,0,59
East Sussex,Buckswood School,289,23,0,23
East Sussex,Bede's Senior School,825,171,1,172
Brighton and Hove,Brighton Girls GDST,416,129,1,130
East Sussex,Greenfields School,175,1,1,2
East Sussex,Owlswick School,11,0,11,11
Brighton and Hove,Brighton Waldorf School,152,43,3,46
East Sussex,St. John's School (Seaford),28,0,28,28
Brighton and Hove,Homewood College,37,0,37,37
Brighton and Hove,Downs View Special School,203,0,203,203
East Sussex,Chailey Heritage School,78,0,78,78
Brighton and Hove,Hill Park School,201,0,201,201
East Sussex,Grove Park School,133,0,133,133
Essex,Tanglewood Nursery School,174,42,1,43
Essex,Woodcroft Nursery School,93,27,3,30
Essex,St. George's School,633,102,7,109
Essex,Hamilton Primary School,416,38,9,47
Essex,Lexden Primary School with Unit for Hearing Impaired Pupils,221,23,17,40
Essex,Myland Community Primary School,312,32,3,35
Essex,North Primary School and Nursery,448,46,9,55
Essex,Old Heath Community Primary School,209,16,6,22
Essex,St John's Green Primary School,628,65,13,78
Essex,King's Ford Infant School and Nursery,185,24,4,28
Southend-on-Sea,Chalkwell Hall Junior School,478,35,10,45
Southend-on-Sea,Chalkwell Hall Infant School,329,15,4,19
Southend-on-Sea,Earls Hall Primary School,634,63,21,84
Essex,Oakwood Infant and Nursery School,315,28,1,29
Essex,Frinton-on-Sea Primary School,211,19,6,25
Essex,Langenhoe Community Primary School,121,19,2,21
Essex,Langham Primary School,99,12,3,15
Essex,Stanway Primary School,407,34,5,39
Essex,Alresford Primary School,227,41,5,46
Essex,Bradfield Primary School,114,11,1,12
Essex,Great Bentley Primary School,215,31,5,36
Essex,Tendring Primary School,187,37,3,40
Essex,Wix and Wrabness Primary School,116,29,6,35
Essex,Gosbecks Primary School,280,40,1,41
Essex,Prettygate Junior School,255,39,5,44
Essex,Prettygate Infant School,147,18,2,20
Essex,Hazelmere Junior School,216,43,4,47
Essex,Hazelmere Infant School and Nursery,187,22,8,30
Essex,The Mayflower Primary School,338,40,9,49
Essex,"Montgomery Junior School, Colchester",346,32,5,37
Essex,"Montgomery Infant School and Nursery, Colchester",300,28,2,30
Essex,Brightlingsea Primary School and Nursery,707,139,6,145
Essex,Broomgrove Infant School,167,31,2,33
Essex,Broomgrove Junior School,226,33,7,40
Essex,Milldene Primary School,193,25,1,26
Essex,Friars Grove Primary School,406,38,4,42
Essex,Stanway Fiveways Primary School,542,84,8,92
Essex,Baynards Primary School,103,34,2,36
Essex,Highfields Primary School,317,38,6,44
Southend-on-Sea,Leigh North Street Primary School,618,53,14,67
Southend-on-Sea,West Leigh Infant School,359,24,5,29
Southend-on-Sea,Barons Court Primary School and Nursery,300,59,16,75
Southend-on-Sea,Heycroft Primary School,402,43,9,52
Essex,Quilters Junior School,256,29,4,33
Essex,Trinity Road Primary School,321,72,15,87
Essex,Vange Primary School and Nursery,113,26,2,28
Essex,Wickford Primary School,511,59,7,66
Essex,"St Michael's Primary School and Nursery, Colchester",285,40,6,46
Essex,John Bunyan Primary School and Nursery,550,104,17,121
Essex,Burnham-on-Crouch Primary School,421,38,8,46
Essex,Canvey Junior School,244,17,8,25
Essex,Roach Vale Primary School,188,44,1,45
Essex,Chipping Hill Primary School,420,18,12,30
Essex,Spring Meadow Primary School & School House Nursery,394,119,12,131
Essex,Great Bardfield Primary School,119,9,5,14
Southend-on-Sea,Fairways Primary School,419,32,17,49
Essex,Harwich Community Primary School and Nursery,234,34,6,40
Essex,Great Leighs Primary School,225,10,7,17
Essex,Rettendon Primary School,138,27,4,31
Essex,Highwood Primary School,57,5,4,9
Essex,Felsted Primary School,200,25,6,31
Essex,Holt Farm Infant School,189,15,3,18
Essex,Quilters Infant School,184,13,4,17
Essex,Galleywood Infant School,181,49,6,55
Essex,Stebbing Primary School,186,23,7,30
Essex,Baddow Hall Infant School,174,5,3,8
Essex,Long Ridings Primary School,394,33,17,50
Essex,Cold Norton Primary School,152,8,3,11
Essex,Ingatestone Infant School,134,5,1,6
Essex,Sunnymede Junior School,229,27,3,30
Essex,Millhouse Primary School,640,100,10,110
Essex,Baddow Hall Junior School,240,38,4,42
Essex,Ghyllgrove Primary School,601,79,37,116
Essex,Writtle Infant School,173,38,4,42
Essex,West Horndon Primary School,170,18,15,33
Essex,Tollesbury School,193,21,4,25
Essex,Blackmore Primary School,169,29,2,31
Essex,Limes Farm Junior School,157,33,5,38
Essex,Wentworth Primary School,436,48,8,56
Essex,Down Hall Primary School,261,15,4,19
Essex,Boreham Primary School,230,37,5,42
Essex,John Ray Infant School,360,30,10,40
Essex,Sunnymede Infant School,176,11,2,13
Essex,Kelvedon Hatch Community Primary School,190,23,7,30
Essex,South Green Junior School,231,41,14,55
Essex,Howbridge Infant School,259,23,3,26
Essex,Ashdon Primary School,66,8,1,9
Essex,Clavering Primary School,173,19,2,21
Essex,Doddinghurst Infant School,129,2,4,6
Essex,Great Sampford Community Primary School,89,14,1,15
Essex,Nazeing Primary School,257,48,0,48
Essex,Hatfield Peverel Infant and Nursery School,220,17,3,20
Essex,Henham and Ugley Primary and Nursery School,211,22,5,27
Essex,Bentfield Primary School and Nursery,214,21,28,49
Essex,Manuden Primary School,92,8,0,8
Essex,Canvey Island Infant School and Nursery,221,15,7,22
Essex,Great Bradfords Junior School,321,49,7,56
Essex,Newport Primary School,190,35,6,41
Essex,White Court School,569,73,13,86
Essex,Great Bradfords Infant and Nursery School,299,23,2,25
Essex,Wimbish Primary School,64,13,0,13
Essex,Danbury Park Community Primary School,256,25,2,27
Essex,Beehive Lane Community Primary School,212,17,8,25
Essex,Eversley Primary School,415,63,9,72
Essex,"Priory Primary School, Bicknacre",180,35,5,40
Essex,Edward Francis Primary School,418,34,12,46
Essex,Hogarth Primary School and Nursery,297,30,9,39
Essex,Westlands Community Primary School,614,68,13,81
Essex,South Green Infant School,202,19,0,19
Essex,Willowbrook Primary School,214,25,6,31
Essex,Warley Primary School,345,50,11,61
Essex,Writtle Junior School,241,42,4,46
Essex,Kendall Church of England Primary School,211,63,5,68
Essex,"St John's Church of England Voluntary Controlled Primary School, Colchester",210,16,2,18
Essex,"Holy Trinity Church of England Voluntary Controlled Primary School, Halstead",213,37,11,48
Essex,St Andrew's Bulmer Church of England Voluntary Controlled Primary School,72,14,1,15
Essex,St Giles' Church of England Primary School,95,13,1,14
Essex,"St Peter's Church of England Voluntary Controlled Primary School, Sible Hedingham",213,31,4,35
Essex,St Margaret's Church of England Voluntary Controlled Primary School Toppesfield,65,3,1,4
Essex,Boxted St Peter's Church of England School,203,11,4,15
Essex,Chappel Church of England Controlled Primary School,103,19,0,19
Essex,Copford Church of England Voluntary Controlled Primary School,217,19,4,23
Essex,"Holy Trinity CofE Primary School, Eight Ash Green and Aldham",84,15,1,16
Essex,Dedham Church of England Voluntary Controlled Primary School,198,19,3,22
Essex,"St Lawrence Church of England Primary School, Rowhedge",225,32,4,36
Essex,Fordham All Saints Church of England Voluntary Controlled Primary School,115,13,3,16
Essex,Great Tey Church of England Voluntary Controlled Primary School,75,14,3,17
Essex,Layer-de-la-Haye Church of England Voluntary Controlled Primary School,202,19,8,27
Essex,"St Andrew's Church of England Voluntary Controlled Primary School, Marks Tey",170,24,3,27
Essex,St Luke's Church of England Controlled Primary School,246,20,5,25
Essex,"Heathlands Church of England Voluntary Controlled Primary School, West Bergholt",418,37,8,45
Essex,"St Mary's Church of England Voluntary Controlled Primary School, Ardleigh",108,8,1,9
Essex,"St George's Church of England Primary School, Great Bromley",117,15,4,19
Essex,Parsons Heath Church of England Voluntary Controlled Primary School,197,40,4,44
Essex,"St Nicholas' Church of England Voluntary Controlled Primary School, Rawreth",145,23,3,26
Essex,Canewdon Endowed Church of England Voluntary Controlled Primary School,110,18,3,21
Essex,Coopersale and Theydon Garnon Church of England Voluntary Controlled Primary School,190,34,2,36
Essex,Sheering Church of England Voluntary Controlled Primary School,105,11,5,16
Essex,Hatfield Peverel St Andrew's Junior School,203,37,4,41
Essex,All Saints Maldon Church of England Voluntary Controlled Primary School,313,43,7,50
Essex,"St Peter's Church of England Voluntary Controlled Primary School, Coggeshall",321,16,11,27
Essex,Wethersfield CofE VC Primary School,56,9,2,11
Essex,White Notley Church of England Voluntary Controlled Primary School,104,17,3,20
Essex,St John Church of England Voluntary Controlled Primary School Danbury,220,29,4,33
Essex,East Hanningfield Church of England Primary School,122,22,2,24
Essex,Great Waltham Church of England Voluntary Controlled Primary School,164,24,0,24
Essex,Downham Church of England Voluntary Controlled Primary School,219,16,4,20
Essex,Stock Church of England Primary School,201,13,1,14
Essex,Woodham Walter Church of England Voluntary Controlled Primary School,114,17,3,20
Essex,"Dr Walker's Church of England Voluntary Controlled Primary School, Fyfield",89,10,2,12
Essex,Matching Green Church of England Voluntary Controlled Primary School,90,9,0,9
Essex,Birchanger Church of England Voluntary Controlled Primary School,121,12,2,14
Essex,Elsenham Church of England Voluntary Controlled Primary School,342,47,5,52
Essex,Rickling Church of England Voluntary Aided Primary School,104,13,2,15
Essex,St John the Baptist Church of England Voluntary Aided Primary School Pebmarsh,73,17,1,18
Essex,Birch Church of England Voluntary Aided Primary School,133,25,1,26
Essex,Fingringhoe Church of England Voluntary Aided Primary School,87,10,0,10
Essex,"All Saints Church of England Voluntary Aided Primary School, Great Oakley",110,19,3,22
Essex,The Bishop William Ward Church of England Primary School,188,30,6,36
Southend-on-Sea,"St Mary's, Prittlewell, CofE Primary School",649,93,7,100
Essex,Bentley St Paul's Church of England Voluntary Aided Primary School,209,25,12,37
Essex,Ingrave Johnstone Church of England Voluntary Aided Primary School,206,32,3,35
Essex,St Mary's Church of England Voluntary Aided Primary School,215,24,7,31
Essex,St Anne Line Catholic Junior School,249,21,8,29
Essex,St Michael's Church of England Voluntary Aided Primary School,416,64,12,76
Essex,"St Mary's Church of England Voluntary Aided Primary School, Burnham-on-Crouch",238,20,7,27
Essex,St Anne Line Catholic Infant School,180,44,8,52
Essex,"St Peter's Church of England Voluntary Aided Primary School, South Weald",415,16,12,28
Essex,Terling Church of England Voluntary Aided Primary School,105,17,2,19
Essex,"Churchgate Church of England Voluntary Aided Primary School, Harlow",195,32,7,39
Essex,Little Waltham Church of England Voluntary Aided Primary School,209,28,7,35
Essex,Great Easton Church of England Voluntary Aided Primary School,142,27,11,38
Essex,"St Mary's Church of England Voluntary Aided Primary School, Hatfield Broad Oak",53,15,3,18
Essex,"St Thomas of Canterbury Church of England Aided Junior School, Brentwood",302,43,15,58
Essex,Little Hallingbury Church of England Voluntary Aided Primary School,111,11,0,11
Essex,St Joseph the Worker Catholic Primary School,207,9,2,11
Essex,St Thomas of Canterbury Church of England Aided Infant School,215,23,11,34
Essex,Moreton Church of England Voluntary Aided Primary School,175,19,4,23
Essex,Farnham Church of England Primary School,41,6,3,9
Essex,Radwinter Church of England Voluntary Aided Primary School,132,13,3,16
Essex,Ingatestone and Fryerning Church of England Voluntary Aided Junior School,191,24,4,28
Essex,"St Francis Catholic Primary School, Braintree",210,15,2,17
Essex,Chrishall Holy Trinity and St Nicholas CofE (Aided) Primary School and Pre-School,117,5,0,5
Essex,St Michael's Church of England Voluntary Aided Junior School,232,35,11,46
Essex,"St Francis Catholic Primary School, Maldon",210,20,7,27
Essex,"Trinity St Mary's CofE Voluntary Aided Primary School, South Woodham Ferrers",186,14,6,20
Essex,"St Joseph's Catholic Primary School, SWF",180,30,6,36
Essex,"St Peters Church of England Voluntary Aided Primary School, West Hanningfield",107,12,1,13
Essex,"All Saints' Church of England Voluntary Aided Primary School, Dovercourt",191,32,4,36
Essex,The Bishops' Church of England and Roman Catholic Primary School,437,56,17,73
Essex,De La Salle School,761,75,28,103
Essex,"St John Payne Catholic School, Chelmsford",1197,159,24,183
Thurrock,Grays Convent High School,642,49,7,56
Essex,Elmwood Primary School,406,30,9,39
Essex,Great Totham Primary School,428,37,11,48
Essex,Holland Haven Primary School,404,66,11,77
Essex,Elmstead Primary School,211,32,4,36
Essex,Millfields Primary School,251,28,1,29
Essex,St Katherine's Church of England Primary School,218,19,9,28
Essex,Rodings Primary School,295,19,6,25
Essex,Kingswood Primary School and Nursery,454,44,12,56
Essex,St Mary's CofE Foundation Primary School,275,16,6,22
Essex,Buttsbury Infant School,364,19,8,27
Essex,St Andrew's CofE Primary School,357,34,11,45
Essex,Leverton Primary School,458,36,12,48
Essex,Thaxted Primary School,260,15,8,23
Essex,"The Cathedral Church of England Voluntary Aided Primary School, Chelmsford",316,42,6,48
Essex,Broomfield Primary School,379,43,7,50
Essex,Lawford Church of England Voluntary Aided Primary School,252,32,5,37
Essex,Great Dunmow Primary School,421,27,7,34
Essex,Dunmow St Mary's Primary School,470,46,6,52
Essex,Walton on the Naze Primary School,196,42,6,48
Essex,Chase Lane Primary School and Nursery,453,61,11,72
Essex,Collingwood Primary School,256,34,3,37
Essex,St Helen's Catholic Infant School,233,14,3,17
Essex,Thomas Willingale Primary School and Nursery,486,56,5,61
Essex,Upshire Primary Foundation School,230,49,4,53
Essex,Mersea Island School,402,55,12,67
Essex,Earls Colne Primary School and Nursery,407,44,4,48
Southend-on-Sea,Milton Hall Primary School and Nursery,706,95,21,116
Essex,Engaines Primary School and Nursery,317,38,5,43
Essex,Beauchamps High School,1416,155,36,191
Essex,St Benedict's Catholic College,887,148,21,169
Essex,Braeside School,155,20,0,20
Essex,New Hall School,1327,119,1,120
Essex,St Anne's School,137,17,0,17
Essex,St Cedd's School,357,7,0,7
Essex,Widford Lodge School,233,20,0,20
Essex,Chigwell School,1053,131,3,134
Essex,Loyola Preparatory School,158,16,0,16
Essex,St Mary's School for Girls,408,79,0,79
Essex,Felsted School,1037,189,0,189
Essex,Gosfield School,333,64,2,66
Essex,St John's School,292,66,0,66
Essex,Daiglen School,120,6,0,6
Southend-on-Sea,St. Michael's School,247,18,0,18
Southend-on-Sea,Thorpe Hall School,457,67,5,72
Southend-on-Sea,Alleyn Court Preparatory School,285,18,3,21
Southend-on-Sea,Saint Pierre School,125,16,0,16
Essex,Colchester Prep & High School,299,38,1,39
Essex,Holmwood House School,346,25,2,27
Essex,Elm Green Preparatory School,196,25,0,25
Essex,Heathcote School,98,5,0,5
Essex,Littlegarth School,310,69,0,69
Essex,St Philomena's School,128,6,0,6
Essex,St Margaret's Preparatory School,202,15,1,16
Essex,St Nicholas School,510,91,0,91
Essex,Oaklands School,246,0,0,0
Essex,Woodlands School,91,8,1,9
Essex,Maldon Court Preparatory School,159,14,0,14
Essex,Oxford House School,145,12,0,12
Essex,Woodcroft School,42,0,42,42
Essex,Doucecroft School,64,0,64,64
Essex,Ursuline Preparatory School,164,18,0,18
Essex,Brentwood School,1946,308,0,308
Essex,Howe Green House School,173,30,3,33
Essex,Coopersale Hall School,270,32,1,33
Essex,The Christian School (Takeley),37,12,1,13
Essex,Guru Gobind Singh Khalsa College,124,1,1,2
Essex,Cedar Hall School,169,1,168,169
Essex,The Edith Borthwick School,244,2,242,244
Essex,St John's RC School (Essex),99,0,99,99
Essex,Glenwood School,223,0,223,223
Essex,Shorefields School,153,0,153,153
Essex,Lexden Springs School,278,0,278,278
Gloucestershire,Widden Primary School,363,87,4,91
Gloucestershire,Tredworth Junior School,307,79,7,86
Gloucestershire,Linden Primary School,419,71,11,82
Gloucestershire,Hatherley Infant School,134,26,3,29
Gloucestershire,Calton Primary School,525,74,9,83
Gloucestershire,Elmbridge Primary School,625,67,16,83
Gloucestershire,Harewood Infant School,258,47,1,48
Gloucestershire,Harewood Junior School,352,72,7,79
Gloucestershire,Hillview Primary School,214,31,6,37
Gloucestershire,Dinglewell Junior School,361,55,13,68
Gloucestershire,Longlevens Junior School,479,66,10,76
Gloucestershire,Longlevens Infant School,360,26,2,28
Gloucestershire,Dinglewell Infant School,269,32,4,36
Gloucestershire,Ashchurch Primary School,138,19,3,22
Gloucestershire,Avening Primary School,110,29,3,32
Gloucestershire,Blakeney Primary School,101,28,4,32
Gloucestershire,Eastcombe Primary School,60,11,0,11
Gloucestershire,Bledington Primary School,76,15,1,16
Gloucestershire,Leighterton Primary School,96,12,2,14
Gloucestershire,Chalford Hill Primary School,198,25,2,27
Gloucestershire,Churcham Primary School,50,7,1,8
Gloucestershire,Churchdown Parton Manor Infant School,141,30,6,36
Gloucestershire,Churchdown Village Junior School,237,39,15,54
Gloucestershire,Birdlip Primary School,101,14,2,16
Gloucestershire,Woodside Primary School,100,15,4,19
Gloucestershire,St White's Primary School,273,45,7,52
Gloucestershire,Soudley School,64,15,4,19
Gloucestershire,Steam Mills Primary School,118,21,2,23
Gloucestershire,Eastington Primary School,139,15,0,15
Gloucestershire,The Rissington School,246,36,13,49
Gloucestershire,Sharpness Primary School,114,13,5,18
Gloucestershire,Kingswood Primary School,99,16,1,17
Gloucestershire,Lydbrook Primary School,103,21,6,27
Gloucestershire,Mickleton Primary School,198,17,2,19
Gloucestershire,Sheepscombe Primary School,71,9,0,9
Gloucestershire,Rodmarton Primary School,59,9,1,10
Gloucestershire,Slimbridge Primary School,131,28,7,35
Gloucestershire,Park Junior School,207,52,9,61
Gloucestershire,Stow-on-the-Wold Primary School,102,16,2,18
Gloucestershire,Stroud Valley Community Primary School,257,36,6,42
Gloucestershire,Uplands Community Primary School,106,12,2,14
Gloucestershire,Thrupp School,138,32,8,40
Gloucestershire,Tibberton Community Primary School and Early Years,120,18,5,23
Gloucestershire,Twyning School,128,13,3,16
Gloucestershire,Walmore Hill Primary School,48,16,1,17
Gloucestershire,Berry Hill Primary School,195,29,1,30
Gloucestershire,Coalway Junior School,221,38,7,45
Gloucestershire,Coalway Community Infant School,143,30,1,31
Gloucestershire,Ellwood Primary School,138,26,5,31
Gloucestershire,Parkend Primary School,55,12,0,12
Gloucestershire,Pillowell Community Primary School,89,17,4,21
Gloucestershire,Yorkley Primary School,159,22,4,26
Gloucestershire,Woolaston Primary School,136,18,5,23
Gloucestershire,Queen Margaret Primary School,167,34,13,47
Gloucestershire,Cashes Green Primary School,195,38,12,50
Gloucestershire,Innsworth Junior School,174,37,5,42
Gloucestershire,Northway Infant School,111,19,2,21
Gloucestershire,Churchdown Parton Manor Junior School,232,74,13,87
Gloucestershire,Rodborough Community Primary School,205,34,3,37
Gloucestershire,The Croft Primary School,130,11,2,13
Gloucestershire,Castle Hill Primary School,209,33,7,40
Gloucestershire,Callowell Primary School,137,20,3,23
Gloucestershire,Foxmoor Primary School,262,44,1,45
Gloucestershire,Gastrells Community Primary School,186,19,17,36
Gloucestershire,Cam Woodfield Infant School,142,27,3,30
Gloucestershire,Woodmancote School,416,68,7,75
Gloucestershire,Glenfall Community Primary School,207,21,12,33
Gloucestershire,Cam Everlands Primary School,211,23,8,31
Gloucestershire,Innsworth Infant School,109,18,4,22
Gloucestershire,Stonehouse Park Infant School,117,29,2,31
Gloucestershire,Dunalley Primary School,421,64,10,74
Gloucestershire,Gloucester Road Primary School,200,58,14,72
Gloucestershire,Greatfield Park Primary School,228,24,4,28
Gloucestershire,Naunton Park Primary School,416,34,11,45
Gloucestershire,Lakeside Primary School,553,76,9,85
Gloucestershire,Benhall Infant School,179,21,8,29
Gloucestershire,Beech Green Primary School,378,65,12,77
Gloucestershire,Abbeymead Primary School,449,70,11,81
Gloucestershire,Coney Hill Community Primary School,241,86,9,95
Gloucestershire,St Paul's Church of England Primary School,203,47,8,55
Gloucestershire,St James Church of England Junior School,165,44,2,46
Gloucestershire,Kingsholm Church of England Primary School,627,77,13,90
Gloucestershire,Hempsted Church of England Primary School,208,32,6,38
Gloucestershire,Bisley Blue Coat Church of England Primary School,66,15,3,18
Gloucestershire,Stratton Church of England Primary School,197,18,9,27
Gloucestershire,Coberley Church of England Primary School,64,11,1,12
Gloucestershire,Deerhurst and Apperley Church of England Primary School,72,8,0,8
Gloucestershire,Fairford Church of England Primary School,315,35,4,39
Gloucestershire,Haresfield Church of England Primary School,101,16,5,21
Gloucestershire,Hatherop Church of England Primary School,80,8,1,9
Gloucestershire,Kempsford Church of England Primary School,79,25,3,28
Gloucestershire,Littledean Church of England Primary School,93,22,8,30
Gloucestershire,Meysey Hampton Church of England Primary School,93,6,0,6
Gloucestershire,Nailsworth Church of England Primary School,200,25,9,34
Gloucestershire,Clearwell Church of England Primary School,56,13,2,15
Gloucestershire,Redbrook Church of England Primary School,25,5,0,5
Gloucestershire,Northleach Church of England Primary School,116,7,2,9
Gloucestershire,Norton Church of England Primary School,152,13,3,16
Gloucestershire,Pauntley Church of England Primary School,31,4,0,4
Gloucestershire,Randwick Church of England Primary School,87,19,2,21
Gloucestershire,Ruardean Church of England Primary School,85,15,11,26
Gloucestershire,Sherborne Church of England Primary School,55,7,1,8
Gloucestershire,Shurdington Church of England Primary School,197,18,4,22
Gloucestershire,Ann Edwards Church of England Primary School,240,41,7,48
Gloucestershire,Southrop Church of England Primary School,46,5,2,7
Gloucestershire,Temple Guiting Church of England School,86,12,2,14
Gloucestershire,Tewkesbury Church of England Primary School,261,49,8,57
Gloucestershire,Tutshill Church of England Primary School,213,21,3,24
Gloucestershire,Uley Church of England Primary School,109,15,3,18
Gloucestershire,Upton St Leonards Church of England Primary School,417,43,13,56
Gloucestershire,Whitminster Endowed Church of England Primary School,110,16,3,19
Gloucestershire,Willersey Church of England Primary School,50,6,3,9
Gloucestershire,Ashleworth Church of England Primary School,21,5,2,7
Gloucestershire,Down Ampney Church of England Primary School,41,9,2,11
Gloucestershire,Holy Trinity Church of England Primary School,208,28,6,34
Gloucestershire,Leckhampton Church of England Primary School,570,33,6,39
Gloucestershire,St John's Church of England Primary School,201,29,7,36
Gloucestershire,Oak Hill Church of England Primary School,44,10,2,12
Gloucestershire,Ampney Crucis Church of England Primary School,93,21,2,23
Gloucestershire,Oakridge Parochial School,29,10,1,11
Gloucestershire,Bromesberrow St Mary's Church of England (Aided) Primary School,54,14,0,14
Gloucestershire,Cam Hopton Church of England Primary School,208,19,5,24
Gloucestershire,Bussage Church of England Primary School,193,23,3,26
Gloucestershire,Holy Apostles' Church of England Primary School,210,17,1,18
Gloucestershire,St Andrew's Church of England Primary School,65,14,1,15
Gloucestershire,Powell's Church of England Primary School,423,45,10,55
Gloucestershire,Cranham Church of England Primary School,54,4,4,8
Gloucestershire,Ann Cam Church of England Primary School,87,13,1,14
Gloucestershire,Horsley Church of England Primary School,91,12,2,14
Gloucestershire,Huntley Church of England Primary School,91,6,0,6
Gloucestershire,Leonard Stanley Church of England Primary School,194,38,9,47
Gloucestershire,Amberley Parochial School,96,4,0,4
Gloucestershire,Brimscombe Church of England (VA) Primary School,97,8,3,11
Gloucestershire,Miserden Church of England Primary School,42,5,1,6
Gloucestershire,Mitcheldean Endowed Primary School,201,40,7,47
Gloucestershire,Newnham St Peter's Church of England Primary School,108,14,5,19
Gloucestershire,North Nibley CofE Primary School,110,10,0,10
Gloucestershire,Prestbury St Mary's Church of England Junior School,266,49,6,55
Gloucestershire,St Briavels Parochial Church of England Primary School,138,15,2,17
Gloucestershire,Sapperton Church of England Primary School,72,14,2,16
Gloucestershire,St Mary's Church of England VA Primary School,363,43,11,54
Gloucestershire,Westbury-on-Severn Church of England Primary School,73,9,2,11
Gloucestershire,Withington Church of England Primary School,33,2,1,3
Gloucestershire,Woodchester Endowed Church of England Aided Primary School,136,13,3,16
Gloucestershire,St Catharine's Catholic Primary School,118,13,2,15
Gloucestershire,St Joseph's Catholic Primary School,165,19,5,24
Gloucestershire,St Thomas More Catholic Primary School,217,42,6,48
Gloucestershire,St Mary's Church of England Infant School,175,12,5,17
Gloucestershire,St Mark's Church of England Junior School,240,45,6,51
Gloucestershire,Barnwood Church of England Primary School,187,26,4,30
Gloucestershire,Hillesley Church of England Primary School,36,8,1,9
Gloucestershire,Barnwood Park School,864,90,55,145
Gloucestershire,Archway School,901,120,25,145
Gloucestershire,The Catholic School of Saint Gregory the Great,421,72,14,86
Gloucestershire,Picklenash Junior School,191,39,3,42
Gloucestershire,Blue Coat CofE Primary School,315,41,6,47
Gloucestershire,Andoversford Primary School,73,6,1,7
Gloucestershire,Tirlebrook Primary School,213,34,4,38
Gloucestershire,The British School,176,12,8,20
Gloucestershire,Warden Hill Primary School,421,42,6,48
Gloucestershire,Glebe Infants' School,138,26,3,29
Gloucestershire,Swindon Village Primary School,423,61,14,75
Gloucestershire,Heron Primary School,413,48,13,61
Gloucestershire,Carrant Brook Junior School,163,37,6,43
Gloucestershire,Rednock School,1251,86,28,114
Gloucestershire,Pittville School,897,134,51,185
Gloucestershire,Maidenhill School,717,130,49,179
Gloucestershire,"The King's School, Gloucester",739,202,1,203
Gloucestershire,Hatherop Castle School,261,23,4,27
Gloucestershire,Dean Close St John's,124,23,1,24
Gloucestershire,Beaudesert Park School,414,72,0,72
Gloucestershire,Rendcomb College,409,129,4,133
Gloucestershire,Wycliffe College,621,157,4,161
Gloucestershire,Westonbirt School,743,168,6,174
Gloucestershire,St Edward's School,305,116,0,116
Gloucestershire,Cheltenham College,1165,185,0,185
Gloucestershire,Dean Close Preparatory School,454,62,0,62
Gloucestershire,Dean Close School,502,47,0,47
Gloucestershire,Cheltenham Ladies' College,878,50,0,50
Gloucestershire,Dean Close Airthrie,76,12,0,12
Gloucestershire,Berkhampstead School,257,30,5,35
Gloucestershire,The Richard Pate School,300,20,3,23
Gloucestershire,Cotswold Chine School,52,4,48,52
Gloucestershire,Hopelands Preparatory School,64,14,0,14
Gloucestershire,The Acorn School,65,17,0,17
Gloucestershire,Hartmore School,44,0,44,44
Gloucestershire,Al-Ashraf Secondary School for Girls,75,1,0,1
Gloucestershire,St Rose's Special School,69,11,40,51
Gloucestershire,Bettridge School,162,0,162,162
Gloucestershire,The Shrubberies School,130,0,130,130
Gloucestershire,Alderman Knight School,221,0,221,221
Hampshire,Haven Early Years Centre,119,34,0,34
Southampton,Hardmoor Early Years Centre,104,8,0,8
Hampshire,Rowhill School,26,21,5,26
Hampshire,Smannell Field School,15,9,6,15
Hampshire,The Bridge Education Centre,6,6,0,6
Hampshire,Greenwood School,16,12,4,16
Hampshire,Alton Infant School,147,21,2,23
Hampshire,Anstey Junior School,226,61,7,68
Hampshire,Balksbury Junior School,350,31,8,39
Hampshire,Portway Junior School,405,37,18,55
Hampshire,Anton Junior School,246,37,8,45
Hampshire,Ashley Infant School,194,27,25,52
Hampshire,Portway Infant School,272,16,12,28
Hampshire,Winklebury Junior School,195,20,16,36
Hampshire,Oakridge Infant School,332,82,13,95
Hampshire,South View Junior School,261,48,41,89
Hampshire,Beaulieu Village Primary School,120,10,8,18
Hampshire,Stoke Park Infant School,247,39,17,56
Hampshire,Bishops Waltham Infant School,195,18,5,23
Hampshire,Bordon Infant School,181,20,6,26
Hampshire,Braishfield Primary School,102,11,3,14
Hampshire,Broughton Primary School,92,15,1,16
Hampshire,Burghclere Primary School,111,13,12,25
Hampshire,Buriton Primary School,97,14,0,14
Hampshire,Burley Primary School,97,28,4,32
Hampshire,Stoke Park Junior School,359,41,15,56
Hampshire,Chandler's Ford Infant School,179,17,5,22
Hampshire,Merdon Junior School,254,34,8,42
Hampshire,Cheriton Primary School,89,15,4,19
Hampshire,North Baddesley Infant School,299,21,8,29
Hampshire,Clanfield Junior School,315,49,12,61
Hampshire,Cliddesden Primary School,111,11,3,14
Hampshire,Crondall Primary School,162,16,5,21
Hampshire,Curdridge Primary School,108,8,2,10
Hampshire,Crofton Anne Dale Junior School,357,39,9,48
Hampshire,Droxford Junior School,176,26,7,33
Hampshire,Denmead Infant School,241,16,4,20
Hampshire,Wildground Junior School,195,50,32,82
Hampshire,Fryern Junior School,300,51,6,57
Hampshire,Wildground Infant School,218,62,6,68
Hampshire,The Crescent Primary School,595,57,18,75
Hampshire,Cherbourg Primary School,383,94,35,129
Hampshire,Shakespeare Infant School,243,27,6,33
Hampshire,Wallisdean Junior School,207,27,7,34
Hampshire,Uplands Primary School,314,19,7,26
Hampshire,Fair Oak Infant School,440,50,12,62
Hampshire,Redlands Primary School,311,41,7,48
Hampshire,Wallisdean Infant School,167,18,2,20
Hampshire,Grateley Primary School,91,9,3,12
Hampshire,Greatham Primary School,198,13,6,19
Hampshire,Waterside Primary School,185,18,6,24
Hampshire,Hale Primary School,71,11,2,13
Hampshire,Hamble Primary School,366,45,9,54
Hampshire,Hambledon Primary School,105,7,5,12
Hampshire,Oakwood Infant School,251,7,7,14
Hampshire,Fairfield Infant School,257,34,3,37
Hampshire,Riders Junior School,263,55,15,70
Hampshire,Riders Infant School,171,15,6,21
Hampshire,Trosnant Junior School,236,49,18,67
Hampshire,Trosnant Infant School,176,48,4,52
Hampshire,Hawley Primary School,305,16,11,27
Hampshire,Mill Rythe Junior School,234,29,4,33
Hampshire,Tiptoe Primary School,130,13,27,40
Hampshire,Hythe Primary School,273,70,13,83
Hampshire,Freegrounds Infant School,219,35,1,36
Hampshire,Bosmere Junior School,356,58,2,60
Hampshire,Itchen Abbas Primary School,74,4,3,7
Hampshire,Kings Worthy Primary School,418,40,9,49
Hampshire,Langrish Primary School,211,2,2,4
Hampshire,Liss Junior School,224,30,15,45
Hampshire,Locks Heath Junior School,458,33,15,48
Hampshire,New Milton Infant School,232,23,8,31
Hampshire,New Milton Junior School,366,29,15,44
Hampshire,Newtown Soberton Infant School,66,4,1,5
Hampshire,North Waltham Primary School,141,6,4,10
Hampshire,Buryfields Infant School,180,9,4,13
Hampshire,Owslebury Primary School,94,12,4,16
Hampshire,Northern Junior School,217,37,6,43
Hampshire,Petersfield Infant School,325,21,12,33
Hampshire,Purbrook Infant School,267,35,4,39
Hampshire,Wicor Primary School,435,34,5,39
Hampshire,Springwood Infant School,150,35,2,37
Hampshire,Herne Junior School,482,77,19,96
Hampshire,Ringwood Junior School,376,17,10,27
Hampshire,Cupernham Junior School,340,25,5,30
Hampshire,St Mary Bourne Primary School,129,10,4,14
Hampshire,Sheet Primary School,97,17,2,19
Hampshire,Shipton Bellinger Primary School,183,32,5,37
Hampshire,Sopley Primary School,87,18,3,21
Hampshire,Stockbridge Primary & Pre-School,165,15,5,20
Hampshire,Tadley Community Primary School,249,23,6,29
Hampshire,Titchfield Primary School,195,29,6,35
Hampshire,Lydlynch Infant School,135,8,5,13
Hampshire,Eling Infant School and Nursery,144,39,7,46
Hampshire,Foxhills Junior School,346,38,10,48
Hampshire,Wallop Primary School,149,15,4,19
Hampshire,Wherwell Primary School,136,15,5,20
Hampshire,Stanmore Primary School,212,29,11,40
Hampshire,Winnall Primary School,185,24,14,38
Hampshire,Padnell Junior School,361,41,6,47
Hampshire,Padnell Infant School,254,15,7,22
Hampshire,Hart Plain Infant School,123,25,1,26
Hampshire,Crofton Anne Dale Infant School,261,12,3,15
Hampshire,Fryern Infant School,140,10,1,11
Hampshire,Vigo Primary School,565,112,36,148
Hampshire,Winklebury Infant School,167,12,9,21
Hampshire,Shamblehurst Primary School,448,69,10,79
Hampshire,Anton Infant School,178,10,4,14
Hampshire,Oakridge Junior School,345,80,14,94
Hampshire,South View Infant and Nursery School,225,43,34,77
Hampshire,Church Crookham Junior School,581,60,18,78
Hampshire,Orchard Infant School,250,43,6,49
Hampshire,Hiltingbury Infant School,271,18,12,30
Hampshire,Frogmore Infant School,170,15,5,20
Hampshire,Horndean Infant School,250,20,2,22
Hampshire,Pennington Infant School,73,24,3,27
Hampshire,Westfields Junior School,360,37,7,44
Hampshire,Wootey Infant School,158,39,4,43
Hampshire,Mengham Infant School,179,9,7,16
Hampshire,Orchard Junior School,358,48,10,58
Hampshire,Locks Heath Infant School,326,7,3,10
Hampshire,Harrison Primary School,628,30,7,37
Hampshire,Warren Park Primary School,419,124,15,139
Hampshire,Sun Hill Infant School,133,9,1,10
Hampshire,Westfields Infant School,264,19,10,29
Hampshire,Fair Oak Junior School,591,71,8,79
Hampshire,North Baddesley Junior School,316,36,8,44
Hampshire,Poulner Junior School,261,21,12,33
Hampshire,Freegrounds Junior School,362,58,7,65
Hampshire,Merton Junior School,264,62,18,80
Hampshire,Heatherside Infant School,272,9,5,14
Hampshire,Fleet Infant School,250,1,2,3
Hampshire,Merton Infant School,203,44,9,53
Hampshire,Castle Hill Primary School,648,75,15,90
Hampshire,Bishop's Waltham Junior School,287,38,5,43
Hampshire,Hiltingbury Junior School,383,22,20,42
Hampshire,Crofton Hammond Infant School,179,6,8,14
Hampshire,Heatherside Junior School,406,49,7,56
Hampshire,Sarisbury Infant School,259,21,4,25
Hampshire,Bishopswood Junior School,234,31,5,36
Hampshire,Knight's Enham Junior School,206,43,9,52
Hampshire,Manor Field Junior School,214,43,12,55
Hampshire,Kempshott Junior School,367,32,9,41
Hampshire,Ranvilles Junior School,238,47,3,50
Hampshire,Tweseldown Infant School,345,28,12,40
Hampshire,Liss Infant School,133,6,11,17
Hampshire,Purbrook Junior School,385,50,15,65
Hampshire,Marnel Community Infant School,360,21,18,39
Hampshire,Foxhills Infant School,179,23,2,25
Hampshire,The Butts Primary School,296,33,4,37
Hampshire,Knights Enham Nursery and Infant School,195,31,6,37
Hampshire,Bursledon Junior School(CA),321,42,13,55
Hampshire,Ranvilles Infant School,170,22,9,31
Hampshire,Northern Infant School,151,15,4,19
Hampshire,Poulner Infant School and Nursery,238,9,8,17
Hampshire,Park Gate Primary School,391,53,9,62
Hampshire,South Wonston Primary School,297,43,10,53
Hampshire,Bishopswood Infant School,171,13,2,15
Hampshire,Kempshott Infant School,270,24,7,31
Hampshire,Wootey Junior School,172,48,9,57
Hampshire,Roman Way Primary School,203,25,7,32
Hampshire,Old Basing Infant School,264,27,4,31
Hampshire,Rucstall Primary School,198,24,6,30
Hampshire,Castle Hill Infant School,179,23,3,26
Hampshire,Scantabout Primary School,214,25,3,28
Hampshire,Denmead Junior School,357,62,7,69
Hampshire,Tavistock Infant School,214,17,2,19
Hampshire,Hook Junior School,483,48,7,55
Hampshire,Olivers Battery Primary School,242,25,5,30
Hampshire,Oakley Infant School,173,16,3,19
Hampshire,Cupernham Infant School,252,14,5,19
Hampshire,Calmore Infant School,165,28,8,36
Hampshire,Lymington Junior School,256,14,0,14
Hampshire,Mengham Junior School,237,37,11,48
Hampshire,Bidbury Junior School,231,51,9,60
Hampshire,Velmead Junior School,383,13,3,16
Hampshire,Manor Field Infant School,164,21,5,26
Hampshire,Liphook Infant School,270,32,3,35
Hampshire,Chalk Ridge Primary School,344,34,15,49
Hampshire,Crofton Hammond Junior School,245,30,8,38
Hampshire,Potley Hill Primary School,231,22,8,30
Hampshire,Kings Copse Primary School,215,17,16,33
Hampshire,Netley Abbey Junior School,350,66,14,80
Hampshire,Balksbury Infant School,269,10,3,13
Hampshire,Petersgate Infant School,223,31,8,39
Hampshire,Springwood Junior School,210,65,6,71
Hampshire,Fordingbridge Junior School,205,39,13,52
Hampshire,Fordingbridge Infant School,154,7,7,14
Hampshire,Netley Abbey Infant School,263,21,12,33
Hampshire,Greenfields Junior School,288,33,13,46
Hampshire,Shakespeare Junior School,359,66,23,89
Hampshire,Marchwood Junior School,321,48,9,57
Hampshire,Colden Common Primary School,406,16,13,29
Hampshire,Mayhill Junior School,241,12,16,28
Hampshire,Woolton Hill Junior School,133,16,8,24
Hampshire,Norwood Primary School,439,31,6,37
Hampshire,Red Barn Community Primary School,211,30,6,36
Hampshire,Newlands Primary School,167,3,4,7
Hampshire,Four Lanes Infant School,269,13,7,20
Hampshire,Castle Primary School,411,67,18,85
Hampshire,Bidbury Infant School,180,11,6,17
Southampton,Bevois Town Primary School,408,67,17,84
Southampton,Bitterne Manor Primary School,240,31,10,41
Southampton,Bitterne Park Primary School,628,121,10,131
Southampton,Mount Pleasant Junior School,356,66,5,71
Southampton,Maytree Nursery and Infants' School,284,32,3,35
Southampton,St Denys Primary School,209,37,10,47
Southampton,St John's Primary and Nursery School,437,44,8,52
Southampton,Swaythling Primary School,210,39,8,47
Southampton,Banister Primary School,419,88,17,105
Southampton,Mansbridge Primary School,206,33,6,39
Southampton,Redbridge Primary School,208,73,4,77
Southampton,Moorlands Primary School,409,54,16,70
Southampton,Townhill Junior School,292,70,12,82
Hampshire,Hatch Warren Infant School,265,64,15,79
Southampton,Oakwood Primary School,414,45,9,54
Hampshire,Cove Junior School,300,59,5,64
Hampshire,Cove Infant School,171,18,2,20
Hampshire,Tower Hill Primary School,416,75,12,87
Hampshire,Marlborough Infant School,89,11,1,12
Hampshire,South Farnborough Infant School,296,19,10,29
Hampshire,North Farnborough Infant School,160,16,3,19
Hampshire,Manor Junior School,348,79,8,87
Hampshire,Grange Community Junior School,240,56,9,65
Hampshire,Talavera Junior School,416,61,11,72
Hampshire,Manor Infant School,205,20,7,27
Hampshire,Talavera Infant School,265,38,13,51
Hampshire,Parsonage Farm Nursery and Infant School,209,19,2,21
Hampshire,South Farnborough Junior School,410,44,22,66
Hampshire,Guillemont Junior School,368,64,33,97
Hampshire,Pinewood Infant School,97,10,25,35
Hampshire,Elson Junior School,302,42,12,54
Hampshire,Elson Infant School,248,40,7,47
Hampshire,Lee-on-the-Solent Junior School,333,55,7,62
Hampshire,Haselworth Primary School,133,25,7,32
Hampshire,Rowner Infant School,147,29,6,35
Hampshire,Alverstoke Community Infant School,175,11,1,12
Hampshire,Grange Junior School,290,51,15,66
Hampshire,Grange Infant School,205,41,9,50
Hampshire,Alver Valley Junior School,223,67,17,84
Hampshire,Peel Common Infant School and Nursery Unit,120,20,2,22
Hampshire,Alver Valley Infant and Nursery School,206,32,12,44
Hampshire,Peel Common Junior School,152,32,8,40
Hampshire,Gomer Infant School,180,24,3,27
Hampshire,Brockhurst Primary School,355,53,14,67
Hampshire,Lee-On-the-Solent Infant and Nursery School,284,19,5,24
Portsmouth,Bramble Infant School and Nursery,173,17,2,19
Portsmouth,Devonshire Infant School,181,16,10,26
Portsmouth,Cumberland Infant School,179,21,7,28
Portsmouth,Medina Primary School,203,23,5,28
Portsmouth,Southsea Infant School,181,14,10,24
Portsmouth,Fernhurst Junior School,353,37,9,46
Portsmouth,Craneswater Junior School,474,53,17,70
Hampshire,Orchard Lea Infant School,161,15,1,16
Hampshire,Orchard Lea Junior School,232,34,7,41
Portsmouth,Manor Infant and Nursery School,296,21,4,25
Hampshire,Hook Infant School,340,35,10,45
Hampshire,King's Furlong Infant School and Nursery,218,32,5,37
Hampshire,Kings Furlong Junior School,288,38,6,44
Hampshire,Fairfields Primary School,417,45,19,64
Hampshire,Park Primary School,202,41,8,49
Hampshire,Alderwood School,1459,236,54,290
Hampshire,Park View Primary School,449,61,21,82
Hampshire,Harestock Primary School,214,25,5,30
Hampshire,Weeke Primary School,408,26,15,41
Hampshire,Hazel Wood Infant School,195,11,9,20
Hampshire,Hart Plain Junior School,217,51,5,56
Hampshire,Southwood Infant School,115,12,7,19
Hampshire,Four Lanes Community Junior School,367,48,9,57
Hampshire,Queen's Inclosure Primary School,413,64,11,75
Hampshire,Berrywood Primary School,632,84,26,110
Hampshire,Woodlea Primary School,203,30,2,32
Southampton,Fairisle Infant and Nursery School,299,71,5,76
Southampton,Fairisle Junior School,383,61,5,66
Hampshire,Hatch Warren Junior School,341,50,27,77
Hampshire,Nightingale Primary School,391,74,21,95
Portsmouth,Portsdown Primary School,380,56,15,71
Hampshire,Emsworth Primary School,416,63,8,71
Southampton,Foundry Lane Primary School,588,94,13,107
Southampton,Shirley Warren Primary & Nursery School,452,72,9,81
Southampton,Mason Moor Primary School,204,54,5,59
Hampshire,Morelands Primary School,324,38,32,70
Hampshire,Abbotts Ann Church of England Primary School,107,17,3,20
Hampshire,Saint Lawrence Church of England Primary School,206,24,4,28
Hampshire,Ampfield Church of England Primary School,38,8,3,11
Hampshire,Andover Church of England Primary School,187,31,6,37
Hampshire,Barton Stacey Church of England Primary School,110,12,7,19
Hampshire,Binsted Church of England Primary School,84,9,1,10
Hampshire,Botley Church of England Controlled Primary School,386,44,8,52
Hampshire,Breamore Church of England Primary School,85,14,5,19
Hampshire,Brockenhurst Church of England Primary School & Pre-School,244,22,2,24
Hampshire,Bursledon Church of England Infant School,246,22,5,27
Hampshire,Bramley Church of England Primary School,427,48,17,65
Hampshire,Bentley Church of England Primary School,205,34,4,38
Hampshire,Catherington Church of England Infant School,89,5,3,8
Hampshire,Chawton Church of England Primary School,94,11,3,14
Hampshire,Copythorne CofE Infant School,80,3,2,5
Hampshire,Durley Church of England Controlled Primary School,139,22,6,28
Hampshire,East Meon Church of England Controlled Primary School,93,18,2,20
Hampshire,Ecchinswell and Sydmonton Church of England Primary School,58,9,2,11
Hampshire,St James Church of England Controlled Primary School,222,31,7,38
Hampshire,Four Marks Church of England Primary School,306,37,7,44
Hampshire,Froxfield Church of England Primary and Pre-School,101,14,1,15
Hampshire,Grayshott Church of England Controlled Primary School,202,25,7,32
Hampshire,Horndean Church of England Junior School,511,82,15,97
Hampshire,Hurstbourne Tarrant Church of England Primary School,95,16,0,16
Hampshire,Hyde Church of England Primary School,52,7,3,10
Hampshire,Kingsclere Church of England Primary School,206,18,5,23
Hampshire,King's Somborne Church of England Primary School,103,10,6,16
Hampshire,St John the Baptist Church of England Primary School,396,27,11,38
Hampshire,Long Sutton Church of England Primary School,100,10,3,13
Hampshire,Marchwood Church of England Infant School,202,24,5,29
Hampshire,Medstead Church of England Primary School,190,16,23,39
Hampshire,Meonstoke Church of England Infant School,58,4,0,4
Hampshire,Netley Marsh Church of England Infant School,81,2,3,5
Hampshire,Nursling Church of England Primary School,205,21,4,25
Hampshire,Otterbourne Church of England Primary School,318,12,11,23
Hampshire,Overton Church of England Primary School,378,42,4,46
Hampshire,Oakley Church of England Junior School,245,27,7,34
Hampshire,Pennington Church of England Junior School,147,21,7,28
Hampshire,Preston Candover Church of England Primary School,107,10,1,11
Hampshire,Ringwood Church of England Infant School,261,14,8,22
Hampshire,Rowlands Castle St John's Church of England Controlled Primary School,206,14,0,14
Hampshire,Rownhams St John's Church of England Primary School,326,31,5,36
Hampshire,Ropley CofE Primary School,178,22,8,30
Hampshire,Sarisbury Church of England Junior School,393,32,11,43
Hampshire,St John the Baptist Church of England Primary School,250,31,12,43
Hampshire,Sherborne St John Church of England Primary School,118,13,2,15
Hampshire,South Baddesley Church of England Primary School,145,26,6,32
Hampshire,Sparsholt Church of England Primary School,129,11,3,14
Hampshire,St Luke's Church of England Primary School,194,38,2,40
Hampshire,Steep Church of England Voluntary Controlled Primary School,103,22,5,27
Hampshire,Twyford St Mary's Church of England Primary School,149,14,4,18
Hampshire,Vernham Dean Gillum's Church of England Primary School,64,11,4,15
Hampshire,West Meon Church of England Voluntary Controlled Primary School,59,9,2,11
Hampshire,West Tytherley Church of England Primary School,54,12,2,14
Hampshire,Whitchurch Church of England Primary School,456,39,8,47
Hampshire,Wickham Church of England Primary School,246,33,11,44
Hampshire,All Saints Church of England Primary School,188,30,2,32
Hampshire,Western Church of England Primary School,410,40,5,45
Hampshire,"St Thomas' Church of England Infant School, Woolton Hill",111,13,2,15
Hampshire,St Bede Church of England Primary School,416,35,20,55
Hampshire,Liphook Church of England Controlled Junior School,368,43,7,50
Hampshire,Saint James' Church of England Primary School,603,73,8,81
Hampshire,St Michael's Church of England Controlled Infant School,263,33,10,43
Hampshire,St Michael's Church of England Controlled Junior School,363,41,14,55
Hampshire,Leesland Church of England Controlled Junior School,336,90,10,100
Hampshire,Leesland Church of England Controlled Infant School,179,48,3,51
Hampshire,Newtown Church of England Voluntary Controlled Primary School,322,80,5,85
Hampshire,Rowledge Church of England Controlled Primary School,213,26,8,34
Hampshire,Bartley Church of England Junior School,358,43,7,50
Southampton,Bitterne CE Primary School,418,62,12,74
Southampton,St Mark's Church of England School,599,86,20,106
Southampton,St Mary's Church of England Voluntary Controlled Primary School,580,80,11,91
Portsmouth,St Jude's CofE Primary School,421,70,12,82
Hampshire,Whitewater Church of England Primary School,101,14,5,19
Portsmouth,St George's Beneficial Church of England (Voluntary Controlled) Primary School,362,76,14,90
Hampshire,Amport Church of England Primary School,99,6,1,7
Hampshire,Appleshaw St Peter's CofE Primary School,88,12,1,13
Hampshire,St Mary's Church of England Voluntary Aided Junior School,352,44,8,52
Hampshire,St Mary's Bentworth Church of England Primary School,103,8,12,20
Hampshire,St Matthew's Church of England Aided Primary School,208,27,5,32
Hampshire,William Gilpin Church of England Primary School,133,4,11,15
Hampshire,Compton All Saints Church of England Primary School,107,7,3,10
Hampshire,Dogmersfield Church of England Primary School,108,11,4,15
Hampshire,St Martin's East Woodhay Church of England (Aided) Primary School,114,3,4,7
Hampshire,Charles Kingsley's Church of England Primary School,216,26,3,29
Hampshire,All Saints Church of England Aided Junior School,549,68,16,84
Hampshire,Andrews' Endowed Church of England Primary School,200,28,6,34
Hampshire,John Keble Church of England Primary School,151,22,7,29
Hampshire,St Alban's Church of England Aided Primary School,217,23,6,29
Hampshire,Lockerley Church of England Endowed Primary School,85,7,3,10
Hampshire,Longparish Church of England Primary School,105,11,2,13
Hampshire,Lymington Church of England Infant School,174,10,3,13
Hampshire,St Michael and All Angels CofE Infant School,58,0,3,3
Hampshire,Romsey Abbey Church of England Primary School,202,27,7,34
Hampshire,Silchester Church of England Primary School,180,19,9,28
Hampshire,Smannell and Enham Church of England (Aided) Primary School,89,17,1,18
Hampshire,Swanmore Church of England Aided Primary School,428,24,6,30
Hampshire,Upham Church of England Aided Primary School,102,7,2,9
Hampshire,Clatford Church of England Primary School,204,39,2,41
Hampshire,St Faith's Church of England Primary School,147,7,2,9
Hampshire,"Kimpton, Thruxton and Fyfield Church of England Primary School",198,23,2,25
Hampshire,St Jude's Catholic Primary School,217,34,5,39
Hampshire,"St Thomas More's Catholic Primary School, Havant",315,42,9,51
Hampshire,Our Lady and St Joseph Catholic Primary School,101,18,1,19
Hampshire,St Bede's Catholic Primary School,435,20,10,30
Hampshire,"St Peter's Catholic Primary School, Winchester",403,27,13,40
Hampshire,"St John the Baptist Catholic Primary School, Andover",215,13,5,18
Hampshire,"St Swithun Wells Catholic Primary School, Chandlers Ford",194,19,2,21
Portsmouth,St John's Cathedral Catholic Primary School,243,27,7,34
Portsmouth,St Swithun's Catholic Primary School,350,36,11,47
Hampshire,Western Downland Church of England Aided Primary School,203,19,4,23
Hampshire,St Peter's Church of England Aided Junior School,196,24,10,34
Hampshire,St Mark's Church of England Aided Primary School,104,7,2,9
Hampshire,St Patrick's Catholic Primary School,252,25,5,30
Hampshire,St Bernadette's Catholic Primary School,231,33,12,45
Hampshire,Alverstoke Church of England Aided Junior School,255,28,14,42
Hampshire,"St John's, Gosport Church of England Voluntary Aided Primary School",376,82,11,93
Hampshire,St Mary's Catholic Primary School,199,37,6,43
Southampton,Highfield Church of England Primary School,314,22,8,30
Southampton,Holy Family Catholic Primary School,418,93,7,100
Southampton,St Patrick's Catholic Primary School,418,54,6,60
Hampshire,Selborne Church of England Primary School,90,12,3,15
Hampshire,St John's Church of England Voluntary Aided Primary School,314,21,6,27
Hampshire,St Francis Church of England Primary School,410,16,6,22
Hampshire,Crookham Church of England Aided Infant School,167,21,6,27
Hampshire,John Hanson Community School,1002,109,26,135
Hampshire,The Westgate School,1625,139,50,189
Hampshire,The Toynbee School,1051,96,49,145
Hampshire,Court Moor School,1139,107,40,147
Hampshire,The Hamble School,1162,243,27,270
Hampshire,Portchester Community School,684,84,52,136
Hampshire,Brookfield Community School,1791,212,34,246
Hampshire,The Hurst School,1014,80,25,105
Hampshire,The Hayling College,573,109,26,135
Hampshire,Swanmore College,1371,97,28,125
Hampshire,Test Valley School,400,76,17,93
Hampshire,Aldworth School,885,119,16,135
Hampshire,Crookhorn College,889,207,43,250
Hampshire,The Clere School,463,58,14,72
Hampshire,Harrow Way Community School,981,110,45,155
Hampshire,Cranbourne,671,77,42,119
Hampshire,Yateley School,1251,153,21,174
Hampshire,Calthorpe Park School,1530,110,36,146
Hampshire,Horndean Technology College,1262,129,39,168
Hampshire,Henry Beaufort School,1056,64,29,93
Hampshire,The Vyne Community School,762,132,36,168
Hampshire,Brighton Hill Community School,1206,134,35,169
Hampshire,Frogmore Community College,711,56,36,92
Hampshire,Crestwood Community School,1403,166,78,244
Hampshire,Cove School,961,152,34,186
Hampshire,Fernhill School,647,140,33,173
Hampshire,The Wavell School,1015,133,44,177
Southampton,Regents Park Community College,899,195,25,220
Southampton,Redbridge Community School,1072,243,30,273
Southampton,Bitterne Park School,2020,375,122,497
Portsmouth,Mayfield School,1474,198,33,231
Southampton,Woodlands Community College,844,157,24,181
Hampshire,The Henry Cort Community College,853,135,10,145
Hampshire,Kings' School,1795,158,37,195
Southampton,Cantell School,1241,189,24,213
Hampshire,Park Community School,950,312,48,360
Hampshire,Warblington School,671,120,19,139
Hampshire,Bishop Challoner Catholic Secondary School,890,70,29,99
Hampshire,Abbotswood Junior School,609,91,20,111
Hampshire,Calmore Junior School,237,37,11,48
Hampshire,Hordle CofE (VA) Primary School,397,49,12,61
Portsmouth,St Paul's Catholic Primary School,303,44,7,51
Hampshire,Ashley Junior School,258,44,25,69
Hampshire,"St Peter's Catholic Primary School, Waterlooville",432,27,4,31
Hampshire,Mill Rythe Infant School,209,11,4,15
Hampshire,Crofton School,1092,129,57,186
Hampshire,Testbourne Community School,932,117,21,138
Hampshire,Applemore College,624,65,62,127
Portsmouth,St Edmund's Catholic School,1120,155,23,178
Hampshire,Purbrook Park School,880,55,21,76
Southampton,Saint George Catholic Voluntary Aided College Southampton,994,137,22,159
Hampshire,Osborne School,222,2,220,222
Hampshire,Rookwood School,256,54,6,60
Hampshire,Sherborne House School,280,17,1,18
Hampshire,Embley,639,102,8,110
Hampshire,St Neot's School,283,119,2,121
Hampshire,Farnborough Hill,555,88,0,88
Hampshire,St Nicholas' School,319,82,7,89
Hampshire,Forres Sandle Manor School,132,20,0,20
Hampshire,Cheam School,393,61,0,61
Hampshire,Lord Wandsworth College,669,203,0,203
Hampshire,Durlston Court School,252,66,1,67
Hampshire,Ballard School,500,128,4,132
Hampshire,Walhampton School,363,85,3,88
Hampshire,Horris Hill School,119,2,0,2
Hampshire,Bedales School,477,140,0,140
Hampshire,"Stroud, the King Edward VI Preparatory School",295,52,2,54
Hampshire,Winchester College,715,84,1,85
Hampshire,St Swithuns,705,107,2,109
Hampshire,The Pilgrims School,239,72,2,74
Hampshire,Twyford School,440,60,1,61
Hampshire,Alton School,358,95,3,98
Hampshire,Farleigh School,474,68,3,71
Hampshire,Salesian College,633,75,3,78
Hampshire,Daneshill School,314,0,1,1
Hampshire,West Hill Park School,256,58,1,59
Hampshire,Prince's Mead School,292,61,2,63
Hampshire,Yateley Manor School,296,30,1,31
Hampshire,Hurst Lodge School,146,21,104,125
Hampshire,Boundary Oak School,443,57,1,58
Hampshire,Moyles Court School,222,43,3,46
Hampshire,Meoncross School,345,73,1,74
Hampshire,Southlands School,44,0,43,43
Hampshire,Hill House School,27,1,26,27
Southampton,CHARLTON HOUSE SCHOOL LIMITED,33,5,0,5
Southampton,The Gregg School,357,34,6,40
Southampton,The Gregg Preparatory School,101,7,1,8
Portsmouth,Mayville High School,492,161,1,162
Hampshire,Brockwood Park School,84,14,0,14
Hampshire,Ditcham Park School,419,109,2,111
Hampshire,Churcher's College,1288,158,1,159
Southampton,King Edward VI School,987,168,2,170
Portsmouth,Portsmouth High School,511,35,0,35
Portsmouth,The Portsmouth Grammar School,1348,310,2,312
Hampshire,St Edward's School,63,0,63,63
Hampshire,Coxlease School,105,1,104,105
Hampshire,Grateley House School,24,0,24,24
Hampshire,The Loddon School,30,0,30,30
Hampshire,Thorngrove School,240,27,0,27
Dorset,The Forum School,18,0,18,18
Hampshire,St Michael's School,69,3,0,3
Hampshire,The King's School,229,35,6,41
Hampshire,Riverside Community Special School,132,0,132,132
Hampshire,Lakeside School,89,0,89,89
Hampshire,Norman Gate School,110,20,90,110
Hampshire,Maple Ridge School,99,0,99,99
Hampshire,Heathfield Special School,133,0,133,133
Hampshire,Icknield School,86,7,79,86
Hampshire,Rachel Madocks School,99,4,95,99
Hampshire,Limington House School,99,0,99,99
Hampshire,Baycroft School,190,0,190,190
Hampshire,St Francis Special School,104,1,103,104
Southampton,Springwell School,271,5,266,271
Southampton,The Cedar School,92,6,86,92
Southampton,The Polygon School,69,0,69,69
Southampton,Vermont School,50,0,50,50
Hampshire,The Waterloo School,82,0,82,82
Hampshire,Saxon Wood School,43,8,35,43
Hampshire,Wolverdene Special School,57,0,57,57
Hampshire,Treloar School,74,0,74,74
Hampshire,Oak Lodge School,157,0,157,157
Hampshire,Glenwood School,107,0,107,107
Hampshire,Samuel Cody School,268,0,268,268
Hampshire,The Mark Way School,93,0,93,93
Hampshire,Shepherds Down Special School,168,0,168,168
"Herefordshire, County of",Almeley Primary School,55,10,1,11
Worcestershire,Crown Meadow First School & Nursery,332,31,3,34
Worcestershire,Ashton-under-Hill First School,100,20,0,20
Worcestershire,Beoley First School,97,11,1,12
Worcestershire,Broadway First School,83,19,1,20
Worcestershire,Catshill First School,328,58,3,61
Worcestershire,Charford First School,527,55,5,60
Worcestershire,Finstall First School,300,14,3,17
Worcestershire,Lickey End First School,150,11,3,14
Worcestershire,Meadows First School,339,72,16,88
Worcestershire,Millfields First School,290,49,4,53
Worcestershire,Blackwell First School,151,25,3,28
"Herefordshire, County of",Clifford Primary School,97,9,1,10
Worcestershire,Clifton upon Teme Primary School,78,10,2,12
Worcestershire,Dodford First School,73,12,1,13
Worcestershire,Westlands First School,242,43,10,53
Worcestershire,Chawson First School,370,77,6,83
Worcestershire,Swan Lane First School,315,44,6,50
"Herefordshire, County of",Ewyas Harold Primary School,108,23,2,25
Worcestershire,Fairfield First School,138,11,0,11
Worcestershire,Flyford Flavell Primary School,115,14,1,15
"Herefordshire, County of",Garway Primary School,105,20,1,21
Worcestershire,Hagley Primary School,628,76,6,82
"Herefordshire, County of",Broadlands Primary School,134,33,5,38
"Herefordshire, County of",Hampton Dene Primary School,265,39,51,90
"Herefordshire, County of",Marlbrook Primary School,648,144,8,152
"Herefordshire, County of",St Martin's Primary School,358,85,3,88
"Herefordshire, County of",Trinity Primary School,571,66,11,77
"Herefordshire, County of",Kington Primary School,216,33,8,41
"Herefordshire, County of",Ledbury Primary School,391,63,9,72
"Herefordshire, County of",Longtown Community Primary School,65,6,1,7
"Herefordshire, County of",Luston Primary School,102,26,1,27
"Herefordshire, County of",Madley Primary School,213,17,3,20
"Herefordshire, County of",Michaelchurch Escley Primary School,62,9,1,10
Worcestershire,Pebworth First School,23,4,2,6
Worcestershire,Abbey Park First and Nursery School,187,32,6,38
"Herefordshire, County of",Peterchurch Primary School,87,15,2,17
Worcestershire,Batchley First and Nursery School,297,85,5,90
Worcestershire,Tenacres First School,284,47,6,53
Worcestershire,Woodrow First School,295,59,6,65
"Herefordshire, County of",Ashfield Park Primary School,315,51,3,54
"Herefordshire, County of",Shobdon Primary School,89,12,2,14
Worcestershire,Stoke Prior First School,150,4,1,5
"Herefordshire, County of",Stoke Prior Primary School,93,11,1,12
"Herefordshire, County of",Walford Nursery & Primary School,197,21,3,24
"Herefordshire, County of",Wellington Primary School and Nursery,61,3,3,6
"Herefordshire, County of",Weobley Primary School,196,30,5,35
"Herefordshire, County of",Withington Primary School,87,16,3,19
Worcestershire,Meadow Green Primary School,298,50,4,54
Worcestershire,Moons Moat First School,232,71,3,74
Worcestershire,Beaconside Primary and Nursery School,238,23,8,31
Worcestershire,Pitmaston Primary School,628,51,10,61
Worcestershire,Lickey Hills Primary School and Nursery,414,55,8,63
Worcestershire,Abbey Park Middle School,107,27,10,37
Worcestershire,Westacre Middle School,449,73,11,84
Worcestershire,Abberley Parochial VC Primary School,117,15,0,15
Worcestershire,Bayton CofE Primary School,107,15,2,17
Worcestershire,Belbroughton CofE Primary School,168,21,5,26
Worcestershire,Blakedown CofE Primary School,201,22,1,23
"Herefordshire, County of",Bosbury CofE Primary School,147,24,5,29
Worcestershire,Church Lench CofE First School,74,8,3,11
Worcestershire,Claines CofE Primary School,205,20,7,27
Worcestershire,Cleeve Prior CofE (Controlled) Primary School,33,6,0,6
"Herefordshire, County of",Clehonger CofE Primary School,89,21,2,23
Worcestershire,Clent Parochial Primary School,108,20,4,24
"Herefordshire, County of",Colwall CofE Primary School,170,23,2,25
"Herefordshire, County of",St Mary's CofE Primary School,167,25,1,26
Worcestershire,Cropthorne-with-Charlton CofE First School,88,7,0,7
Worcestershire,Defford-Cum-Besford CofE School,53,2,4,6
"Herefordshire, County of",Eardisley CofE Primary School,109,11,3,14
Worcestershire,Eckington CofE First School,69,9,0,9
Worcestershire,Eldersfield Lawn CofE Primary School,104,8,3,11
Worcestershire,Elmley Castle CofE First School,79,8,1,9
Worcestershire,St Richard's CofE First School,320,66,13,79
Worcestershire,St Andrew's CofE School and Nursery,376,61,7,68
"Herefordshire, County of",Goodrich CofE Primary School,130,22,2,24
"Herefordshire, County of",Gorsley Goffs Primary School,207,20,1,21
Worcestershire,Grimley and Holt CofE Primary School,99,6,1,7
Worcestershire,Hanbury CofE First School,135,13,3,16
Worcestershire,Harvington CofE First School,175,32,10,42
Worcestershire,Himbleton CofE Primary School and Nursery,97,12,4,16
Worcestershire,Hindlip CofE First School,87,18,1,19
"Herefordshire, County of",Little Dewchurch CofE Primary School,87,12,2,14
Worcestershire,Malvern Wyche CofE Primary School,137,19,4,23
"Herefordshire, County of",Much Birch CofE Primary School,179,18,0,18
"Herefordshire, County of",Orleton CofE Primary School,171,22,3,25
Worcestershire,Overbury CofE First School,86,8,4,12
Worcestershire,Pendock CofE Primary School,47,11,2,13
Worcestershire,St Luke's CofE First School,148,20,9,29
Worcestershire,Romsley St Kenelm's CofE Primary School,197,31,3,34
Worcestershire,Sedgeberrow CofE First School,180,20,4,24
Worcestershire,Tibberton CofE First School,68,9,0,9
Worcestershire,Upton-Upon-Severn CofE Primary and Pre School,189,26,3,29
Worcestershire,Upton Snodsbury CofE First School,40,6,1,7
Worcestershire,Whittington CofE Primary School,211,30,6,36
Worcestershire,St Barnabas CofE Primary School,408,78,10,88
Worcestershire,Red Hill CofE Primary School,368,48,8,56
Worcestershire,Astley CofE Primary School,91,8,1,9
Worcestershire,St Andrew's CofE First School,219,25,7,32
"Herefordshire, County of",Brampton Abbotts CofE Primary School,130,20,4,24
Worcestershire,Bredon Hancock's Endowed CofE First School,155,31,3,34
"Herefordshire, County of",Bridstow CofE Primary School,90,10,2,12
Worcestershire,Broadwas CofE Aided Primary School,87,14,7,21
"Herefordshire, County of",Cradley CofE Primary School,109,15,0,15
Worcestershire,St Joseph's Catholic Primary School,194,30,2,32
Worcestershire,Fladbury CofE First School,75,13,1,14
"Herefordshire, County of",St Mary's CofE Primary School,132,20,1,21
Worcestershire,Hallow CofE Primary School,184,25,1,26
"Herefordshire, County of",Our Lady's RC Primary School,206,30,5,35
"Herefordshire, County of",St Francis Xavier's Primary School,211,20,2,22
"Herefordshire, County of",St James' CofE Primary School,216,25,5,30
"Herefordshire, County of",Kimbolton St James CofE Primary School,88,10,1,11
"Herefordshire, County of",Kingsland CofE School,157,34,3,37
"Herefordshire, County of",Lea CofE Primary School,100,35,3,38
"Herefordshire, County of",Leintwardine Endowed CE Primary School,84,18,3,21
"Herefordshire, County of",Ivington CofE Primary and Pre-School,125,28,0,28
Worcestershire,Lindridge St Lawrence CE Primary School,78,17,3,20
Worcestershire,St Joseph's Catholic Primary School,114,13,6,19
Worcestershire,Malvern Wells CofE Primary School,84,12,2,14
Worcestershire,St James' CofE Primary School,70,6,4,10
"Herefordshire, County of",Much Marcle CofE Primary School,82,14,1,15
Worcestershire,Ombersley Endowed First School,121,20,4,24
"Herefordshire, County of",Pembridge CofE Primary School,80,14,1,15
"Herefordshire, County of",Pencombe CofE Primary School,61,8,0,8
Worcestershire,Holy Redeemer Catholic Primary School,167,33,2,35
"Herefordshire, County of",St Joseph's RC Primary School,156,21,1,22
"Herefordshire, County of",Staunton-on-Wye Endowed Primary School,90,12,0,12
Worcestershire,Sytchampton Endowed Primary School,93,13,4,17
Worcestershire,Tardebigge CofE First School,145,17,1,18
"Herefordshire, County of",Weston-under-Penyard CofE Primary School,64,9,1,10
"Herefordshire, County of",Whitchurch CofE Primary School,136,11,0,11
Worcestershire,Our Lady Queen of Peace Catholic Primary,185,9,2,11
Worcestershire,St George's CofE Primary School,169,21,5,26
Worcestershire,St George's Catholic Primary School,210,18,2,20
Worcestershire,St Joseph's Catholic Primary School,353,33,4,37
Worcestershire,North Bromsgrove High School,1006,156,24,180
"Herefordshire, County of",Aylestone School,454,144,21,165
"Herefordshire, County of",Earl Mortimer College and Sixth Form Centre,510,96,14,110
"Herefordshire, County of",Weobley High School,528,107,25,132
Worcestershire,Aston Fields Middle School,597,48,6,54
Worcestershire,Catshill Middle School,403,81,6,87
Worcestershire,Parkside Middle School,606,91,23,114
Worcestershire,Blackminster Middle School,252,37,8,45
Worcestershire,St Egwin's CofE Middle School,451,52,6,58
"Herefordshire, County of",The Bishop of Hereford's Bluecoat School,1044,122,23,145
"Herefordshire, County of",St Mary's RC High School,748,138,21,159
Worcestershire,Blessed Edward Oldcorne Catholic College,1045,100,23,123
"Herefordshire, County of","The Downs, Malvern College Prep School",176,31,1,32
"Herefordshire, County of",The Elms School,156,20,2,22
Worcestershire,Abberley Hall,160,30,2,32
Worcestershire,Bromsgrove School,2095,229,2,231
Worcestershire,Malvern College,649,109,2,111
Worcestershire,Malvern St James,355,58,1,59
Worcestershire,Heathfield Knoll School,243,30,38,68
Worcestershire,Cambian New Elizabethan School,44,0,44,44
Worcestershire,Bredon School,225,63,112,175
Worcestershire,Sunfield Children's Home Ltd,43,0,43,43
Worcestershire,Bowbrook House School,212,11,9,20
Worcestershire,Abbey College in Malvern,35,0,0,0
"Herefordshire, County of",Hereford Cathedral School,561,109,0,109
Worcestershire,The King's School,1335,166,3,169
Worcestershire,Royal Grammar School Worcester,1428,371,5,376
Worcestershire,The River School,122,14,7,21
"Herefordshire, County of",Rowden House School,20,0,20,20
Worcestershire,Madinatul Uloom Al Islamiya School,223,0,0,0
"Herefordshire, County of",Lucton School,265,6,0,6
"Herefordshire, County of",Hereford Cathedral Junior School,203,26,0,26
"Herefordshire, County of",Cambian Hereford School,15,1,14,15
Worcestershire,Rigby Hall Day Special School,203,0,203,203
"Herefordshire, County of",Blackmarston School,99,2,97,99
"Herefordshire, County of",Westfield School,72,0,72,72
Worcestershire,Chadsgrove School,139,9,130,139
Worcestershire,New College Worcester (NMSS),70,0,70,70
Hertfordshire,Weston Way Nursery School,77,5,0,5
Hertfordshire,Arlesdene Nursery School and Pre-School,136,17,13,30
Hertfordshire,Greenfield Nursery School,124,11,6,17
Hertfordshire,Batford Nursery School,84,1,0,1
Hertfordshire,Birchwood Nursery School,175,9,9,18
Hertfordshire,Heath Lane Nursery School,77,6,0,6
Hertfordshire,York Road Nursery School,107,7,5,12
Hertfordshire,Rye Park Nursery School,138,26,7,33
Hertfordshire,Kingswood Nursery School,102,7,0,7
Hertfordshire,Oxhey Nursery School,90,7,1,8
Hertfordshire,Tenterfield Nursery School,66,12,0,12
Hertfordshire,Ludwick Nursery School,168,16,12,28
Hertfordshire,Peartree Way Nursery School,124,22,3,25
Hertfordshire,Abbots Langley School,434,61,5,66
Hertfordshire,Ashwell Primary School,216,29,0,29
Hertfordshire,Jenyns First School and Nursery,74,6,0,6
Hertfordshire,Bushey Heath Primary School,238,18,8,26
Hertfordshire,Highwood Primary School,434,57,3,60
Hertfordshire,Merry Hill Infant School and Nursery,209,19,1,20
Hertfordshire,Holdbrook Primary School and Nursery,197,37,4,41
Hertfordshire,Four Swannes Primary School,202,24,1,25
Hertfordshire,Chorleywood Primary School,229,30,6,36
Hertfordshire,Shepherd Primary,230,45,2,47
Hertfordshire,Hobletts Manor Junior School,225,40,4,44
Hertfordshire,The Russell School,221,19,1,20
Hertfordshire,Cowley Hill School,436,44,13,57
Hertfordshire,Flamstead Village School,94,9,2,11
Hertfordshire,Gaddesden Row JMI School,41,4,0,4
Hertfordshire,Sauncey Wood Primary School,192,25,12,37
Hertfordshire,Manland Primary School,205,12,4,16
Hertfordshire,Green Lanes Primary School,414,42,5,47
Hertfordshire,George Street Primary School,232,26,7,33
Hertfordshire,Boxmoor Primary School,233,17,7,24
Hertfordshire,Two Waters Primary School,239,8,7,15
Hertfordshire,Tudor Primary School,434,82,13,95
Hertfordshire,South Hill Primary School,413,44,13,57
Hertfordshire,Abel Smith School,228,24,4,28
Hertfordshire,Hexton Junior Mixed and Infant School,21,5,1,6
Hertfordshire,Highbury Infant School and Nursery,217,18,0,18
Hertfordshire,Strathmore Infant and Nursery School,198,20,5,25
Hertfordshire,Highover Junior Mixed and Infant School,435,78,9,87
Hertfordshire,Hunsdon Junior Mixed and Infant School,110,19,2,21
Hertfordshire,Kimpton Primary School,176,27,2,29
Hertfordshire,Breachwood Green Junior Mixed and Infant School,82,14,4,18
Hertfordshire,Knebworth Primary and Nursery School,427,29,3,32
Hertfordshire,Hillshott Infant School and Nursery,212,25,4,29
Hertfordshire,Hertford Heath Primary and Nursery School,209,23,9,32
Hertfordshire,Little Hadham Primary School,125,17,2,19
Hertfordshire,Markyate Village School and Nursery,218,19,4,23
Hertfordshire,Pirton School,143,24,3,27
Hertfordshire,Reed First School,45,4,1,5
Hertfordshire,Yorke Mead Primary School,428,56,16,72
Hertfordshire,Harvey Road Primary School,240,22,6,28
Hertfordshire,Little Green Junior School,348,46,5,51
Hertfordshire,Malvern Way Infant and Nursery School,292,12,3,15
Hertfordshire,Tannery Drift School,311,38,0,38
Hertfordshire,Bernards Heath Infant and Nursery School,309,23,8,31
Hertfordshire,Camp Primary and Nursery School,235,31,6,37
Hertfordshire,St Peter's School,321,20,5,25
Hertfordshire,Aboyne Lodge Junior Mixed and Infant School,198,23,4,27
Hertfordshire,Bernards Heath Junior School,354,32,9,41
Hertfordshire,St Paul's Walden Primary School,76,15,1,16
Hertfordshire,Colney Heath Junior Mixed Infant and Nursery School,209,27,6,33
Hertfordshire,London Colney Primary & Nursery School,187,15,7,22
Hertfordshire,Sandon Junior Mixed and Infant School,60,8,3,11
Hertfordshire,Sandridge School,166,20,7,27
Hertfordshire,Fawbert and Barnard Infants' School,217,8,4,12
Hertfordshire,Shenley Primary School,177,16,4,20
Hertfordshire,Letchmore Infants' and Nursery School,303,32,6,38
Hertfordshire,Therfield First School,54,14,0,14
Hertfordshire,Walkern Primary School,114,19,0,19
Hertfordshire,Central Primary School,403,55,20,75
Hertfordshire,Bushey and Oxhey Infant School,174,4,1,5
Hertfordshire,Chater Junior School,239,15,3,18
Hertfordshire,Chater Infant School,221,19,6,25
Hertfordshire,Field Junior School,265,41,9,50
Hertfordshire,Watford Field School (Infant & Nursery),231,21,3,24
Hertfordshire,Parkgate Junior School,237,33,9,42
Hertfordshire,Parkgate Infants' and Nursery School,202,19,3,22
Hertfordshire,St Meryl School,232,30,4,34
Hertfordshire,Cassiobury Junior School,357,38,8,46
Hertfordshire,Kingsway Junior School,225,47,7,54
Hertfordshire,Watton-at-Stone Primary and Nursery School,230,33,2,35
Hertfordshire,Templewood Primary School,224,21,9,30
Hertfordshire,Holwell Primary School,406,43,15,58
Hertfordshire,Widford School,48,3,2,5
Hertfordshire,Wymondley Junior Mixed and Infant School,99,14,2,16
Hertfordshire,Tanners Wood Junior Mixed and Infant School,439,65,6,71
Hertfordshire,Hurst Drive Primary School,397,43,17,60
Hertfordshire,Woodlands Primary School,225,27,6,33
Hertfordshire,Summerswood Primary School,352,29,11,40
Hertfordshire,Kenilworth Primary School,199,46,6,52
Hertfordshire,Icknield Infant and Nursery School,256,41,3,44
Hertfordshire,Bowmansgreen Primary School,339,48,3,51
Hertfordshire,Margaret Wix Primary School,135,15,8,23
Hertfordshire,Broom Barns Primary School,227,63,10,73
Hertfordshire,Greenfields Primary School,201,35,9,44
Hertfordshire,Woodhall Primary School,125,43,4,47
Hertfordshire,Saffron Green Primary School,194,37,5,42
Hertfordshire,Hobletts Manor Infants' School,217,29,6,35
Hertfordshire,Bedwell Primary School,286,70,10,80
Hertfordshire,Chaulden Infants' and Nursery,136,25,9,34
Hertfordshire,Peartree Spring Primary School,623,127,16,143
Hertfordshire,Roundwood Primary School,332,36,10,46
Hertfordshire,Chambersbury Primary School,203,55,6,61
Hertfordshire,Windermere Primary School,179,17,5,22
Hertfordshire,Anstey First School,51,18,1,19
Hertfordshire,Monksmead School,230,38,11,49
Hertfordshire,Howe Dell Primary School,454,45,8,53
Hertfordshire,Almond Hill Junior School,317,36,8,44
Hertfordshire,Oakwood Primary School,320,31,3,34
Hertfordshire,Northfields Infants and Nursery School,176,30,4,34
Hertfordshire,Purwell Primary School,176,27,5,32
Hertfordshire,Harwood Hill Junior Mixed Infant and Nursery School,191,16,4,20
Hertfordshire,Creswick Primary & Nursery School,419,62,8,70
Hertfordshire,Thorley Hill Primary School,231,34,0,34
Hertfordshire,Micklem Primary School,219,48,7,55
Hertfordshire,Brookland Junior School,334,27,15,42
Hertfordshire,The Reddings Primary School,216,53,5,58
Hertfordshire,How Wood Primary and Nursery School,220,19,5,24
Hertfordshire,Redbourn Primary School,438,37,10,47
Hertfordshire,Bushey Manor Junior School,233,34,4,38
Hertfordshire,Goffs Oak Primary & Nursery School,233,18,4,22
Hertfordshire,Eastbury Farm Primary School,341,14,5,19
Hertfordshire,Gade Valley Primary School,227,22,3,25
Hertfordshire,Cunningham Hill Junior School,238,43,3,46
Hertfordshire,Homerswood Primary and Nursery School,226,21,7,28
Hertfordshire,Whitehill Junior School,242,30,3,33
Hertfordshire,Westfield Primary School and Nursery,212,23,4,27
Hertfordshire,Downfield Primary School,450,150,17,167
Hertfordshire,Pixies Hill Primary School,209,38,4,42
Hertfordshire,The Grove Junior School,357,62,6,68
Hertfordshire,Pixmore Junior School,240,34,7,41
Hertfordshire,Swing Gate Infant School and Nursery,149,28,4,32
Hertfordshire,Oaklands Primary School,198,13,10,23
Hertfordshire,Hollybush Primary School,222,55,12,67
Hertfordshire,Maple Cross Junior Mixed Infant and Nursery School,167,27,5,32
Hertfordshire,Moss Bury Primary School and Nursery,258,31,9,40
Hertfordshire,Westfield Community Primary School,185,20,7,27
Hertfordshire,Priors Wood Primary School,203,41,8,49
Hertfordshire,Brookland Infant and Nursery School,282,22,6,28
Hertfordshire,Goldfield Infants' and Nursery School,219,20,3,23
Hertfordshire,Greenway Primary and Nursery School,232,34,5,39
Hertfordshire,Thorn Grove Primary School,217,18,8,26
Hertfordshire,Icknield Walk First School,344,59,3,62
Hertfordshire,Cunningham Hill Infant School,180,40,3,43
Hertfordshire,Reedings Junior School,241,27,5,32
Hertfordshire,The Grove Infant and Nursery School,297,26,4,30
Hertfordshire,Kings Langley Primary School,449,54,1,55
Hertfordshire,Forres Primary School,307,47,20,67
Hertfordshire,Arnett Hills Junior Mixed and Infant School,207,15,7,22
Hertfordshire,Holywell Primary School,232,39,7,46
Hertfordshire,Trotts Hill Primary and Nursery School,237,46,1,47
Hertfordshire,Cassiobury Infant and Nursery School,307,26,6,32
Hertfordshire,Panshanger Primary School,233,66,7,73
Hertfordshire,Bournehall Primary School,209,19,10,29
Hertfordshire,Mill Mead Primary School,231,19,6,25
Hertfordshire,Maple Primary School,242,25,13,38
Hertfordshire,Andrews Lane Primary School,197,37,3,40
Hertfordshire,Newberries Primary School,179,22,4,26
Hertfordshire,Rickmansworth Park Junior Mixed and Infant School,198,19,1,20
Hertfordshire,Mandeville Primary School,226,12,10,22
Hertfordshire,Giles Junior School,329,90,20,110
Hertfordshire,Millfield First and Nursery School,349,47,7,54
Hertfordshire,Hillmead Primary School,251,38,8,46
Hertfordshire,Nascot Wood Junior School,240,22,4,26
Hertfordshire,The Ryde School,224,33,3,36
Hertfordshire,William Ransom Primary School,419,38,5,43
Hertfordshire,Prae Wood Primary School,442,50,3,53
Hertfordshire,The Giles Infant and Nursery School,328,87,16,103
Hertfordshire,Kingsway Infants' School,170,44,2,46
Hertfordshire,Kingshill Infant School,209,19,6,25
Hertfordshire,Woolenwick Junior School,232,40,6,46
Hertfordshire,Woolenwick Infant and Nursery School,211,16,1,17
Hertfordshire,Leavesden JMI School,388,50,9,59
Hertfordshire,Longlands Primary School and Nursery,220,21,12,33
Hertfordshire,The Lea Primary School and Nursery,236,39,5,44
Hertfordshire,Wheatcroft Primary School,329,44,6,50
Hertfordshire,Mary Exton Primary School,177,29,2,31
Hertfordshire,Lordship Farm Primary School,438,49,7,56
Hertfordshire,Studlands Rise First School,167,18,3,21
Hertfordshire,Lime Walk Primary School,204,22,6,28
Hertfordshire,Fairfields Primary School and Nursery,444,53,14,67
Hertfordshire,Aycliffe Drive Primary School,322,44,7,51
Hertfordshire,Holtsmere End Junior School,238,51,6,57
Hertfordshire,Samuel Lucas Junior Mixed and Infant School,421,43,6,49
Hertfordshire,Coates Way JMI and Nursery School,230,31,7,38
Hertfordshire,High Beeches Primary School,415,53,3,56
Hertfordshire,Stonehill School,215,39,6,45
Hertfordshire,Richard Whittington Primary School,307,36,7,43
Hertfordshire,Brockswood Primary School,233,137,6,143
Hertfordshire,Ashtree Primary School and Nursery,304,39,4,43
Hertfordshire,Sheredes Primary School,458,62,6,68
Hertfordshire,Wood End School,455,17,4,21
Hertfordshire,Bengeo Primary School,446,34,10,44
Hertfordshire,Morgans Primary School & Nursery,347,22,6,28
Hertfordshire,The Leys Primary and Nursery School,438,106,12,118
Hertfordshire,Belswains Primary School,377,30,7,37
Hertfordshire,Bonneygrove Primary School,398,77,3,80
Hertfordshire,Burleigh Primary School,413,61,6,67
Hertfordshire,Hobbs Hill Wood Primary School,455,81,9,90
Hertfordshire,Cranborne Primary School,447,56,11,67
Hertfordshire,Ladbrooke Junior Mixed and Infant School,236,29,1,30
Hertfordshire,Oakmere Primary School,285,61,5,66
Hertfordshire,Nascot Wood Infant and Nursery School,211,18,5,23
Hertfordshire,Hartsfield Junior Mixed and Infant School,412,49,1,50
Hertfordshire,Holtsmere End Infant and Nursery School,214,28,9,37
Hertfordshire,Commonswood Primary & Nursery School,452,82,6,88
Hertfordshire,Millbrook School,148,22,7,29
Hertfordshire,Aldbury Church of England Primary and Nursery School,107,10,1,11
Hertfordshire,St Mary's Infants' School,136,32,4,36
Hertfordshire,St Mary's Junior Mixed School,222,52,8,60
Hertfordshire,Barley (VA) Church of England First School,32,10,1,11
Hertfordshire,Bayford Church of England Voluntary Controlled Primary School,99,10,1,11
Hertfordshire,Tonwell St Mary's Church of England Primary School,35,11,5,16
Hertfordshire,Benington Church of England Primary School,91,14,0,14
Hertfordshire,Layston Church of England First School,145,23,5,28
Hertfordshire,Ashfield Junior School,208,23,2,25
Hertfordshire,Codicote Church of England Primary School,283,17,3,20
Hertfordshire,Essendon CofE (VC) Primary School,93,23,0,23
Hertfordshire,Furneux Pelham Church of England School,102,13,1,14
Hertfordshire,Graveley Primary School,92,28,6,34
Hertfordshire,Ponsbourne St Mary's Church of England Primary School,103,12,2,14
Hertfordshire,Hertford St Andrew CofE Primary School,139,26,10,36
Hertfordshire,High Wych Church of England Primary School,222,24,9,33
Hertfordshire,Wormley CofE Primary School,444,69,22,91
Hertfordshire,Ickleford Primary School,207,12,2,14
Hertfordshire,Little Munden Church of England Voluntary Controlled Primary School,76,6,3,9
Hertfordshire,Preston Primary School,70,11,1,12
Hertfordshire,Spellbrook CofE Primary School,106,12,2,14
Hertfordshire,Roger De Clare First CofE School,280,38,7,45
Hertfordshire,St Andrew's Church of England Voluntary Controlled Primary School,220,44,6,50
Hertfordshire,Thundridge Church of England Primary School,67,12,0,12
Hertfordshire,St Mary's Voluntary Controlled Church of England Junior School,236,33,5,38
Hertfordshire,St Catherine's Church of England Primary School,393,49,7,56
Hertfordshire,Weston Primary & Nursery School,125,17,3,20
Hertfordshire,Potten End CofE Primary School,204,32,2,34
Hertfordshire,Dewhurst St Mary CofE Primary School,197,20,6,26
Hertfordshire,Leverstock Green Church of England Primary School,234,39,5,44
Hertfordshire,"St Paul's Church of England Primary School, Langleybury",202,14,3,17
Hertfordshire,Nash Mills Church of England Primary School,230,32,3,35
Hertfordshire,Albury Church of England Voluntary Aided Primary School,61,8,3,11
Hertfordshire,Ardeley St Lawrence Church of England Voluntary Aided Primary School,74,22,3,25
Hertfordshire,Aston St Mary's Church of England Aided Primary School,127,17,4,21
Hertfordshire,Barkway VA Church of England First School,28,9,0,9
Hertfordshire,Victoria Church of England Infant and Nursery School,185,16,1,17
Hertfordshire,"St Mary's CofE Primary School, Northchurch",206,21,3,24
Hertfordshire,St Michael's Church of England Primary School,216,23,4,27
Hertfordshire,Holy Trinity Church of England Primary School,193,21,6,27
Hertfordshire,"All Saints Church of England Voluntary Aided Primary School, Datchworth",144,20,2,22
Hertfordshire,St Nicholas Elstree Church of England VA Primary School,92,11,0,11
Hertfordshire,St John the Baptist Voluntary Aided Church of England Primary School,176,15,3,18
Hertfordshire,Great Gaddesden Church of England Primary School,87,5,1,6
Hertfordshire,St Nicholas CofE VA Primary School,147,12,0,12
Hertfordshire,"St John's Voluntary Aided Church of England Primary School, Lemsford",101,14,5,19
Hertfordshire,Broxbourne CofE Primary School,244,29,5,34
Hertfordshire,Hormead Church of England (VA) First School,120,9,7,16
Hertfordshire,St Ippolyts Church of England Aided Primary School,171,17,6,23
Hertfordshire,"St Paul's Church of England Voluntary Aided Primary School, Chipperfield",194,9,7,16
Hertfordshire,Norton St Nicholas CofE (VA) Primary School,228,30,5,35
Hertfordshire,Little Gaddesden Church of England Voluntary Aided Primary School,92,6,1,7
Hertfordshire,St Andrew's CE Primary School and Nursery,215,16,5,21
Hertfordshire,Offley Endowed Primary School and Nursery,158,27,0,27
Hertfordshire,Cockernhoe Endowed CofE Primary School,91,4,0,4
Hertfordshire,"St Mary's Church of England Primary School, Rickmansworth",195,28,3,31
Hertfordshire,St Peter's Church of England Voluntary Aided Primary School,241,27,5,32
Hertfordshire,"The Abbey Church of England Voluntary Aided Primary School, St Albans",174,2,3,5
Hertfordshire,"St Michael's Church of England Voluntary Aided Primary School, St Albans",180,26,4,30
Hertfordshire,Park Street Church of England Voluntary Aided Primary School,138,9,5,14
Hertfordshire,"Puller Memorial, Church of England, Voluntary Aided Primary School",63,14,6,20
Hertfordshire,Stapleford Primary School,69,5,2,7
Hertfordshire,St Nicholas CofE (VA) Primary School and Nursery,228,23,11,34
Hertfordshire,Tewin Cowper Church of England Voluntary Aided Primary School,174,11,3,14
Hertfordshire,"Bishop Wood Church of England Junior School, Tring",236,30,4,34
Hertfordshire,Long Marston VA Church of England Primary School,120,12,1,13
Hertfordshire,St John's CofE Primary School,221,25,10,35
Hertfordshire,St Michael's Woolmer Green CofE VA Primary School,185,17,3,20
Hertfordshire,St Helen's Church of England Primary School,256,28,2,30
Hertfordshire,"St Bartholomew's Church of England Voluntary Aided Primary School, Wigginton",101,7,1,8
Hertfordshire,Our Lady  Catholic Primary School,201,12,2,14
Hertfordshire,St Joseph Catholic Primary School,237,50,4,54
Hertfordshire,St Teresa Catholic Primary School,209,21,10,31
Hertfordshire,"St Andrew's Church of England Voluntary Aided Primary School, Hitchin",246,20,4,24
Hertfordshire,St Cuthbert Mayne Catholic Junior School,237,29,3,32
Hertfordshire,St Philip Howard Catholic Primary School,481,96,18,114
Hertfordshire,St Adrian Roman Catholic Primary School,219,20,2,22
Hertfordshire,Saint Albert the Great Catholic Primary School,217,33,5,38
Hertfordshire,"All Saints Church of England Primary School and Nursery, Bishop's Stortford",219,21,8,29
Hertfordshire,Christ Church CofE (VA) Primary School and Nursery,311,44,9,53
Hertfordshire,St Margaret Clitherow Roman Catholic Primary School,237,21,3,24
Hertfordshire,St Dominic Catholic Primary School,240,11,1,12
Hertfordshire,St Thomas More Roman Catholic Voluntary Aided Primary School,182,29,6,35
Hertfordshire,The Holy Family Catholic Primary School,210,25,7,32
Hertfordshire,St Rose's Catholic Infants School,200,13,6,19
Hertfordshire,Sacred Heart Catholic Primary School and Nursery,340,43,4,47
Hertfordshire,Saint Bernadette Catholic Primary School,216,23,3,26
Hertfordshire,Welwyn St Mary's Church of England Voluntary Aided Primary School,421,32,7,39
Hertfordshire,St Alban & St Stephen Catholic Primary School & Nursery,457,31,2,33
Hertfordshire,St Paul's Catholic Primary School,201,20,12,32
Hertfordshire,St Anthony's Catholic Primary School,437,70,4,74
Hertfordshire,Pope Paul Catholic Primary School,208,12,1,13
Hertfordshire,St Mary's Church of England Primary School,170,31,3,34
Hertfordshire,Saint Vincent de Paul Catholic Primary School,447,38,10,48
Hertfordshire,The Priory School,1243,190,24,214
Hertfordshire,The Hemel Hempstead School,1297,152,14,166
Hertfordshire,Fearnhill School,570,68,23,91
Hertfordshire,Barnwell School,1227,219,46,265
Hertfordshire,The Nobel School,1474,223,24,247
Hertfordshire,Marriotts School,1449,248,41,289
Hertfordshire,The Highfield School,987,157,32,189
Hertfordshire,Bridgewater Primary School,453,20,5,25
Hertfordshire,The Astley Cooper School,913,163,24,187
Hertfordshire,Edwinstree Church of England Middle School,477,72,6,78
Hertfordshire,Townsend VA Church of England,768,136,18,154
Hertfordshire,John F Kennedy Catholic School,1125,106,15,121
Hertfordshire,The Thomas Coram Church of England School,315,45,12,57
Hertfordshire,Parkside Community Primary School,247,22,7,29
Hertfordshire,Hertingfordbury Cowper Primary School,223,19,3,22
Hertfordshire,St Giles' CofE Primary School,81,14,4,18
Hertfordshire,Cuffley School,453,27,6,33
Hertfordshire,Little Heath Primary School,236,38,6,44
Hertfordshire,Northaw Church of England Primary School,107,19,1,20
Hertfordshire,Brookmans Park Primary School,345,28,4,32
Hertfordshire,The Bishop's Stortford High School,1194,80,9,89
Hertfordshire,Ashlyns School,1506,194,35,229
Hertfordshire,Abbot's Hill School,522,110,2,112
Hertfordshire,Edge Grove School,435,37,1,38
Hertfordshire,The Aldenham Foundation,865,149,3,152
Hertfordshire,Berkhamsted School,1333,285,4,289
Hertfordshire,Bishop's Stortford College,1276,151,6,157
Hertfordshire,St Margaret's School,654,99,5,104
Hertfordshire,Haileybury and Imperial Service College,892,104,1,105
Hertfordshire,Aldwickbury School,387,61,0,61
Hertfordshire,Queenswood School,456,125,2,127
Hertfordshire,Westbrook Hay,381,33,0,33
Hertfordshire,Lockers Park School,177,22,2,24
Hertfordshire,St Christopher School,523,129,2,131
Hertfordshire,St. Francis' College,313,104,1,105
Hertfordshire,Radlett Preparatory School Ltd,347,0,0,0
Hertfordshire,Merchant Taylors' School,945,96,1,97
Hertfordshire,St Albans High School for Girls,1156,92,0,92
Hertfordshire,Tring Park School for the Performing Arts,353,163,0,163
Hertfordshire,Beechwood Park School,521,72,0,72
Hertfordshire,Heath Mount School,500,91,1,92
Hertfordshire,Sherrardswood School,500,108,34,142
Hertfordshire,Egerton-Rothesay School,158,16,125,141
Hertfordshire,St Hilda's School,142,7,1,8
Hertfordshire,St Hilda's School,142,40,0,40
Hertfordshire,Duncombe School,264,26,0,26
Hertfordshire,St Joseph's in the Park,164,31,2,33
Hertfordshire,Kingshott School,384,40,0,40
Hertfordshire,St Edmund's College,878,151,0,151
Hertfordshire,Charlotte House Preparatory School,99,18,0,18
Hertfordshire,York House School,397,47,0,47
Hertfordshire,St Columba's College,797,244,1,245
Hertfordshire,Stanborough Secondary School,63,7,4,11
Hertfordshire,Royal Masonic School for Girls,999,206,0,206
Hertfordshire,Lochinver House School,343,28,0,28
Hertfordshire,Stormont School,141,26,0,26
Hertfordshire,Radlett Lodge School,45,0,45,45
Hertfordshire,St Albans School,901,173,0,173
Hertfordshire,Haberdashers' Boys' School,1473,208,0,208
Hertfordshire,Haberdashers' Girls' School,1170,135,1,136
Hertfordshire,The King's School,181,2,32,34
Hertfordshire,Merchant Taylors' Prep School,370,24,0,24
Hertfordshire,Berkhamsted Prep and Pre-Prep School,553,59,0,59
Hertfordshire,Gurukula - The Hare Krishna Primary School,56,5,2,7
Hertfordshire,Immanuel College,660,211,1,212
Hertfordshire,Manor Lodge School,457,30,0,30
Hertfordshire,Longwood School,203,10,1,11
Hertfordshire,St Elizabeth's School,37,0,37,37
Hertfordshire,Garston Manor School,150,0,150,150
Hertfordshire,The Valley School,172,0,172,172
Hertfordshire,Colnbrook School,113,0,113,113
Hertfordshire,St Luke's School,160,0,160,160
Hertfordshire,The Collett School,130,0,130,130
Hertfordshire,Batchwood School,101,0,101,101
Hertfordshire,Middleton School,100,0,100,100
Hertfordshire,Lonsdale School,112,0,112,112
Hertfordshire,Lakeside School,92,0,92,92
Hertfordshire,Breakspeare School,94,0,94,94
Hertfordshire,Woodfield School,124,0,124,124
Hertfordshire,Watling View School,98,0,98,98
Hertfordshire,Amwell View School,162,0,162,162
Hertfordshire,Heathlands School,129,5,124,129
Hertfordshire,Falconer School,87,0,87,87
Hertfordshire,Greenside School,172,0,172,172
Hertfordshire,Meadow Wood School,36,0,36,36
"Kingston upon Hull, City of",McMillan Nursery School,117,14,2,16
East Riding of Yorkshire,Bridlington Nursery School,92,13,3,16
North East Lincolnshire,Great Coates Village Nursery School,50,0,0,0
East Riding of Yorkshire,Beverley Manor Nursery School,95,14,1,15
East Riding of Yorkshire,Hornsea Nursery School,80,7,3,10
North East Lincolnshire,Scartho Nursery School,46,1,0,1
North Lincolnshire,Alkborough Primary School,81,13,1,14
North Lincolnshire,Althorpe and Keadby Primary School,191,53,5,58
North Lincolnshire,Bottesford Junior School,265,29,6,35
North Lincolnshire,Brigg Primary School,358,71,9,80
North Lincolnshire,Broughton Primary School,325,31,7,38
North Lincolnshire,Burton-upon-Stather Primary School,188,26,6,32
North East Lincolnshire,Queen Mary Avenue Infant School,305,36,16,52
North Lincolnshire,East Halton Primary School,49,12,0,12
North Lincolnshire,Goxhill Primary School,223,32,8,40
North Lincolnshire,Kirton Lindsey Primary School,224,24,2,26
North Lincolnshire,Luddington & Garthorpe Primary,78,15,0,15
North Lincolnshire,Messingham Primary School,269,34,3,37
North Lincolnshire,Killingholme Primary School,111,14,4,18
North Lincolnshire,Bushfield Road Infant School,198,24,3,27
North Lincolnshire,Frodingham Infant School,201,38,2,40
North Lincolnshire,South Ferriby Primary School,74,0,1,1
North Lincolnshire,Winteringham Primary School,94,4,2,6
North Lincolnshire,Priory Lane Community School,357,55,7,62
North Lincolnshire,Enderby Road Infant School,109,9,5,14
North Lincolnshire,Leys Farm Junior School,134,17,4,21
North Lincolnshire,Bottesford Infant School,206,14,5,19
North Lincolnshire,Berkeley Primary School,615,111,6,117
North Lincolnshire,Winterton Junior School,228,36,2,38
North Lincolnshire,Holme Valley Primary School,421,40,10,50
North Lincolnshire,Bowmandale Primary School,344,41,5,46
East Riding of Yorkshire,Aldbrough Primary School,129,18,3,21
East Riding of Yorkshire,Barmby-on-the-Marsh Primary School,50,0,4,4
East Riding of Yorkshire,Bempton Primary School,94,13,3,16
East Riding of Yorkshire,Beverley St Nicholas Community Primary School,315,32,6,38
East Riding of Yorkshire,Boynton Primary School,73,9,2,11
East Riding of Yorkshire,Brandesburton Primary School,163,16,5,21
East Riding of Yorkshire,Burlington Junior School,308,73,16,89
East Riding of Yorkshire,Burlington Infant School,198,44,4,48
East Riding of Yorkshire,Burstwick Community Primary School,139,26,3,29
East Riding of Yorkshire,Burton Pidsea Primary School,76,2,6,8
East Riding of Yorkshire,Driffield Junior School,506,88,19,107
East Riding of Yorkshire,Eastrington Primary School,105,13,7,20
East Riding of Yorkshire,Brough Primary School,319,52,15,67
East Riding of Yorkshire,Hedon Primary School,156,15,11,26
East Riding of Yorkshire,Holme-upon-Spalding Moor Primary School,239,15,5,20
East Riding of Yorkshire,Hornsea Community Primary School,562,79,38,117
East Riding of Yorkshire,Hutton Cranswick Community Primary School,179,23,3,26
East Riding of Yorkshire,Nafferton Primary School,284,42,5,47
East Riding of Yorkshire,Newbald Primary School,92,19,0,19
East Riding of Yorkshire,Newport Primary School,153,19,14,33
East Riding of Yorkshire,North Frodingham Primary School,75,11,3,14
East Riding of Yorkshire,Paull Primary School,54,2,3,5
East Riding of Yorkshire,Preston Primary School,179,29,8,37
East Riding of Yorkshire,Walkington Primary School,219,21,4,25
East Riding of Yorkshire,Wawne Primary School,108,24,2,26
East Riding of Yorkshire,Welton Primary School,341,33,10,43
East Riding of Yorkshire,Leconfield Primary School,133,10,3,13
East Riding of Yorkshire,Bacon Garth Primary School,237,36,10,46
East Riding of Yorkshire,Bubwith Community Primary School,125,12,4,16
East Riding of Yorkshire,Kirk Ella St Andrew's Community Primary School,464,37,14,51
East Riding of Yorkshire,Skipsea Primary School,56,7,0,7
East Riding of Yorkshire,Westfield Primary School,463,39,8,47
East Riding of Yorkshire,Springhead Primary School,204,28,6,34
East Riding of Yorkshire,Martongate Primary School,406,32,16,48
East Riding of Yorkshire,Acre Heads Primary School,409,53,17,70
East Riding of Yorkshire,Molescroft Primary School,421,36,9,45
East Riding of Yorkshire,Elloughton Primary School,371,50,16,66
East Riding of Yorkshire,Rawcliffe Primary School,101,9,3,12
East Riding of Yorkshire,Rawcliffe Bridge Primary School,48,7,2,9
East Riding of Yorkshire,Snaith Primary School,334,29,11,40
North East Lincolnshire,Coomb Briggs Primary School,187,11,7,18
East Riding of Yorkshire,New Pasture Lane Primary School,250,63,10,73
East Riding of Yorkshire,Inmans Primary School,394,24,26,50
East Riding of Yorkshire,Market Weighton Infant School,295,15,3,18
East Riding of Yorkshire,Northfield Infant School,179,35,2,37
North East Lincolnshire,Western Primary School,293,33,8,41
North Lincolnshire,Crosby Primary School,525,56,7,63
East Riding of Yorkshire,Parkside Primary School,541,86,8,94
East Riding of Yorkshire,Kingsway Primary School,429,34,10,44
East Riding of Yorkshire,Marshlands Primary School,284,66,10,76
East Riding of Yorkshire,Reedness Primary School,27,3,1,4
East Riding of Yorkshire,Boothferry Primary School,390,65,10,75
East Riding of Yorkshire,Swinefleet Primary School,81,12,3,15
North East Lincolnshire,Scartho Infants' School and Nursery,181,18,4,22
North Lincolnshire,Castledyke Primary School,244,45,6,51
East Riding of Yorkshire,Beeford Church of England Voluntary Controlled Primary School,94,14,4,18
East Riding of Yorkshire,Beswick and Watton CofE (VC) School,23,4,1,5
East Riding of Yorkshire,Beverley Minster Church of England Voluntary Controlled Primary School,254,25,5,30
East Riding of Yorkshire,Bishop Wilton Church of England Voluntary Controlled Primary School,36,1,2,3
East Riding of Yorkshire,Burton Agnes Church of England Voluntary Controlled Primary School,100,7,1,8
East Riding of Yorkshire,Driffield Church of England Voluntary Controlled Infant School,190,19,8,27
East Riding of Yorkshire,Flamborough CofE (VC) Primary School,90,8,3,11
East Riding of Yorkshire,Garton-on-the-Wolds Church of England Voluntary Controlled Primary School,87,10,6,16
East Riding of Yorkshire,Kilham Church of England Voluntary Controlled School,116,17,5,22
East Riding of Yorkshire,Leven Church of England Voluntary Controlled Primary School,141,20,3,23
East Riding of Yorkshire,Mount Pleasant Church of England Voluntary Controlled Junior School,296,25,6,31
East Riding of Yorkshire,Middleton-on-the-Wolds Church of England Voluntary Controlled Primary School,71,8,5,13
East Riding of Yorkshire,North Ferriby Church of England Voluntary Controlled Primary School,291,20,7,27
East Riding of Yorkshire,Pocklington Church of England Voluntary Controlled Infant School,212,28,0,28
East Riding of Yorkshire,Roos Church of England Voluntary Controlled Primary School,122,9,5,14
East Riding of Yorkshire,Little Weighton Rowley Church of England Voluntary Controlled Primary School,57,15,1,16
East Riding of Yorkshire,Skidby Church of England Voluntary Controlled Primary School,77,4,1,5
East Riding of Yorkshire,Skirlaugh Church of England Voluntary Controlled Primary School,146,13,6,19
East Riding of Yorkshire,Tickton Church of England Voluntary Controlled Primary School,181,30,6,36
East Riding of Yorkshire,Warter Church of England Primary School,163,3,3,6
East Riding of Yorkshire,Wetwang Church of England Voluntary Controlled Primary School,48,2,5,7
East Riding of Yorkshire,Wilberfoss Church of England Voluntary Controlled Primary School,233,21,8,29
East Riding of Yorkshire,Woodmansey Church of England Voluntary Controlled Primary School,90,5,1,6
East Riding of Yorkshire,Bugthorpe Church of England Voluntary Controlled Primary School,66,4,0,4
East Riding of Yorkshire,Lockington Church of England Voluntary Controlled Primary School,43,3,0,3
East Riding of Yorkshire,Cherry Burton Church of England Voluntary Controlled Primary School,182,27,9,36
East Riding of Yorkshire,South Cave Church of England Voluntary Controlled Primary School,198,9,2,11
North Lincolnshire,"St Barnabas CofE Primary School, Barnetby",158,18,4,22
North Lincolnshire,John Harrison C of E Primary School,185,19,1,20
North Lincolnshire,Barton St Peter's CofE Primary School,264,33,2,35
North Lincolnshire,Belton All Saints CofE Primary School,227,27,1,28
North Lincolnshire,Gunness and Burringham Church of England Primary School,96,8,2,10
North Lincolnshire,Haxey CofE Primary School,172,24,5,29
North East Lincolnshire,The Humberston CofE Primary School,242,17,0,17
North Lincolnshire,Kirmington CofE Primary School,59,6,1,7
North East Lincolnshire,Stanford Junior and Infant School,237,45,4,49
North Lincolnshire,Scunthorpe CofE Primary School,246,41,10,51
North East Lincolnshire,Stallingborough CofE Primary School,133,19,3,22
North Lincolnshire,West Butterwick C of E Primary School,48,9,3,12
North Lincolnshire,Winterton Church of England Infants' School,164,24,1,25
North Lincolnshire,Wroot Travis Charity Church of England Primary School,35,8,0,8
North Lincolnshire,New Holland Church of England and Methodist Primary School,52,16,1,17
East Riding of Yorkshire,Cowick Church of England Voluntary Controlled Primary School,106,19,4,23
East Riding of Yorkshire,Sutton Upon Derwent Church of England Voluntary Controlled Primary School,78,11,2,13
East Riding of Yorkshire,Sledmere Church of England Voluntary Controlled Primary School,46,10,1,11
East Riding of Yorkshire,"St Mary's Church of England Voluntary Controlled Primary School, Beverley",391,57,12,69
East Riding of Yorkshire,"St Martin's Church of England Voluntary Aided Primary School, Fangfoss",101,13,3,16
North Lincolnshire,St Martin's CofE Primary School,115,23,8,31
North Lincolnshire,Wootton St Andrew's CofE Primary School,60,9,0,9
North Lincolnshire,Eastoft Church of England Primary School,74,15,1,16
East Riding of Yorkshire,Pollington-Balne Church of England Primary School,122,19,5,24
"Kingston upon Hull, City of",St Andrew's Church of England Voluntary Aided Primary School,604,61,9,70
East Riding of Yorkshire,Beverley High School,847,56,26,82
East Riding of Yorkshire,Longcroft School and Sixth Form College,752,58,18,76
East Riding of Yorkshire,Withernsea High School,763,94,45,139
East Riding of Yorkshire,The Market Weighton School,578,96,63,159
East Riding of Yorkshire,Hornsea School and Language College,1200,55,76,131
East Riding of Yorkshire,Headlands School,1037,85,36,121
North Lincolnshire,Frederick Gough School,1341,275,29,304
North Lincolnshire,Baysgarth School,954,157,30,187
East Riding of Yorkshire,Bridlington School,1009,164,60,224
North Lincolnshire,Sir John Nelthorpe School,796,118,8,126
East Riding of Yorkshire,Wold Newton Foundation School,106,4,3,7
East Riding of Yorkshire,Howden Church of England Infant School,153,10,3,13
East Riding of Yorkshire,Barmby Moor Church of England Primary School,122,14,1,15
"Kingston upon Hull, City of",Froebel House School,110,2,0,2
North East Lincolnshire,St James' School,56,16,2,18
North East Lincolnshire,St Martin's Preparatory School,228,33,1,34
East Riding of Yorkshire,Tranby,519,110,3,113
"Kingston upon Hull, City of",Hymers College,1076,132,5,137
East Riding of Yorkshire,Pocklington School,781,98,2,100
"Kingston upon Hull, City of",Northcott School and Sixth Form College,138,0,138,138
"Kingston upon Hull, City of",Oakfield,103,0,103,103
East Riding of Yorkshire,Kings Mill School,138,0,138,138
East Riding of Yorkshire,St Anne's School and Sixth Form College,168,0,168,168
North Lincolnshire,St Hugh's Special School,179,0,176,176
North Lincolnshire,St Luke's Primary School,168,0,168,168
East Riding of Yorkshire,Riverside Special School,136,0,136,136
Isle of Wight,Chillerton and Rookley Primary School,11,1,0,1
Isle of Wight,Cowes Primary School,183,38,3,41
Isle of Wight,Gatten and Lake Primary School,211,25,6,31
Isle of Wight,Godshill Primary School,172,7,8,15
Isle of Wight,Gurnard Primary School,406,35,7,42
Isle of Wight,Nettlestone Primary School,213,7,3,10
Isle of Wight,Newchurch Primary School,212,11,7,18
Isle of Wight,Barton Primary School,270,46,24,70
Isle of Wight,Nine Acres Primary School,395,59,13,72
Isle of Wight,Niton Primary School,204,33,3,36
Isle of Wight,Hunnyhill Primary School,409,50,16,66
Isle of Wight,Haylands Primary School,361,67,10,77
Isle of Wight,St Helens Primary School,99,13,5,18
Isle of Wight,Wootton Community Primary School,194,13,7,20
Isle of Wight,Wroxall Primary School,132,31,3,34
Isle of Wight,Broadlea Primary School,273,36,13,49
Isle of Wight,Binstead Primary School,209,22,7,29
Isle of Wight,Greenmount Primary School,371,49,12,61
Isle of Wight,Summerfields Primary School,181,19,9,28
Isle of Wight,Dover Park Primary School,207,25,6,31
Isle of Wight,Arreton St George's Church of England (Aided) Primary School,171,37,4,41
Isle of Wight,Bembridge Church of England Primary School,195,7,2,9
Isle of Wight,Brading Church of England Controlled Primary School,195,57,23,80
Isle of Wight,Carisbrooke Church of England Controlled Primary School,390,60,18,78
Isle of Wight,Shalfleet Church of England Primary School,191,21,4,25
Isle of Wight,Brighstone Church of England Aided Primary School,86,12,0,12
Isle of Wight,"Oakfield Church of England Aided Primary School, Ryde",236,103,14,117
Isle of Wight,Yarmouth Church of England Aided Primary School,141,22,7,29
Isle of Wight,St Mary's Catholic Primary School,178,36,2,38
Isle of Wight,St Saviour's Catholic Primary School,146,19,3,22
Isle of Wight,Holy Cross Catholic Primary School,146,19,1,20
Isle of Wight,St Thomas of Canterbury Catholic Primary School,202,29,8,37
Isle of Wight,Newport Church of England Aided Primary School,310,32,12,44
Isle of Wight,Ryde School with Upper Chine,804,311,1,312
Isle of Wight,Priory School,175,42,0,42
Isle of Wight,St Catherine's School and College,92,2,90,92
Isle of Wight,St George's School,201,0,201,201
Isle of Wight,Medina House School,102,0,102,102
Kent,Northfleet Nursery School,91,11,1,12
Kent,Maypole Primary School,420,63,6,69
Kent,Crockenhill Primary School,187,31,4,35
Kent,The Anthony Roper Primary School,307,12,3,15
Kent,Cobham Primary School,218,22,5,27
Kent,Cecil Road Primary and Nursery School,444,58,15,73
Kent,Higham Primary School,208,15,1,16
Kent,Lawn Primary School,230,64,5,69
Kent,Bean Primary School,190,22,4,26
Kent,Capel Primary School,207,29,0,29
Kent,Dunton Green Primary School,187,13,6,19
Kent,Hadlow Primary School,187,32,7,39
Kent,Four Elms Primary School,108,14,2,16
Kent,Kemsing Primary School,184,32,1,33
Kent,Leigh Primary School,161,18,6,24
Kent,Otford Primary School,332,42,1,43
Kent,Pembury School,404,33,3,36
Kent,Sandhurst Primary School,154,17,4,21
Kent,Weald Community Primary School,126,10,2,12
Kent,Shoreham Village School,84,17,3,20
Kent,Slade Primary School and Attached Unit for Children with Hearing Impairment,418,39,19,58
Kent,Sussex Road Community Primary School,418,56,5,61
Kent,Boughton Monchelsea Primary School,206,26,6,32
Kent,East Farleigh Primary School,208,38,4,42
Kent,East Peckham Primary School,175,20,2,22
Kent,Headcorn Primary School,392,41,4,45
Kent,Hollingbourne Primary School,96,10,2,12
Kent,Ightham Primary School,209,9,5,14
Kent,Lenham Primary School,213,27,3,30
Kent,Platts Heath Primary School,62,18,2,20
Kent,Brunswick House Primary School,421,91,6,97
Kent,North Borough Junior School,353,55,2,57
Kent,Park Way Primary School,316,28,2,30
Kent,Mereworth Community Primary School,203,33,2,35
Kent,Offham Primary School,205,13,6,19
Kent,Plaxtol Primary School,98,6,1,7
Kent,Ryarsh Primary School,210,10,7,17
Kent,Shipbourne School,60,5,7,12
Kent,Staplehurst School,406,30,9,39
Kent,Sutton Valence Primary School,205,12,4,16
Medway,Greenvale Primary  School,110,17,1,18
Medway,Luton Primary School,658,119,9,128
Medway,New Road Primary School,360,137,13,150
Medway,Balfour Infant School,266,21,1,22
Medway,Crest Infant School,177,44,3,47
Kent,Eastling Primary School,101,4,1,5
Kent,Ethelbert Road Primary School,209,20,4,24
Kent,Davington Primary School,417,58,16,74
Kent,Lower Halstow Primary School,188,32,6,38
Kent,Rodmersham School,117,8,6,14
Kent,Rose Street Primary School,438,54,14,68
Kent,Canterbury Road Primary School,208,24,12,36
Kent,Blean Primary School,431,44,5,49
Kent,Herne Bay Infant School,304,44,8,52
Kent,Hoath Primary School,103,19,3,22
Kent,Westmeads Community Infant School,156,15,1,16
Kent,Whitstable Junior School,232,38,5,43
Kent,Aldington Primary School,191,12,1,13
Kent,Victoria Road Primary School,211,37,5,42
Kent,Willesborough Infant School,357,37,5,42
Kent,Willesborough Junior School,511,51,11,62
Kent,Bethersden Primary School,131,20,3,23
Kent,Brook Community Primary School,71,9,5,14
Kent,Challock Primary School,210,20,3,23
Kent,Great Chart Primary School,420,46,11,57
Kent,Mersham Primary School,181,17,3,20
Kent,Smeeth Community Primary School,122,8,2,10
Kent,Hawkinge Primary School,396,48,7,55
Kent,Sellindge Primary School,142,22,2,24
Kent,River Primary School,413,63,19,82
Kent,Langdon Primary School,86,16,2,18
Kent,Eythorne Elvington Community Primary School,107,13,2,15
Kent,Lydden Primary School,78,16,0,16
Kent,Preston Primary School,117,16,2,18
Kent,Wingham Primary School,191,26,9,35
Kent,St Mildred's Primary Infant School,269,20,6,26
Kent,Callis Grange Nursery and Infant School,288,33,1,34
Kent,St Crispin's Community Primary Infant School,254,22,6,28
Kent,Ellington Infant School,134,18,6,24
Kent,Priory Infant School,155,20,5,25
Medway,Hempstead Junior School,353,30,3,33
Kent,Shears Green Junior School,483,60,13,73
Kent,West Minster Primary School,508,68,38,106
Medway,Horsted Infant School,177,21,0,21
Kent,Aycliffe Community Primary School,93,11,4,15
Kent,Riverhead Infants' School,268,17,0,17
Kent,Claremont Primary School,438,11,12,23
Kent,Whitfield Aspen School,585,33,165,198
Kent,St Paul's Infant School,261,51,3,54
Kent,Langton Green Primary School,414,33,6,39
Kent,Bishops Down Primary School,233,14,10,24
Medway,Parkwood Primary School,546,80,4,84
Medway,Horsted Junior School,249,39,0,39
Kent,Singlewell Primary School,392,44,4,48
Kent,Cheriton Primary School,389,90,4,94
Kent,Brookfield Infant School,180,17,1,18
Kent,Vigo Village School,142,10,5,15
Kent,Madginford Primary School,642,69,9,78
Kent,Palmarsh Primary School,191,22,8,30
Kent,Painters Ash Primary School,406,35,6,41
Kent,Tunbury Primary School,587,62,7,69
Kent,St Margaret's-at-Cliffe Primary School,189,20,4,24
Kent,Stocks Green Primary School,216,3,2,5
Kent,Sandgate Primary School,418,25,7,32
Medway,Swingate Primary School,659,92,6,98
Kent,Sandling Primary School,421,48,2,50
Kent,Capel-le-Ferne Primary School,177,29,3,32
Kent,Lunsford Primary School,208,22,3,25
Kent,Downs View Infant School,260,37,4,41
Kent,Kingswood Primary School,129,19,1,20
Kent,Senacre Wood Primary School,212,18,5,23
Kent,"Bromstone Primary School, Broadstairs",406,65,46,111
Kent,Parkside Community Primary School,168,21,5,26
Kent,High Firs Primary School,206,50,3,53
Kent,Sandwich Junior School,210,27,7,34
Kent,Sevenoaks Primary School,587,45,14,59
Medway,Hempstead Infant School,270,32,0,32
Kent,Swalecliffe Community Primary School,581,57,17,74
Kent,Aylesham Primary School,391,84,9,93
Kent,Broadwater Down Primary School,148,36,2,38
Kent,West Borough Primary School,503,51,6,57
Kent,Long Mead Community Primary School,128,45,1,46
Medway,St Peter's Infant School,94,13,1,14
Kent,King's Farm Primary School,437,56,21,77
Kent,St Pauls' Church of England Voluntary Controlled Primary School,107,10,1,11
Kent,Fawkham Church of England Voluntary Controlled Primary School,102,11,3,14
Kent,Benenden Church of England Primary School,211,3,5,8
Kent,Bidborough Church of England Voluntary Controlled Primary School,207,9,0,9
Kent,Cranbrook Church of England Primary School,199,21,2,23
Kent,Goudhurst and Kilndown Church of England Primary School,211,10,3,13
Kent,Hawkhurst Church of England Primary School,183,43,1,44
Kent,Hildenborough Church of England Primary School,190,25,2,27
Kent,Lamberhurst St Mary's CofE (Voluntary Controlled) Primary School,206,28,1,29
Kent,Seal Church of England Voluntary Controlled Primary School,383,81,11,92
Kent,"St John's Church of England Primary School, Sevenoaks",202,22,1,23
Kent,Speldhurst Church of England Voluntary Aided Primary School,213,21,0,21
Kent,Sundridge and Brasted Church of England Voluntary Controlled Primary School,60,19,1,20
Kent,St John's Church of England Primary School,631,44,8,52
Kent,St Mark's Church of England Primary School,360,28,6,34
Kent,St Peter's Church of England Primary School,213,20,5,25
Kent,Crockham Hill Church of England Voluntary Controlled Primary School,137,13,1,14
Kent,Churchill Church of England Voluntary Controlled Primary School,201,40,2,42
Kent,St Peter's Church of England Primary School,194,13,2,15
Kent,Bredhurst Church of England Voluntary Controlled Primary School,130,19,1,20
Kent,Burham Church of England Primary School,144,28,0,28
Kent,Harrietsham Church of England Primary School,309,27,3,30
Kent,Leeds and Broomfield Church of England Primary School,84,17,7,24
Kent,"Maidstone, St Michael's Church of England Junior School",178,25,4,29
Kent,St Michael's Church of England Infant School Maidstone,121,20,2,22
Kent,Thurnham Church of England Infant School,270,8,1,9
Kent,Trottiscliffe Church of England Primary School,81,16,1,17
Kent,Ulcombe Church of England Primary School,63,16,3,19
Kent,Wateringbury Church of England Primary School,175,23,2,25
Kent,"Wouldham, All Saints Church of England Voluntary Controlled Primary School",401,44,12,56
Kent,St George's Church of England Voluntary Controlled Primary School,203,29,4,33
Kent,"St Margaret's, Collier Street Church of England Voluntary Controlled School",123,14,2,16
Kent,Laddingford St Mary's Church of England Voluntary Controlled Primary School,81,19,1,20
Kent,"Yalding, St Peter and St Paul Church of England Voluntary Controlled Primary School",173,22,1,23
Medway,"St Helen's Church of England Primary School, Cliffe",211,26,3,29
Medway,St Nicholas Cevc Infant School,93,16,1,17
Kent,Ospringe Church of England Primary School,213,33,8,41
Kent,Hernhill Church of England Primary School,212,16,7,23
Kent,Newington Church of England Primary School,252,48,6,54
Kent,Teynham Parochial Church of England Primary School,202,32,1,33
Kent,Barham Church of England Primary School,210,27,2,29
Kent,Bridge and Patrixbourne Church of England Primary School,407,71,3,74
Kent,Chislet Church of England Primary School,95,2,4,6
Kent,Littlebourne Church of England Primary School,99,19,3,22
Kent,St Alphege Church of England Infant School,206,30,9,39
Kent,Wickhambreaux Church of England Primary School,118,11,2,13
Kent,"John Mayne Church of England Primary School, Biddenden",110,11,1,12
Kent,Brabourne Church of England Primary School,104,6,1,7
Kent,Brookland Church of England Primary School,87,18,1,19
Kent,"Chilham, St Mary's Church of England Primary School",79,14,2,16
Kent,High Halden Church of England Primary School,102,12,1,13
Kent,Woodchurch Church of England Primary School,157,14,5,19
Kent,Bodsham Church of England Primary School,82,6,1,7
Kent,"Folkestone, St Martin's Church of England Primary School",202,22,3,25
Kent,"Folkestone, St Peter's Church of England Primary School",104,24,1,25
Kent,Seabrook Church of England Primary School,104,14,2,16
Kent,Lyminge Church of England Primary School,196,16,5,21
Kent,Lympne Church of England Primary School,203,16,0,16
Kent,Stelling Minnis Church of England Primary School,83,15,2,17
Kent,Stowting Church of England Primary School,103,11,2,13
Kent,Selsted Church of England Primary School,99,11,1,12
Kent,Eastry Church of England Primary School,165,21,5,26
Kent,Goodnestone Church of England Primary School,53,13,5,18
Kent,Guston Church of England Primary School,151,24,0,24
Kent,Nonington Church of England Primary School,38,8,3,11
Kent,Sibertswold Church of England Primary School at Shepherdswell,202,15,2,17
Kent,Birchington Church of England Primary School,475,74,8,82
Kent,"Margate, Holy Trinity and St John's Church of England Primary School",407,51,14,65
Kent,St Saviour's Church of England Junior School,375,25,13,38
Kent,Minster Church of England Primary School,389,87,11,98
Kent,Monkton Church of England Primary School,106,14,2,16
Kent,St Nicholas At Wade Church of England Primary School,195,16,6,22
Kent,Frittenden Church of England Primary School,98,8,4,12
Kent,Egerton Church of England Primary School,188,18,4,22
Kent,St Lawrence Church of England Primary School,76,15,1,16
Kent,Boughton-under-Blean and Dunkirk Primary School,203,18,11,29
Kent,Lady Joanna Thornhill Endowed Primary School,418,49,5,54
Kent,St Peter's Methodist Primary School,209,17,7,24
Kent,St Matthew's High Brooms Church of England Voluntary Controlled Primary School,354,60,4,64
Kent,Herne Church of England Infant and Nursery School,316,39,10,49
Kent,Langafel Church of England Voluntary Controlled Primary School,325,33,38,71
Kent,Southborough CofE Primary School,615,101,6,107
Kent,St Katharine's Knockholt Church of England Voluntary Aided Primary School,170,24,4,28
Kent,"Chevening, St Botolph's Church of England Voluntary Aided Primary School",179,26,2,28
Kent,Colliers Green Church of England Primary School,112,6,2,8
Kent,Sissinghurst Voluntary Aided Church of England Primary School,171,8,6,14
Kent,Hever Church of England Voluntary Aided Primary School,152,31,4,35
Kent,Penshurst Church of England Voluntary Aided Primary School,84,13,3,16
Kent,"Lady Boswell's Church of England Voluntary Aided Primary School, Sevenoaks",425,27,6,33
Kent,Ide Hill Church of England Primary School,153,16,3,19
Kent,St Barnabas CofE VA Primary School,202,24,1,25
Kent,St James' Church of England Voluntary Aided Primary School,631,48,7,55
Kent,Hunton Church of England Primary School,102,15,3,18
Kent,Platt Church of England Voluntary Aided Primary School,173,22,4,26
Kent,Bapchild and Tonge Church of England Primary School and Nursery,245,14,9,23
Kent,Hartlip Endowed Church of England Primary School,108,25,4,29
Kent,Tunstall Church of England (Aided) Primary School,422,29,9,38
Kent,Herne Church of England Junior School,360,42,17,59
Kent,Whitstable and Seasalter Endowed Church of England Junior School,210,39,3,42
Kent,"Ashford, St Mary's Church of England Primary School",420,41,4,45
Kent,Wittersham Church of England Primary School,141,24,5,29
Kent,Elham Church of England Primary School,127,6,4,10
Kent,Saltwood CofE Primary School,208,11,1,12
Kent,Ash Cartwright and Kelsey Church of England Primary School,158,15,7,22
Kent,"Dover, St Mary's Church of England Primary School",155,13,1,14
Kent,St Peter-in-Thanet CofE Junior School,365,44,8,52
Kent,"Ramsgate, Holy Trinity Church of England Primary School",210,8,5,13
Kent,St Mary's Church of England Voluntary Aided Primary School,247,38,8,46
Medway,St Michael's RC Primary School,469,63,8,71
Kent,St Ethelbert's Catholic Primary School,209,29,5,34
Kent,St Anselm's Catholic Primary School,209,13,1,14
Medway,English Martyrs' Catholic Primary School,202,23,3,26
Medway,St Thomas of Canterbury RC Primary School,258,22,5,27
Kent,"Our Lady's Catholic Primary School, Dartford",217,14,2,16
Medway,St Thomas More Roman Catholic Primary School,417,61,3,64
Medway,St William of Perth Roman Catholic Primary School,208,19,0,19
Kent,"St Thomas' Catholic Primary School, Canterbury",209,13,4,17
Medway,St Augustine of Canterbury Catholic Primary School,199,36,2,38
Medway,St Benedict's Catholic Primary School,211,14,2,16
Medway,St Mary's Catholic Primary School,433,67,4,71
Kent,Dartford Science & Technology College,876,121,17,138
Kent,Northfleet School for Girls,1251,153,9,162
Kent,Tunbridge Wells Girls' Grammar School,984,110,2,112
Kent,Tunbridge Wells Grammar School for Boys,1636,24,3,27
Kent,Dover Grammar School for Girls,882,43,3,46
Kent,Maidstone Grammar School,1425,15,3,18
Kent,Maidstone Grammar School for Girls,1197,89,2,91
Kent,Simon Langton Girls' Grammar School,1244,209,4,213
Kent,The Judd School,1472,83,23,106
Kent,Snodland CofE Primary School,407,51,8,59
Kent,Borough Green Primary School,265,36,3,39
Kent,Roseacre Junior School,423,39,7,46
Kent,Herne Bay Junior School,426,56,20,76
Kent,"St Francis' Catholic Primary School, Maidstone",418,27,6,33
Kent,Ditton Church of England Junior School,200,35,5,40
Kent,Ditton Infant School,174,17,2,19
Kent,"Holy Trinity Church of England Primary School, Dartford",423,66,5,71
Kent,"St Bartholomew's Catholic Primary School, Swanley",324,39,4,43
Kent,Greatstone Primary School,300,45,7,52
Kent,Wincheap Foundation Primary School,432,45,18,63
Kent,Brookfield Junior School,246,35,4,39
Kent,Harcourt Primary School,178,27,8,35
Kent,Thamesview School,955,136,26,162
Kent,Simon Langton Grammar School for Boys,1247,7,42,49
Kent,The Malling School,1010,104,151,255
Kent,The Archbishop's School,722,140,23,163
Kent,Hugh Christie School,963,183,41,224
Medway,St John Fisher Catholic Comprehensive School,1024,157,8,165
Kent,St George's Church of England Foundation School,1633,135,72,207
Kent,Northfleet Technology College,903,243,18,261
Kent,Dover Grammar School for Boys,835,23,6,29
Kent,St John's Catholic Comprehensive,1294,190,28,218
Kent,Ashford School,1050,40,281,321
Kent,Wellesley Haddon Dene School,210,20,3,23
Kent,Benenden School,546,127,0,127
Kent,Dover College,313,110,0,110
Kent,Northbourne Park School,193,38,0,38
Kent,Marlborough House School,248,63,0,63
Kent,St Ronan's School,455,85,0,85
Kent,Gad's Hill School,384,30,6,36
Kent,Kent College Pembury,512,155,7,162
Kent,St Lawrence College,409,0,1,1
Medway,"King's School, Rochester",660,89,4,93
Kent,Beechwood School,309,64,0,64
Kent,Holmewood House School,449,139,4,143
Kent,Rose Hill School,265,82,6,88
Kent,Sevenoaks School,1181,169,0,169
Kent,Sevenoaks Preparatory School,381,63,0,63
Kent,St Michael's Prep School,476,71,2,73
Kent,The New Beacon School,348,77,1,78
Kent,Radnor House Sevenoaks,533,37,0,37
Kent,Sutton Valence School,868,29,2,31
Kent,Tonbridge School,794,150,0,150
Kent,Somerhill,608,41,0,41
Kent,Steephill School,132,38,1,39
Kent,Bronte School,148,18,1,19
Kent,The Granville School,162,13,0,13
Kent,Hilden Grange School,298,84,1,85
Kent,Hilden Oaks Preparatory School and Nursery,166,27,0,27
Kent,The Mead School,238,19,2,21
Kent,Chartfield School,42,5,0,5
Kent,Bethany School,348,240,0,240
Medway,Bryony School,128,1,0,1
Kent,Solefield School,151,55,4,59
Kent,Russell House School,183,12,1,13
Medway,St Andrew's School (Rochester),362,8,0,8
Kent,St Lawrence College Junior School,160,36,0,36
Kent,Dulwich Prep Cranbrook,343,119,1,120
Kent,Cobham Hall,137,27,3,30
Kent,Spring Grove School 2003 Ltd,225,19,1,20
Kent,Helen Allison School,65,0,65,65
Kent,Ripplevale School,149,0,149,149
Kent,The King's School Canterbury,943,220,0,220
Kent,St Edmund's School Canterbury,631,80,11,91
Kent,Kent College (Canterbury),574,36,3,39
Kent,Walthamstow Hall,549,0,84,84
Kent,Elliott Park School,0,0,0,0
Medway,Rochester Independent College,358,102,43,145
Kent,Sackville School,206,23,51,74
Kent,St Faith's At Ash School Limited,228,19,4,23
Kent,Heath Farm School,105,0,105,105
Kent,Junior King's School,381,16,1,17
Kent,Learning Opportunities Centre Secondary,31,0,31,31
Kent,Lorenden Preparatory School,120,19,1,20
Kent,ISP School,59,0,59,59
Kent,Fosse Bank School,48,4,0,4
Kent,Kent College Junior School,222,22,0,22
Kent,Brewood Secondary School,34,0,34,34
Kent,Broomhill Bank School,351,0,351,351
Kent,Caldecott Foundation School,60,0,60,60
Kent,Meadows School,61,0,61,61
Kent,Valence School,119,0,119,119
Kent,Bower Grove School,238,0,238,238
Kent,St Anthony's School,107,0,107,107
Kent,Ifield School,265,0,265,265
Kent,Foreland Fields School,270,19,251,270
Kent,Goldwyn School,203,0,203,203
Kent,The Beacon Folkestone,419,11,408,419
Kent,Rowhill School,149,0,149,149
Kent,Elms School,150,0,150,150
Kent,Nexus Foundation Special School,261,1,260,261
Kent,Grange Park School,175,0,175,175
Medway,Abbey Court Foundation Special School,197,0,197,197
Kent,Five Acre Wood School,793,21,772,793
Kent,Stone Bay School,103,0,103,103
Kent,The Orchard School,105,0,105,105
Kent,St Nicholas' School,353,0,353,353
Kent,Portal House School,75,0,75,75
Lancashire,Lee Royd Nursery School,110,21,0,21
Lancashire,Rockwood Nursery School,113,18,1,19
Lancashire,Duke Street Nursery School,122,31,0,31
Lancashire,Highfield Nursery School,96,20,0,20
Lancashire,Rosegrove Nursery School,94,23,2,25
Lancashire,Ightenhill Nursery School,85,10,0,10
Lancashire,Stoneyholme Nursery School,85,36,0,36
Lancashire,Bradley Nursery School,202,38,0,38
Lancashire,Walton Lane Nursery School,90,15,3,18
Lancashire,Moorgate Nursery School,41,10,0,10
Lancashire,Stoneygate Nursery School,67,11,0,11
Blackburn with Darwen,Longshaw Nursery School,95,4,0,4
Lancashire,Fairfield Nursery School,80,19,3,22
Lancashire,Woodfield Nursery School,111,9,1,10
Lancashire,Ribblesdale Nursery School,54,9,1,10
Lancashire,Newtown Nursery School,90,22,0,22
Blackburn with Darwen,Ashworth Nursery School,81,7,0,7
Blackburn with Darwen,Brunel Nursery School,50,20,0,20
Lancashire,Hillside Nursery School,66,13,0,13
Lancashire,McMillan Nursery School,65,13,0,13
Lancashire,Whitegate Nursery School,129,13,1,14
Lancashire,Bacup Nursery School,72,4,1,5
Blackburn with Darwen,Turncroft Nursery School,59,0,0,0
Lancashire,Staghills Nursery School,81,18,0,18
Lancashire,Basnett Street Nursery School,106,23,0,23
Lancashire,Stepping Stones School,16,5,10,15
Lancashire,Golden Hill Pupil Referral Unit,16,10,6,16
Lancashire,Larches High School,82,15,9,24
Blackburn with Darwen,Audley Junior School,372,105,13,118
Blackburn with Darwen,Griffin Park Primary School,222,47,4,51
Blackburn with Darwen,Intack Primary School,425,42,9,51
Blackburn with Darwen,Longshaw Community Junior School,350,74,11,85
Blackburn with Darwen,Lower Darwen Primary School,379,64,20,84
Blackburn with Darwen,Meadowhead Junior School,211,80,4,84
Blackburn with Darwen,Meadowhead Community Infant School and Nursery,165,49,5,54
Blackburn with Darwen,Daisyfield Primary School,295,30,9,39
Blackburn with Darwen,Lammack Primary School,494,24,13,37
Blackburn with Darwen,Longshaw Infant School,212,43,7,50
Lancashire,Carnforth Community Primary School,99,22,5,27
Blackburn with Darwen,Roe Lee Park Primary School,458,34,10,44
Lancashire,Forton Primary School,80,12,1,13
Lancashire,Bowerham  Primary & Nursery School,503,54,11,65
Lancashire,Lancaster Dallas Road Community Primary School,405,37,7,44
Lancashire,Lancaster Ryelands Primary School,388,75,10,85
Lancashire,Willow Lane Community Primary School,204,25,4,29
Lancashire,Morecambe Bay Community Primary School,288,51,21,72
Blackburn with Darwen,Audley Infant School,269,47,5,52
Lancashire,Lancaster Road Primary School,588,111,15,126
Lancashire,Morecambe and Heysham Sandylands Community Primary School,435,119,13,132
Lancashire,West End Primary School,181,65,3,68
Lancashire,Nateby Primary School,92,10,2,12
Lancashire,Nether Kellet Community Primary School,111,28,1,29
Lancashire,Kirkham and Wesham Primary School,208,37,10,47
Lancashire,Ansdell Primary School,246,23,3,26
Lancashire,Stalmine Primary School,93,12,4,16
Lancashire,Thornton Primary School,135,32,2,34
Lancashire,Thornton Cleveleys Royles Brook Primary School,290,30,1,31
Lancashire,Fulwood and Cadley Primary School,313,38,4,42
Lancashire,Harris Primary School,229,16,5,21
Lancashire,Kennington Primary School,243,22,6,28
Lancashire,Goosnargh Whitechapel Primary School,94,4,1,5
Lancashire,Lea Community Primary School,241,37,6,43
Lancashire,Little Hoole Primary School,200,13,3,16
Lancashire,Penwortham Primary School,208,3,1,4
Lancashire,Tarleton Community Primary School,228,10,2,12
Lancashire,Lostock Hall Community Primary School,435,22,7,29
Lancashire,Catforth Primary School,100,8,3,11
Lancashire,Clitheroe Pendle Primary School,346,22,4,26
Lancashire,Great Harwood Primary School,187,32,3,35
Blackburn with Darwen,Feniscowles Primary School,409,31,6,37
Lancashire,Padiham Primary School,293,29,9,38
Lancashire,Sabden Primary School,93,10,0,10
Lancashire,Barrowford School,326,55,29,84
Lancashire,Briercliffe Primary School,382,41,8,49
Lancashire,Park Primary School,338,33,14,47
Lancashire,Colne Primet Primary School,199,53,3,56
Lancashire,West Street Community Primary School,207,85,7,92
Lancashire,Bradley Primary School,414,31,8,39
Lancashire,Marsden Community Primary School,452,39,15,54
Lancashire,Lomeshaye Junior School,364,9,9,18
Lancashire,Walverden Primary School,444,66,8,74
Lancashire,Whitefield Infant School and Nursery,341,41,3,44
Lancashire,Trawden Forest Primary School,201,17,4,21
Lancashire,Worsthorne Primary School,206,21,2,23
Lancashire,Accrington Hyndburn Park Primary School,445,28,4,32
Lancashire,Accrington Peel Park Primary School,626,49,13,62
Lancashire,Accrington Spring Hill Community Primary School,379,41,8,49
Lancashire,Clayton-le-Moors Mount Pleasant Primary School,389,27,0,27
Lancashire,Oswaldtwistle Moor End Primary School,213,15,8,23
Lancashire,Britannia Community Primary School,209,22,5,27
Lancashire,Northern Primary School,183,21,4,25
Lancashire,Bacup St Saviour's Community Primary School,100,6,4,10
Lancashire,Sharneyford Primary School,62,6,3,9
Lancashire,Bacup Thorn Primary School,282,25,11,36
Lancashire,Haslingden Primary School,407,58,14,72
Lancashire,Helmshore Primary School,408,38,5,43
Lancashire,Ramsbottom Stubbins Primary School,201,16,2,18
Lancashire,Water Primary School,137,14,4,18
Lancashire,Waterfoot Primary School,312,21,10,31
Blackburn with Darwen,Ashleigh Primary School,224,17,6,23
Blackburn with Darwen,Turton Belmont Community Primary School,96,20,2,22
Lancashire,Anderton Primary School,195,12,5,17
Lancashire,Brindle Gregson Lane Primary School,166,13,3,16
Lancashire,Highfield Community Primary School,246,55,24,79
Lancashire,Buckshaw Primary School,233,34,5,39
Lancashire,Coppull Primary School and Nursery,307,97,9,106
Lancashire,Woodlea Junior School,250,20,3,23
Lancashire,Pinfold Primary School,16,10,0,10
Lancashire,Burnley Lowerhouse Junior School,216,24,2,26
Lancashire,Burnley Brunshaw Primary School,382,50,10,60
Blackburn with Darwen,Shadsworth Infant School,207,91,11,102
Blackburn with Darwen,Shadsworth Junior School,227,98,13,111
Blackburn with Darwen,Cedars Primary School,396,46,6,52
Lancashire,Crawford Village Primary School,82,8,0,8
Lancashire,Wrightington Mossy Lea Primary School,17,5,0,5
Lancashire,Brookfield Community Primary School,198,32,6,38
Lancashire,Deepdale Community Primary School,658,49,8,57
Lancashire,Eldon Primary School,253,71,1,72
Lancashire,Brockholes Wood Community Primary School and Nursery,235,32,2,34
Lancashire,Frenchwood Community Primary School,331,53,6,59
Lancashire,Preston Grange Primary School,177,25,7,32
Lancashire,Preston Greenlands Community Primary School,203,23,3,26
Lancashire,Holme Slack Community Primary School,199,25,7,32
Lancashire,Ribbleton Avenue Infant School,247,26,7,33
Lancashire,Moor Nook Community Primary School,195,19,2,21
Lancashire,The Roebuck School,319,35,8,43
Lancashire,Ashton Primary School,211,25,7,32
Lancashire,Ingol Community Primary School,201,22,16,38
Blackpool,Layton Primary School,626,96,5,101
Lancashire,Kelbrook Primary School,93,7,1,8
Lancashire,Earby Springfield Primary School,152,31,8,39
Lancashire,Burnley Stoneyholme Community Primary School,412,42,6,48
Lancashire,Rosegrove Infant School,176,36,2,38
Lancashire,Barden Primary School,462,72,28,100
Lancashire,Heasandford  Primary School,621,37,10,47
Lancashire,Whittlefield Primary School,228,37,5,42
Lancashire,Burnley Ightenhill Primary School,337,39,3,42
Lancashire,Gisburn Road Community Primary School,218,33,5,38
Lancashire,Salterforth Primary School,95,7,1,8
Lancashire,Gisburn Primary School,144,1,1,2
Lancashire,Tonacliffe Primary School,321,20,11,31
Lancashire,Trumacar Nursery and Community Primary School,375,55,8,63
Lancashire,Moorside Primary School,622,85,7,92
Lancashire,Edisford Primary School,220,18,5,23
Lancashire,Poulton-le-Fylde Carr Head Primary School,205,19,1,20
Lancashire,Charles Saer Community Primary School,320,50,2,52
Lancashire,Kingsfold Primary School,116,24,3,27
Lancashire,Weeton Primary School,146,11,8,19
Lancashire,Rawtenstall Balladen Community Primary School,165,20,3,23
Lancashire,Ormskirk West End School,91,20,3,23
Lancashire,Morecambe and Heysham Torrisholme Community Primary School,405,57,10,67
Lancashire,Lytham St Annes Mayfield Primary School,246,34,6,40
Lancashire,Seven Stars Primary School,207,27,10,37
Lancashire,Walton-le-Dale Community Primary School,438,48,5,53
Lancashire,Aughton Town Green Primary School,326,11,4,15
Lancashire,Freckleton Strike Lane Primary School,179,19,3,22
Lancashire,Northfold Community Primary School,202,23,5,28
Lancashire,Clifton Primary School,227,33,2,35
Lancashire,Queen's Drive Primary School,423,21,6,27
Lancashire,Whitefield Primary School,383,33,4,37
Blackburn with Darwen,Avondale Primary School,399,49,6,55
Lancashire,Stanah Primary School,397,20,8,28
Lancashire,Little Digmoor Primary School,137,5,2,7
Lancashire,Hillside Community Primary School,199,61,5,66
Lancashire,Larkholme Primary School,300,32,7,39
Lancashire,Garstang Community Primary School,208,16,4,20
Lancashire,Poulton-le-Fylde the Breck Primary School,288,16,2,18
Lancashire,Delph Side Community Primary School,258,38,8,46
Lancashire,Lever House Primary School,310,23,6,29
Lancashire,Withnell Fold Primary School,89,15,1,16
Lancashire,Abbey Village Primary School,51,10,2,12
Lancashire,Euxton Primrose Hill Primary School,421,33,6,39
Lancashire,Eccleston Primary School,203,19,3,22
Lancashire,Great Wood Primary School,413,65,9,74
Lancashire,Balshaw Lane Community Primary School,366,31,8,39
Lancashire,Crawshawbooth Primary School,305,22,3,25
Lancashire,Ormskirk Asmall Primary School,144,25,3,28
Lancashire,Lytham Hall Park Primary School,393,45,7,52
Lancashire,Carleton Green Community Primary School,326,18,6,24
Lancashire,Clayton-le-Woods Manor Road Primary School,250,16,6,22
Lancashire,Coupe Green Primary School,149,16,6,22
Lancashire,Reedley Primary School,390,44,6,50
Lancashire,Clitheroe Brookside Primary School,159,18,3,21
Lancashire,Caton Primary School,73,8,2,10
Lancashire,Holland Moor Primary School,467,45,9,54
Lancashire,Gillibrand Primary School,210,13,7,20
Lancashire,Lancaster Lane Community Primary School,207,30,11,41
Lancashire,Haslingden Broadway Primary School,210,26,7,33
Lancashire,Burscough Village Primary School,215,35,1,36
Lancashire,Cobbs Brow School,323,56,2,58
Lancashire,Adlington Primary School,132,14,3,17
Lancashire,Clayton Brook Primary School,176,32,9,41
Lancashire,Pool House Community Primary School,172,37,2,39
Lancashire,Fishwick Primary School,157,46,4,50
Lancashire,Crow Orchard Primary School,120,12,5,17
Lancashire,Coates Lane Primary School,193,30,6,36
Lancashire,Moss Side Primary School,259,25,6,31
Lancashire,Penwortham Broad Oak Primary School,198,27,3,30
Lancashire,Westwood Primary School,185,22,3,25
Lancashire,Sherwood Primary School,425,36,6,42
Lancashire,Accrington Woodnook Primary School,201,15,2,17
Lancashire,Shakespeare Primary School,417,74,9,83
Lancashire,Fleetwood Chaucer Community Primary School,268,72,10,82
Blackburn with Darwen,Brookhouse Primary School,268,44,10,54
Lancashire,Thornton Cleveleys Manor Beach Primary School,185,21,6,27
Lancashire,Morecambe and Heysham Westgate Primary School,573,95,8,103
Lancashire,Longton Primary School,203,24,1,25
Lancashire,Morecambe and Heysham Grosvenor Park Primary School,313,15,10,25
Lancashire,Duke Street Primary School,333,40,20,60
Lancashire,Ribbleton Avenue Methodist Junior School,276,34,6,40
Blackburn with Darwen,Blackburn St Thomas' Church of England Primary School,458,73,14,87
Blackburn with Darwen,St Michael With St John CofE Primary School,300,40,14,54
Blackburn with Darwen,Holy Trinity VC School,131,29,5,34
Lancashire,St Stephen's CofE School,319,46,5,51
Lancashire,Barnoldswick Church of England Controlled Primary School,378,37,6,43
Lancashire,Kirkland and Catterall St Helen's Church of England Voluntary Aided Primary School,164,21,1,22
Lancashire,Wray with Botton Endowed Primary School,56,7,3,10
Lancashire,"Cop Lane Church of England Primary School, Penwortham",213,20,1,21
Lancashire,Howick Church Endowed Primary School,103,9,3,12
Lancashire,Padiham Green Church of England Primary School,197,28,3,31
Lancashire,Rawtenstall St Paul's Church of England Primary School,282,67,4,71
Lancashire,St Mary's CofE Primary School Rawtenstall,195,12,7,19
Lancashire,Leyland St Andrew's Church of England Infant School,152,16,6,22
Lancashire,Aughton Christ Church Church of England Voluntary Controlled Primary School,196,23,3,26
Lancashire,Ormskirk Lathom Park Church of England Primary School,54,8,4,12
Lancashire,Ormskirk Church of England Primary School,401,25,9,34
Lancashire,St Bartholomew's Church of England Primary School,146,19,5,24
Lancashire,Staining Church of England Voluntary Controlled Primary School,226,19,0,19
Lancashire,Burscough Bridge St John's Church of England Primary School,159,7,5,12
Lancashire,Westhead Lathom St James' Church of England Primary School,98,13,2,15
Lancashire,Quernmore Church of England Voluntary Controlled Primary School,94,18,0,18
Lancashire,Tatham Fells Church of England Voluntary Controlled Primary School,36,0,2,2
Lancashire,Bamber Bridge St Aidan's Church of England Primary School,135,28,5,33
Lancashire,Bickerstaffe Voluntary Controlled Church of England School,100,7,9,16
Lancashire,Penwortham Middleforth Church of England Primary School,199,25,5,30
Lancashire,Roughlee Church of England Primary School,50,5,1,6
Lancashire,Banks St Stephen's CofE School,169,20,0,20
Lancashire,Edenfield Church of England Primary School,190,20,3,23
Lancashire,St Peter's CofE Primary School,141,28,4,32
Lancashire,Higham St John's Church of England Primary School,137,14,6,20
Lancashire,Aughton St Michael's Church of England Primary School,198,12,4,16
Lancashire,Read St John's CofE Primary School,189,21,5,26
Lancashire,Rawtenstall Newchurch Church of England Primary School,123,23,5,28
Lancashire,Thornton Cleveleys Baines Endowed Voluntary Controlled Primary School,210,20,6,26
Lancashire,"Carter's Charity Voluntary Controlled Primary School, Preesall",176,30,4,34
Lancashire,Higher Walton Church of England Primary School,115,21,9,30
Lancashire,Brabins Endowed School,81,5,3,8
Lancashire,Rishton Methodist Primary School,168,34,2,36
Lancashire,Barrow URC Primary School,169,10,4,14
Lancashire,Oswaldtwistle Hippings Methodist Voluntary Controlled Primary School,196,30,3,33
Lancashire,Leyland Methodist Junior School,262,37,3,40
Lancashire,Leyland Methodist Infant School,192,27,2,29
Lancashire,Burscough Bridge Methodist School,43,3,1,4
Lancashire,Holmeswood Methodist School,49,10,1,11
Lancashire,Warton Archbishop Hutton's VC Primary School,100,6,0,6
Lancashire,Banks Methodist School,83,13,0,13
Lancashire,Trinity Church of England/Methodist School,253,26,6,32
Lancashire,Hapton Church of England/Methodist Primary School,116,24,3,27
Blackburn with Darwen,Turton and Edgworth CofE/Methodist Controlled Primary School,191,30,3,33
Lancashire,Richard Durning's Endowed Primary School,91,17,2,19
Lancashire,Scarisbrick St Mark's Church of England Primary School,48,8,1,9
Blackpool,Bispham Endowed Church of England Primary School,364,47,11,58
Lancashire,Oswaldtwistle St Andrew's Church of England Primary School,305,21,7,28
Lancashire,Bacup Holy Trinity Stacksteads Church of England Primary School,257,26,6,32
Lancashire,Balderstone St Leonard's Church of England Voluntary Aided Primary School,98,9,1,10
Lancashire,"Fulwood, St Peter's Church of England Primary School and Nursery",250,30,4,34
Lancashire,Langho and Billington St Leonards Church of England Primary School,301,17,2,19
Lancashire,Chatburn Church of England Primary School,131,11,0,11
Lancashire,"St James' Church of England Primary School, Clitheroe",291,31,5,36
Lancashire,Great Harwood St Bartholomew's Parish Church of England Voluntary Aided Primary School,201,39,5,44
Lancashire,Great Harwood St John's Church of England Primary School,148,14,6,20
Blackburn with Darwen,Livesey Saint Francis' Church of England School,192,24,9,33
Lancashire,Mellor St Mary Church of England Primary School,141,10,1,11
Lancashire,Padiham St Leonard's Voluntary Aided Church of England Primary School,337,56,17,73
Lancashire,Rishton St Peter and St Paul's Church of England Primary School,177,18,4,22
Lancashire,Simonstone St Peter's Church of England Primary School,131,16,3,19
Lancashire,Whalley Church of England Primary School,313,34,8,42
Lancashire,Barrowford St Thomas Church of England Primary School,118,10,2,12
Lancashire,"St John's CofE Primary School, Cliviger",196,18,4,22
Lancashire,Colne Christ Church Church of England Voluntary Aided Primary School,185,30,7,37
Lancashire,Foulridge Saint Michael and All Angels CofE Voluntary Aided Primary School,198,27,3,30
Lancashire,Nelson St Philip's Church of England Primary School,138,19,1,20
Lancashire,Nelson St Paul's Church of England Primary School,415,54,8,62
Blackburn with Darwen,St Stephen's Church of England Primary School,390,49,10,59
Lancashire,Baxenden St John's Church of England Primary School,206,24,0,24
Lancashire,Accrington Benjamin Hargreaves Voluntary Aided Church of England Primary School,159,17,6,23
Lancashire,Green Haworth Church of England Primary School,71,14,4,18
Lancashire,"St Mary and St Andrew's Catholic Primary School, Barton Newsham",130,9,4,13
Lancashire,Accrington St John with St Augustine Church of England Primary School,202,34,5,39
Lancashire,Accrington St Mary Magdalen's Church of England Primary School,197,43,7,50
Lancashire,St Nicholas Church of England Primary School,191,36,2,38
Lancashire,Knuzden St Oswald's CofE Voluntary Aided Primary School,183,17,6,23
Lancashire,Oswaldtwistle St Paul's Church of England Primary School,160,24,5,29
Lancashire,Haslingden St James Church of England Primary School,212,29,2,31
Lancashire,St John's Stonefold CofE Primary School,114,20,2,22
Lancashire,St Anne's Church of England Primary School,187,25,5,30
Blackburn with Darwen,Hoddlesden St Paul's Church of England Primary School,236,23,7,30
Blackburn with Darwen,Darwen St Peter's Church of England Primary School,259,36,7,43
Blackburn with Darwen,St Stephen's Tockholes CofE Primary School,62,14,4,18
Lancashire,Bretherton Endowed Church of England Voluntary Aided Primary School,107,11,0,11
Lancashire,Brindle St James' Church of England Voluntary Aided Primary School,69,5,1,6
Lancashire,Christ Church Charnock Richard CofE Primary School,197,23,1,24
Lancashire,Chorley All Saints Church of England Primary School and Nursery Unit,203,45,4,49
Lancashire,"Chorley, the Parish of St Laurence Church of England Primary School",209,18,1,19
Lancashire,"St George's Church of England Primary School, Chorley",302,32,2,34
Lancashire,Chorley St James' Church of England Primary School,229,41,3,44
Lancashire,Clayton-le-Woods Church of England Primary School,222,33,4,37
Lancashire,Coppull St John's Church of England Voluntary Aided Primary School,104,9,3,12
Lancashire,Coppull Parish Church of England Primary School,202,14,3,17
Lancashire,Eccleston St Mary's Church of England Primary School,188,23,2,25
Lancashire,Euxton Church of England Voluntary Aided Primary School,211,20,4,24
Lancashire,Slaidburn Brennands Endowed Primary School,33,3,0,3
Lancashire,Heskin Pemberton's Church of England VA Primary School,94,1,1,2
Lancashire,Leyland St James Church of England Primary School,207,16,5,21
Lancashire,Mawdesley St Peter's Church of England Primary School,89,12,1,13
Lancashire,Whittle-le-Woods Church of England Primary School,243,41,8,49
Lancashire,Downholland-Haskayne Voluntary Aided Church of England Primary School,43,13,3,16
Lancashire,Halsall St Cuthbert's Church of England Primary School,176,2,0,2
Lancashire,Burscough Lordsgate Township Church of England Primary School,185,8,0,8
Lancashire,Newburgh Church of England Primary School,120,1,0,1
Lancashire,Rufford CofE School,139,8,0,8
Lancashire,Burnley St Peter's Church of England Primary School,210,15,7,22
Lancashire,Burnley Holy Trinity Church of England Primary School,208,46,8,54
Lancashire,Burnley St Stephen's Church of England Voluntary Aided Primary School,206,38,7,45
Lancashire,St James' Lanehead Church of England Primary School,276,38,5,43
Lancashire,Wellfield Methodist and Anglican Church School,203,29,3,32
Lancashire,Dalton St Michael's Church of England Primary School,59,7,1,8
Lancashire,St Thomas the Martyr Voluntary Aided Church of England Primary School,221,26,3,29
Lancashire,Upholland Roby Mill CofE Voluntary Aided Primary School,17,5,1,6
Lancashire,Appley Bridge All Saints Church of England Primary School,150,5,1,6
Blackburn with Darwen,St Barnabas and St Paul's Church of England Voluntary Aided Primary School,420,67,15,82
Blackburn with Darwen,St Gabriel's Church of England Primary School,211,20,8,28
Blackburn with Darwen,St James' Church of England Primary School Blackburn,434,92,6,98
Blackburn with Darwen,St James' Church of England Primary School,184,21,5,26
Blackburn with Darwen,St Matthew's Church of England Primary School,273,47,16,63
Lancashire,Rivington Foundation Primary School,113,28,5,33
Blackburn with Darwen,Sacred Heart Roman Catholic Primary School Blackburn,173,23,4,27
Blackburn with Darwen,St Anne's Roman Catholic Primary School Blackburn,229,41,6,47
Blackburn with Darwen,Our Lady of Perpetual Succour Roman Catholic Primary School Blackburn,171,66,4,70
Blackburn with Darwen,St Mary's and St Joseph's Roman Catholic Primary School Blackburn,211,23,2,25
Blackburn with Darwen,"St Peter's Roman Catholic Primary School, Blackburn",436,58,10,68
Blackburn with Darwen,St Antony's RC Primary School,226,36,8,44
Blackburn with Darwen,Holy Souls Roman Catholic Primary School Blackburn,203,14,5,19
Lancashire,Calder Vale St John Church of England Primary School,28,3,7,10
Lancashire,Bilsborrow John Cross Church of England Primary School,75,5,0,5
Lancashire,Bolton-le-Sands Church of England Primary School,310,14,4,18
Lancashire,"Carnforth Christ Church, Church of England, Voluntary Aided Primary School",116,40,1,41
Lancashire,Arkholme Church of England Primary School,101,13,3,16
Lancashire,Caton St Paul's Church of England Primary School,156,7,3,10
Lancashire,Cockerham Parochial CofE Primary School,75,7,1,8
Lancashire,Dolphinholme Church of England Primary School,91,4,1,5
Lancashire,Ellel St John the Evangelist Church of England Primary School,205,23,1,24
Lancashire,Garstang St Thomas' Church of England Primary School,253,22,2,24
Lancashire,St Wilfrid's Cof E Primary School,231,18,3,21
Lancashire,Hornby St Margaret's Church of England Primary School,48,1,3,4
Lancashire,Inskip St Peter's Church of England Voluntary Aided School,63,11,1,12
Lancashire,Lancaster Christ Church Church of England Primary School,207,25,6,31
Lancashire,Scotforth St Paul's Church of England Primary and Nursery School,224,20,4,24
Lancashire,Skerton St Luke's Church of England Primary School,197,27,4,31
Lancashire,Leck St Peter's Church of England Primary School,43,1,1,2
Lancashire,Melling St Wilfrid Church of England Primary School,31,3,2,5
Lancashire,Heysham St Peter's Church of England Primary School,248,16,5,21
Lancashire,Poulton-le-Sands Church of England Primary School,149,18,7,25
Lancashire,Overton St Helen's Church of England Primary School,177,10,2,12
Lancashire,Cawthorne's Endowed School,35,6,0,6
Lancashire,Silverdale St John's Church of England Voluntary Aided Primary School,70,13,0,13
Lancashire,"Slyne-with-Hest, St Luke's, Church of England Primary School",218,20,2,22
Lancashire,"Thurnham Glasson Christ Church, Church of England Primary School",9,2,0,2
Lancashire,St Michael's-On-Wyre Church of England Primary School & Nursery,112,9,0,9
Lancashire,Winmarleigh Church of England Primary School,17,3,0,3
Lancashire,Yealand Church of England Primary School,30,8,1,9
Lancashire,Freckleton Church of England Primary School,188,16,3,19
Lancashire,Great Eccleston Copp CofE Primary School,167,19,1,20
Lancashire,Kirkham St Michael's Church of England Primary School,199,28,6,34
Lancashire,Lytham Church of England Voluntary Aided Primary School,193,27,4,31
Lancashire,St Annes on Sea St Thomas' Church of England Primary School,197,22,5,27
Lancashire,Medlar-with-Wesham Church of England Primary School,172,24,3,27
Lancashire,Pilling St John's Church of England Voluntary Aided Primary School,114,13,2,15
Lancashire,Poulton-le-Fylde St Chad's CofE Primary School,242,17,5,22
Lancashire,Carleton St Hilda's Church of England Primary School,204,24,2,26
Lancashire,Preesall Fleetwood's Charity Church of England Primary School,129,26,3,29
Lancashire,Ribby with Wrea Endowed CofE Primary School,151,5,7,12
Lancashire,Singleton Church of England Voluntary Aided Primary School,103,15,1,16
Lancashire,Weeton St Michael's Church of England Voluntary Aided Primary School,54,12,3,15
Lancashire,Barton St Lawrence Church of England Primary School,195,14,2,16
Lancashire,Broughton-in-Amounderness Church of England Primary School,298,17,5,22
Lancashire,Goosnargh Oliverson's Church of England Primary School,200,12,2,14
Lancashire,Grimsargh St Michael's Church of England Primary School,206,16,4,20
Lancashire,Hesketh-with-Becconsall All Saints CofE School,214,17,2,19
Lancashire,Lea Neeld's Endowed Church of England Primary School,142,16,2,18
Lancashire,Longridge Church of England Primary School,192,28,4,32
Lancashire,New Longton All Saints CofE Primary School,213,8,0,8
Lancashire,Hoole St Michael CofE Primary School,96,9,2,11
Lancashire,Ribchester St Wilfrid's Church of England Voluntary Aided Primary School,78,2,2,4
Lancashire,Samlesbury Church of England School,67,1,1,2
Lancashire,Tarleton Holy Trinity CofE Primary School,191,19,5,24
Lancashire,Tarleton Mere Brow Church of England Primary School,82,14,3,17
Lancashire,"Walton-le-Dale, St Leonard's Church of England Primary School",263,30,5,35
Lancashire,Woodplumpton St Anne's CofE Primary School,106,6,3,9
Lancashire,Altham St James Church of England Primary School,74,3,2,5
Lancashire,St Anne's Catholic Primary School,182,33,6,39
Lancashire,St Patrick's Catholic Primary School,198,34,5,39
Lancashire,"St Bernadette's Catholic Primary School, Lancaster",211,33,3,36
Lancashire,St Catherine's RC Primary School,222,18,3,21
Lancashire,"St John's Catholic Primary School, Skelmersdale",201,48,1,49
Lancashire,"St James' Catholic Primary School, Skelmersdale",221,22,1,23
Lancashire,"St Veronica's Roman Catholic Primary School, Helmshore",161,16,3,19
Lancashire,"Holy Family Catholic Primary School, Warton",137,17,5,22
Lancashire,St Edmund's Catholic Primary School,84,25,3,28
Blackpool,Blackpool St Nicholas CofE Primary School,413,46,3,49
Blackpool,Blackpool St John's Church of England Primary School,205,54,8,62
Blackpool,Our Lady of the Assumption Catholic Primary School,201,22,7,29
Blackpool,St John Vianney's Catholic Primary School,444,69,5,74
Blackpool,Holy Family Catholic Primary School,209,34,5,39
Lancashire,Ashton-on-Ribble St Andrew's Church of England Primary School,419,29,5,34
Lancashire,"English Martyrs Catholic Primary School, Preston",227,44,8,52
Lancashire,Sacred Heart Catholic Primary School,208,20,0,20
Lancashire,"St Maria Goretti Catholic Primary School, Preston",223,45,2,47
Lancashire,"St Gregory's Catholic Primary School, Preston",210,22,5,27
Lancashire,St Ignatius' Catholic Primary School,189,30,3,33
Lancashire,"Holy Family Catholic Primary School, Ingol, Preston",195,14,1,15
Lancashire,Farington Moss St. Paul's C.E. Primary School,185,15,6,21
Lancashire,Scorton Church of England Primary School,62,4,0,4
Lancashire,Over Kellet Wilson's Endowed Church of England Primary School,122,21,5,26
Blackburn with Darwen,St Cuthbert's Church of England Primary School,215,29,22,51
Lancashire,Bishop Martin Church of England Primary School,223,24,1,25
Lancashire,St Mary and Michael Catholic Primary School,122,11,1,12
Lancashire,"Our Lady of Lourdes Catholic Primary School, Carnforth",77,15,0,15
Lancashire,"St Mary's Catholic Primary School, Claughton-on-Brock",43,3,0,3
Lancashire,"The Cathedral Catholic Primary School, Lancaster",208,12,4,16
Lancashire,"St Mary's Catholic Primary School, Morecambe",172,20,5,25
Lancashire,"St Mary's Catholic Primary School, Fleetwood",171,34,1,35
Lancashire,"The Willows Catholic Primary School, Kirkham",209,23,1,24
Lancashire,Our Lady Star of the Sea Catholic Primary School,210,32,4,36
Lancashire,"St Peter's Catholic Primary School, Lytham",204,9,4,13
Lancashire,"St Joseph's Catholic Primary School, Medlar-with-Wesham",107,7,2,9
Lancashire,"St William's Catholic Primary School, Pilling",38,12,3,15
Lancashire,"St John's Catholic Primary School, Poulton-le-Fylde",208,20,0,20
Lancashire,"St Francis Catholic Primary School, Goosnargh",95,3,2,5
Lancashire,St Mary's Catholic Primary School,106,23,2,25
Lancashire,"Alston Lane Catholic Primary School, Longridge",237,12,4,16
Lancashire,Longridge St Wilfrid's Roman Catholic Primary School,200,38,6,44
Lancashire,"St Oswald's Catholic Primary School, Longton",245,17,5,22
Lancashire,St Mary Magdalen's Catholic Primary School,197,22,4,26
Lancashire,"Our Lady and St Gerard's Roman Catholic Primary School, Lostock Hall",356,37,4,41
Lancashire,"St Patrick's Roman Catholic Primary School, Walton-le-Dale",181,10,6,16
Lancashire,"St Joseph's Roman Catholic Primary School, Hurst Green",113,3,2,5
Lancashire,"St Mary's Roman Catholic Primary School, Langho",294,15,1,16
Lancashire,"St Mary's Roman Catholic Primary School, Chipping",38,6,2,8
Lancashire,"St Michael and St John's Roman Catholic Primary School, Clitheroe",167,22,2,24
Lancashire,"St Hubert's Roman Catholic Primary School, Great Harwood",150,13,4,17
Lancashire,"St Wulstan's Catholic Primary School, Great Harwood",156,23,1,24
Lancashire,"St Mary's Roman Catholic Primary School, Osbaldeston",87,16,1,17
Lancashire,"St John the Baptist Roman Catholic Primary School, Padiham",228,28,1,29
Blackburn with Darwen,"St Paul's Roman Catholic Primary School, Feniscowles, Blackburn",215,22,3,25
Lancashire,St Charles' RC School,172,18,2,20
Lancashire,"St Mary's Roman Catholic Primary School, Sabden",68,11,6,17
Lancashire,"Holy Trinity Roman Catholic Primary School, Brierfield",114,9,8,17
Lancashire,"Holy Saviour Roman Catholic Primary School, Nelson",207,17,6,23
Lancashire,"St John Southworth Roman Catholic Primary School, Nelson",212,25,8,33
Lancashire,St Anne's and St Joseph's Roman Catholic Primary School,169,24,3,27
Lancashire,"St Oswald's Roman Catholic Primary School, Accrington",155,27,3,30
Lancashire,"Sacred Heart Roman Catholic Primary School, Church",190,24,2,26
Lancashire,"St Mary's Roman Catholic Primary School, Clayton-le-Moors",115,19,3,22
Lancashire,"St Mary's Roman Catholic Primary School, Oswaldtwistle",260,21,4,25
Lancashire,"St Joseph's Roman Catholic Primary School, Stacksteads, Bacup",113,27,5,32
Lancashire,"St Mary's Roman Catholic Primary School, Haslingden",142,18,4,22
Lancashire,"St Peter's Roman Catholic Primary School, Newchurch",150,19,4,23
Lancashire,"St James-the-Less Roman Catholic Primary School, Rawtenstall",212,12,1,13
Blackburn with Darwen,St Edward's Roman Catholic Primary School Blackburn,195,25,1,26
Blackburn with Darwen,"St Joseph's Roman Catholic Primary School, Darwen",181,32,9,41
Lancashire,"St Joseph's Catholic Primary School, Anderton",174,6,7,13
Lancashire,"St Joseph's Catholic Primary School, Brindle",87,8,0,8
Lancashire,"Sacred Heart Catholic Primary School, Chorley",209,11,3,14
Lancashire,"St Joseph's Catholic Primary School, Chorley",207,20,4,24
Lancashire,"St Mary's Catholic Primary School and Nursery, Chorley",238,7,6,13
Lancashire,"St Gregory's Catholic Primary School, Chorley",213,15,7,22
Lancashire,St Bede's Catholic Primary School,207,18,1,19
Lancashire,"St Oswald's Catholic Primary School, Coppull",104,15,3,18
Lancashire,St. Mary's Catholic Primary School Euxton,208,12,2,14
Lancashire,Leyland St Mary's Roman Catholic Primary School,260,37,2,39
Lancashire,"St Peter and Paul Catholic Primary School, Mawdesley",51,4,1,5
Lancashire,St Chad's Catholic Primary School,137,17,2,19
Lancashire,"St Joseph's Catholic Primary School, Withnell",100,10,1,11
Lancashire,"St John's Catholic Primary School, Burscough",100,16,3,19
Lancashire,Ormskirk St Anne's Catholic Primary School,369,23,1,24
Lancashire,"St Mary's Catholic Primary School, Scarisbrick",82,6,2,8
Lancashire,"St Richard's Catholic Primary School, Skelmersdale",231,16,10,26
Lancashire,"St Joseph's Catholic Primary School, Barnoldswick",123,21,4,25
Lancashire,Grindleton Church of England Voluntary Aided Primary School,34,3,3,6
Lancashire,Waddington and West Bradford Church of England Voluntary Aided Primary School,203,14,3,17
Lancashire,Bolton by Bowland Church of England Voluntary Aided Primary School,40,5,1,6
Lancashire,"Thorneyholme Roman Catholic Primary School, Dunsop Bridge",29,6,0,6
Blackpool,St Bernadette's Catholic Primary School,209,24,3,27
Lancashire,Heyhouses Endowed Church of England Primary School,606,81,15,96
Lancashire,"Our Lady and All Saints Roman Catholic Primary School, Parbold",109,9,0,9
Lancashire,St Teresa's Catholic Primary School,227,16,3,19
Lancashire,"St Joseph's Catholic Primary School, Wrightington",105,8,3,11
Lancashire,"Our Lady and St Anselm's Roman Catholic Primary School, Whitworth",203,32,4,36
Lancashire,St Anthony's Catholic Primary School,316,35,10,45
Lancashire,"Penwortham, St Teresa's Catholic Primary School",274,14,9,23
Lancashire,Treales Church of England Primary School,60,11,2,13
Lancashire,Wheatley Lane Methodist Voluntary Aided Primary School,206,16,3,19
Lancashire,"St Mary's Roman Catholic Primary School, Burnley",207,22,14,36
Lancashire,St Mary's and St Benedict's Roman Catholic Primary School,288,31,3,34
Lancashire,Brinscall St John's CofE and Methodist Primary School,211,29,7,36
Blackburn with Darwen,St Alban's Roman Catholic Primary School Blackburn,184,44,7,51
Lancashire,Ashton Community Science College,862,159,39,198
Lancashire,Millfield Science & Performing Arts College,868,71,19,90
Lancashire,Ribblesdale School,1408,138,17,155
Lancashire,Alder Grange School,843,103,16,119
Lancashire,Wellfield Academy,417,40,10,50
Lancashire,Lytham St Annes High School,1577,128,22,150
Lancashire,Walton-le-Dale High School,772,102,32,134
Lancashire,Carr Hill High School,899,161,21,182
Lancashire,Longridge High School,801,95,7,102
Lancashire,Up Holland High School,845,60,11,71
Lancashire,Whitworth Community High School,658,107,16,123
Lancashire,Broughton High School,917,77,11,88
Lancashire,Penwortham Girls' High School,792,13,16,29
Lancashire,Haslingden High School and Sixth Form,1544,136,28,164
Lancashire,Fleetwood High School,1039,119,17,136
Lancashire,Moor Park High School and Sixth Form,595,96,9,105
Lancashire,Lathom High School : A Technology College,644,112,17,129
Lancashire,Balshaw's Church of England High School,916,27,15,42
Lancashire,Our Lady's Catholic High School,900,54,12,66
Lancashire,Corpus Christi Catholic High School,791,69,8,77
Lancashire,Christ The King Catholic High School,402,49,17,66
Lancashire,Our Lady Queen of Peace Catholic Engineering College,915,132,18,150
Lancashire,Brownedge St  Mary's Catholic High School,746,58,10,68
Lancashire,Ss John Fisher and Thomas More Roman Catholic High School,810,87,12,99
Lancashire,St Bede's Catholic High School,821,33,25,58
Lancashire,Saint Aidan's Church of England High School,847,56,17,73
Blackburn with Darwen,Our Lady and St John Catholic College,816,210,9,219
Lancashire,St Bede's Catholic High School,707,60,12,72
Blackburn with Darwen,"St Bede's Roman Catholic High School, Blackburn",1057,49,32,81
Lancashire,Hutton Church of England Grammar School,884,83,20,103
Lancashire,Our Lady's Catholic College,1031,384,32,416
Lancashire,"Cardinal Allen Catholic High School, Fleetwood",806,130,16,146
Lancashire,St Cecilia's RC High School,532,103,7,110
Lancashire,All Hallows Catholic High School,910,42,18,60
Lancashire,Holy Cross Catholic High School,987,63,18,81
Lancashire,"Mount Carmel Roman Catholic High School, Hyndburn",799,93,18,111
Lancashire,Newton Bluecoat Church of England Primary School,208,4,4,8
Lancashire,St Peter's CofE Primary School Chorley,297,41,5,46
Lancashire,Salesbury Church of England Primary School,288,17,7,24
Lancashire,Barnacre Road Primary School,227,33,2,35
Lancashire,Baines School,852,16,16,32
Lancashire,Archbishop Temple Church of England High School,788,51,13,64
Lancashire,St Mary's Catholic High School,798,98,12,110
Lancashire,Stonyhurst College,792,225,5,230
Lancashire,Rossall School,841,103,3,106
Lancashire,The St Anne's College Grammar School,97,2,24,26
Lancashire,Moorland School Limited,169,25,2,27
Lancashire,St Pius X Preparatory School,127,10,4,14
Lancashire,Scarisbrick Hall School,865,142,5,147
Blackburn with Darwen,Westholme School,733,60,3,63
Lancashire,Highfield Priory School,207,5,3,8
Lancashire,St Joseph's Park Hill School,113,30,0,30
Lancashire,Oakhill School,298,26,8,34
Lancashire,Kirkham Grammar School,880,83,0,83
Lancashire,AKS Lytham,767,58,1,59
Lancashire,Rossendale School,97,0,97,97
Blackburn with Darwen,Rawdhatul Uloom Islamic Primary School,142,0,0,0
Lancashire,Crookhey Hall School,90,0,90,90
Lancashire,Waterloo Lodge,45,0,45,45
Lancashire,Ashbridge Independent School,514,29,0,29
Blackburn with Darwen,Al Islah Girls' High School,126,0,0,0
Lancashire,Bleasdale School,35,0,35,35
Lancashire,Moorbrook School,54,0,54,54
Blackpool,Highfurlong School,109,0,109,109
Blackpool,Woodlands School,110,0,110,110
Lancashire,Morecambe Road School,194,0,194,194
Lancashire,Chorley Astley Park School,167,0,167,167
Lancashire,Great Arley School,107,0,107,107
Lancashire,Rawtenstall Cribden House Community Special School,90,0,90,90
Lancashire,Applebee Wood Community Specialist School,155,0,155,155
Lancashire,Broadfield Specialist School,191,2,189,191
Lancashire,Kirkham Pear Tree School,99,0,99,99
Lancashire,Mayfield School,120,0,120,120
Lancashire,The Loyne Specialist School,111,0,111,111
Lancashire,The Coppice School,65,0,65,65
Lancashire,Oswaldtwistle White Ash School,111,0,111,111
Lancashire,Brookfield School,75,0,75,75
Lancashire,Thornton-Cleveleys Red Marsh School,106,0,106,106
Lancashire,Hope High School,84,0,84,84
Leicestershire,The Latimer Primary School,375,57,8,65
Leicestershire,Moira Primary School,195,29,5,34
Leicestershire,Buckminster Primary School,80,13,1,14
Leicestershire,Burton-on-the-Wolds Primary School,191,29,4,33
Leicestershire,Belvoirdale Community Primary School,308,52,13,65
Leicestershire,Ellistown Community Primary School,199,19,5,24
Leicestershire,Hugglescote Community Primary School,462,61,13,74
Leicestershire,Woodstone Community Primary School,210,26,4,30
Leicestershire,New Swannington Primary School,190,25,6,31
Leicestershire,Griffydam Primary School,107,11,1,12
Leicestershire,Foxton Primary School,84,9,3,12
Leicestershire,Martinshaw Primary School,210,23,1,24
Leicestershire,Heather Primary School,116,18,3,21
Leicestershire,Westfield Junior School,369,59,28,87
Leicestershire,Westfield Infant School,287,22,27,49
Leicestershire,Barwell Infant School,161,8,1,9
Leicestershire,Ibstock Junior School,327,77,5,82
Leicestershire,Kegworth Primary School,225,16,2,18
Leicestershire,Hemington Primary School,57,7,3,10
Leicestershire,Little Bowden School,388,61,6,67
Leicestershire,Newbold Verdon Primary School,232,40,32,72
Leicestershire,Congerstone Primary School,183,1,1,2
Leicestershire,Stathern Primary School,95,13,1,14
Leicestershire,Newton Burgoland Primary School,81,7,0,7
Leicestershire,Worthington School,71,18,1,19
Leicestershire,Blaby Thistly Meadow Primary School,251,41,7,48
Leicestershire,Thorpe Acre Junior School,186,43,15,58
Leicestershire,Thorpe Acre Infant School,129,18,2,20
Leicestershire,Elizabeth Woodville Primary School,210,30,4,34
Leicestershire,Oxley Primary School Shepshed,260,33,6,39
Leicestershire,Burbage Junior School,352,58,13,71
Leicestershire,Booth Wood Primary School,242,26,6,32
Leicestershire,Badgerbrook Primary School,419,24,7,31
Leicestershire,Warren Hills Community Primary School,198,47,9,56
Leicestershire,Newlands Community Primary School,306,58,8,66
Leicestershire,Sketchley Hill Primary School Burbage,556,48,17,65
Leicestershire,Thythorn Field Community Primary School,198,25,6,31
Leicester,Bridge Junior School,360,55,5,60
Leicester,Catherine Infant School,398,63,19,82
Leicester,Catherine Junior School,475,35,6,41
Leicester,Evington Valley Primary School,363,40,12,52
Leicester,Granby Primary School,469,58,9,67
Leicester,Rushey Mead Primary School,576,54,14,68
Leicester,Imperial Avenue Infant School,308,32,11,43
Leicester,Inglehurst Infant School,250,40,6,46
Leicester,Inglehurst Junior School,311,51,18,69
Leicester,King Richard III Infant and Nursery School,282,12,13,25
Leicester,Mayflower Primary School,459,47,6,53
Leicester,Merrydale Infant School,358,26,2,28
Leicester,St Mary's Fields Primary School,446,33,3,36
Leicester,Shaftesbury Junior School,240,31,1,32
Leicester,Wyvern Primary School,409,34,7,41
Leicester,Montrose School,450,56,11,67
Leicester,Folville Junior School,360,34,10,44
Leicester,Shenton Primary School,457,61,7,68
Leicester,Stokes Wood Primary School,476,38,19,57
Leicester,Wolsey House Primary School,638,104,14,118
Leicester,Buswells Lodge Primary School,409,54,8,62
Leicester,Sandfield Close Primary School,298,21,11,32
Leicester,Barley Croft Primary School,345,45,20,65
Leicester,Taylor Road Primary School,664,75,7,82
Leicester,Linden Primary School,440,35,7,42
Leicester,Eyres Monsell Primary School,398,92,5,97
Leicestershire,The Hall School,414,72,4,76
Leicester,Hazel Community Primary School,409,54,4,58
Leicester,Charnwood Primary School,438,30,4,34
Leicester,Mellor Community Primary School,622,66,6,72
Leicester,Marriott Primary School,432,47,12,59
Leicestershire,Water Leys Primary School,417,77,6,83
Leicester,Whitehall Primary School,657,77,9,86
Leicester,Spinney Hill Primary School,670,95,4,99
Leicester,Scraptoft Valley Primary School,439,63,11,74
Leicester,Beaumont Lodge Primary School,228,45,8,53
Leicester,Parks Primary School,455,59,9,68
Leicester,Coleman Primary School,603,59,3,62
Leicestershire,Woodcote Primary School,158,26,17,43
Leicester,Herrick Primary School,403,34,3,37
Leicester,Slater Primary School,211,13,4,17
Leicester,Alderman Richard Hallam Primary School,906,78,11,89
Leicester,Medway Community Primary School,482,54,7,61
Leicestershire,Belton Church of England Primary School,96,15,4,19
Leicestershire,Billesdon Church of England Primary School,94,9,1,10
Leicestershire,St Hardulph's Church of England Primary School,51,13,2,15
Leicestershire,"Orchard Church of England Primary School, Broughton Astley",195,18,2,20
Leicestershire,Burbage Church of England Infant School,263,28,4,32
Leicestershire,St Edward's Church of England Primary School,191,22,1,23
Leicestershire,"All Saints Church of England Primary School, Coalville",219,49,11,60
Leicestershire,Cossington Church of England Primary School,106,9,1,10
Leicestershire,Diseworth Church of England Primary School,44,14,1,15
Leicestershire,Fleckney Church of England Primary School,434,76,11,87
Leicestershire,Great Glen St Cuthbert's Church of England Primary School,305,31,6,37
Leicestershire,Harby Church of England Primary School,73,12,1,13
Leicestershire,"St Mary's Church of England Primary School, Hinckley",274,27,8,35
Leicestershire,Hose Church of England Primary School,54,6,0,6
Leicestershire,"St Denys Church of England Infant School, Ibstock",238,29,16,45
Leicestershire,Long Clawson Church of England Primary School,59,5,3,8
Leicestershire,Long Whatton Church of England Primary School and Community Centre,95,7,1,8
Leicestershire,Newbold Church of England Primary School,40,9,1,10
Leicestershire,Packington Church of England Primary School,101,9,2,11
Leicestershire,St Bartholomew's Church of England Primary School,528,74,8,82
Leicestershire,Scalford Church of England Primary School,70,7,0,7
Leicestershire,Sheepy Magna Church of England Primary School,108,12,2,14
Leicestershire,St Botolph's Church of England Primary School,312,40,11,51
Leicestershire,Swithland St Leonard's Church of England Primary School,87,10,0,10
Leicestershire,Whitwick St John The Baptist Church of England Primary School,374,63,8,71
Leicestershire,Witherley Church of England Primary School,106,8,1,9
Leicestershire,Woodhouse Eaves St Paul's Church of England Primary School,197,13,1,14
Leicestershire,Wymeswold Church of England Primary School,116,13,2,15
Leicestershire,Hathern Church of England Primary School,190,9,1,10
Leicestershire,Hallaton Church of England Primary School,87,8,0,8
Rutland,Oakham CofE Primary School,253,42,30,72
Leicester,St Barnabas CofE Primary School,336,31,4,35
Leicestershire,Ashby-de-la-Zouch Church of England Primary School,320,38,5,43
Leicestershire,Sir John Moore Church of England Primary School,152,37,1,38
Leicestershire,Kilby St Mary's Church of England Primary School,75,7,3,10
Leicestershire,Snarestone Church of England Primary School,73,8,1,9
Leicestershire,Thurlaston Church of England Primary School,93,12,2,14
Rutland,St Mary and St John CofE VA Primary School,203,19,6,25
Leicester,St John the Baptist CofE Primary School,607,90,10,100
Leicester,Crown Hills Community College,1491,176,18,194
Leicester,Beaumont Leys School,1085,188,21,209
Leicester,Soar Valley College,1566,190,22,212
Leicester,Moat Community College,1085,124,4,128
Leicester,The City of Leicester College,1696,214,18,232
Leicester,Fullhurst Community College,1517,214,77,291
Leicestershire,Ratcliffe College,909,222,3,225
Leicestershire,Loughborough Amherst School,438,13,15,28
Rutland,Uppingham School,847,118,0,118
Rutland,Oakham School,1015,171,0,171
Leicester,Leicester High School for Girls,312,33,0,33
Leicestershire,Stoneygate School,228,87,9,96
Leicester,St Crispin's School,97,5,2,7
Leicester,Leicester Preparatory School,31,0,0,0
Leicestershire,The Grange Therapeutic School,79,0,79,79
Leicestershire,Twycross House School,393,62,0,62
Leicestershire,Loughborough Grammar School,883,137,0,137
Leicestershire,Loughborough High School,529,78,1,79
Leicestershire,Leicester Grammar School Trust,1300,271,2,273
Leicester,Leicester Islamic Academy,326,36,3,39
Leicestershire,Twycross House Pre-Preparatory School,137,11,1,12
Leicestershire,Dixie Grammar School,472,44,4,48
Rutland,Brooke Priory School,140,13,0,13
Leicestershire,Brooke House College,254,10,0,10
Leicestershire,Fairfield Prep School,512,57,1,58
Leicester,Darul Uloom Leicester,134,1,0,1
Leicestershire,Maplewell Hall School,294,0,294,294
Leicestershire,Ashmount School,196,0,196,196
Rutland,The Parks School,8,0,8,8
Leicester,Nether Hall School,131,2,129,131
Leicester,The Children's Hospital School,68,48,12,60
Lincolnshire,Wyndham Park Nursery School,105,3,3,6
Lincolnshire,The Lincoln St Giles Nursery School,120,13,0,13
Lincolnshire,Billingborough Primary School,134,33,4,37
Lincolnshire,Corby Glen Community Primary School,71,12,5,17
Lincolnshire,Digby the Tedder Primary School,108,11,5,16
Lincolnshire,Eagle Community Primary School,74,16,5,21
Lincolnshire,Helpringham School,92,19,1,20
Lincolnshire,Langtoft Primary School,193,20,1,21
Lincolnshire,The Metheringham Primary School,266,34,11,45
Lincolnshire,Nocton Community Primary School,35,4,1,5
Lincolnshire,North Scarle Primary School,61,5,3,8
Lincolnshire,Osbournby Primary School,81,7,4,11
Lincolnshire,Church Lane Primary School & Nursery,203,16,5,21
Lincolnshire,The South Hykeham Community Primary School,144,26,6,32
Lincolnshire,Walcott Primary School,94,16,4,20
Lincolnshire,Belton Lane Community Primary School,327,62,6,68
Lincolnshire,Cliffedale Primary School,295,30,6,36
Lincolnshire,Deeping St James Community Primary School,211,15,7,22
Lincolnshire,Market Deeping Community Primary School,306,43,5,48
Lincolnshire,Skellingthorpe the Holt Primary School,194,16,6,22
Lincolnshire,Belmont Community Primary School,204,35,6,41
Lincolnshire,South View Community Primary School,413,32,14,46
Lincolnshire,Deeping St Nicholas Primary School,61,9,0,9
Lincolnshire,Fleet Wood Lane School,188,32,5,37
Lincolnshire,Gedney Drove End Primary School,37,9,2,11
Lincolnshire,Clough and Risegate Community Primary School,87,5,4,9
Lincolnshire,Kirton Primary School,549,122,9,131
Lincolnshire,Moulton Chapel Primary School,72,20,3,23
Lincolnshire,"The John Harrox Primary School, Moulton",257,26,8,34
Lincolnshire,Sutton St James Community Primary School,116,22,2,24
Lincolnshire,Shepeau Stow Primary School,70,16,0,16
Lincolnshire,Hawthorn Tree School,345,60,12,72
Lincolnshire,The Spalding Monkshouse Primary School,460,47,8,55
Lincolnshire,Sir Francis Hill Community Primary School,615,92,17,109
Lincolnshire,Lincoln Monks Abbey Primary School,565,116,14,130
Lincolnshire,Woodlands Infant and Nursery School,121,8,6,14
Lincolnshire,Alford Primary School,318,41,10,51
Lincolnshire,Bucknall Primary School,35,11,5,16
Lincolnshire,The Donington-on-Bain School,94,11,4,15
Lincolnshire,Faldingworth Community Primary School,70,19,3,22
Lincolnshire,Fulstow Community Primary School,40,4,1,5
Lincolnshire,Grainthorpe Junior School,42,12,1,13
Lincolnshire,Great Steeping Primary School,100,16,1,17
Lincolnshire,Holton Le Clay Infant School,88,25,1,26
Lincolnshire,Ingham Primary School,82,12,2,14
Lincolnshire,Legsby Primary School,47,13,4,17
Lincolnshire,Marshchapel Infant School,29,1,2,3
Lincolnshire,The Middle Rasen Primary School,134,13,5,18
Lincolnshire,Morton Trentside Primary School,194,25,5,30
Lincolnshire,Nettleton Community Primary School,80,19,3,22
Lincolnshire,The New Leake Primary School,37,12,2,14
Lincolnshire,Normanby Primary School,54,5,1,6
Lincolnshire,Kelsey Primary School,110,8,5,13
Lincolnshire,Osgodby Primary School,91,13,2,15
Lincolnshire,Pollyplatt Primary School,101,12,3,15
Lincolnshire,Scotter Primary School,277,61,4,65
Lincolnshire,Sturton by Stow Primary School,178,31,5,36
Lincolnshire,Sutton-on-Sea Community Primary School,159,37,4,41
Lincolnshire,Tealby School,79,15,4,19
Lincolnshire,"The Edward Richardson Primary School, Tetford",107,16,1,17
Lincolnshire,Tetney Primary School,110,11,5,16
Lincolnshire,Toynton All Saints Primary School,146,13,1,14
Lincolnshire,Waddingham Primary School,77,14,1,15
Lincolnshire,Willoughton Primary School,48,5,1,6
Lincolnshire,Wragby Primary School,185,38,5,43
Lincolnshire,Hemswell Cliff Primary School,42,15,3,18
Lincolnshire,The Gainsborough Charles Baines Community Primary School,205,40,7,47
Lincolnshire,Tattershall Primary School,138,11,9,20
Lincolnshire,"The Richmond School, Skegness",406,44,14,58
Lincolnshire,Winchelsea Primary School Ruskington,231,17,5,22
Lincolnshire,Holton-le-Clay Junior School,123,26,5,31
Lincolnshire,Sutton Bridge Westmere Community Primary School,236,37,8,45
Lincolnshire,Bythams Primary School,81,15,3,18
Lincolnshire,Lincoln Birchwood Junior School,254,52,17,69
Lincolnshire,Leslie Manser Primary School,244,24,13,37
Lincolnshire,Allington with Sedgebrook Church of England Primary School,112,14,2,16
Lincolnshire,Ancaster CofE Primary School,184,33,8,41
Lincolnshire,Barrowby Church of England Primary School,237,23,6,29
Lincolnshire,Baston CE Primary School,181,16,2,18
Lincolnshire,The Billinghay Church of England Primary School,158,23,4,27
Lincolnshire,Coleby Church of England (Controlled) Primary School,46,11,2,13
Lincolnshire,Denton CofE School,60,9,1,10
Lincolnshire,Digby Church of England School,59,7,3,10
Lincolnshire,Dunston St Peter's Church of England Primary School,70,4,1,5
Lincolnshire,"St Anne's Church of England Primary School, Grantham",212,29,3,32
Lincolnshire,The Gonerby Hill Foot Church of England Primary School,299,56,11,67
Lincolnshire,The Harlaxton Church of England Primary School,193,25,6,31
Lincolnshire,Heckington St Andrew's Church of England School,168,14,4,18
Lincolnshire,The Leasingham St Andrew's Church of England Primary School,212,20,5,25
Lincolnshire,Mrs Mary King's CofE (Controlled) Primary School,103,12,4,16
Lincolnshire,Navenby Church of England Primary School,193,18,10,28
Lincolnshire,The North Hykeham All Saints Church of England Primary School,193,35,13,48
Lincolnshire,The Potterhanworth Church of England Primary School,127,7,3,10
Lincolnshire,The Ropsley Church of England Primary School,112,22,1,23
Lincolnshire,St Lawrence Church of England Primary School,208,23,5,28
Lincolnshire,Swinderby All Saints Church of England Primary School,83,11,4,15
Lincolnshire,"The St Michael's Church of England Primary School, Thorpe on the Hill",197,16,6,22
Lincolnshire,The Uffington Church of England Primary School,85,5,4,9
Lincolnshire,The Welbourn Church of England Primary School,58,10,3,13
Lincolnshire,The Claypole Church of England Primary School,156,6,0,6
Lincolnshire,The Gedney Hill Church of England VC Primary School,70,18,5,23
Lincolnshire,The Holbeach St Mark's Church of England Primary School,41,4,1,5
Lincolnshire,St Bartholomews CofE Primary School,101,9,4,13
Lincolnshire,Quadring Cowley & Brown's Primary School,104,23,1,24
Lincolnshire,Weston Hills CofE Primary School,129,13,10,23
Lincolnshire,The Donington Cowley Endowed Primary School,261,25,9,34
Lincolnshire,Swineshead St Mary's Church of England Primary School,263,38,11,49
Lincolnshire,"The Fourfields Church of England School, Sutterton",154,29,7,36
Lincolnshire,The Lincoln St Peter-in-Eastgate Church of England (Controlled) Infants School,87,3,1,4
Lincolnshire,"The St Faith and St Martin Church of England Junior School, Lincoln",339,43,10,53
Lincolnshire,"The St Faith's Church of England Infant and Nursery School, Lincoln",277,28,4,32
Lincolnshire,The Lincoln St Peter at Gowts Church of England Primary School,254,47,13,60
Lincolnshire,Binbrook CofE Primary School,92,11,4,15
Lincolnshire,The St Peter and St Paul C of E Primary School,205,28,14,42
Lincolnshire,Corringham CofE VC Primary School,106,22,1,23
Lincolnshire,Dunholme St Chad's Church of England Primary School,210,28,4,32
Lincolnshire,Fiskerton Church of England Primary School,89,14,3,17
Lincolnshire,Grasby All Saints Church of England Primary School,69,7,3,10
Lincolnshire,The Hackthorn Church of England Primary School,57,2,2,4
Lincolnshire,Halton Holegate CofE Primary School,65,17,3,20
Lincolnshire,"St Michael's Church of England School, Louth",313,41,8,49
Lincolnshire,The Mareham-le-Fen Church of England Primary School,91,19,4,23
Lincolnshire,The Market Rasen Church of England Primary School,316,45,9,54
Lincolnshire,Newton-on-Trent CofE Primary School,70,6,4,10
Lincolnshire,The North Cotes Church of England Primary School,32,6,0,6
Lincolnshire,North Cockerington Church of England Primary School,87,8,4,12
Lincolnshire,Reepham Church of England Primary School,197,23,5,28
Lincolnshire,Saxilby Church of England Primary School,381,28,17,45
Lincolnshire,Scamblesby Church of  England Primary School,60,9,4,13
Lincolnshire,Scampton Church of England Primary School,54,6,6,12
Lincolnshire,"St Helena's Church of England Primary School, Willoughby",127,30,5,35
Lincolnshire,"The St Margaret's Church of England School, Withern",76,6,0,6
Lincolnshire,Bardney Church of England and Methodist Primary School,194,26,6,32
Lincolnshire,Caistor CofE and Methodist Primary School,222,35,7,42
Lincolnshire,Brant Broughton Church of England and Methodist Primary School,98,15,3,18
Lincolnshire,The Holbeach William Stukeley Church of England Voluntary Aided Primary School,304,42,11,53
Lincolnshire,East Wold Church of England Primary School,108,16,2,18
Lincolnshire,"The St Sebastian's Church of England Primary School, Great Gonerby",164,20,8,28
Lincolnshire,Great Ponton Church of England School,60,6,1,7
Lincolnshire,The Marston Thorold's Charity Church of England School,76,13,4,17
Lincolnshire,"The St Gilbert of Sempringham Church of England Primary School, Pointon",87,11,3,14
Lincolnshire,St George's Church of England Aided Primary School,186,32,6,38
Lincolnshire,The Cowbit St Mary's (Endowed) CofE Primary,73,6,6,12
Lincolnshire,The Spalding St John the Baptist Church of England Primary School,435,57,16,73
Lincolnshire,The Tydd St Mary Church of England Primary School,100,20,5,25
Lincolnshire,Blyton Cum Laughton Church of England School,132,25,4,29
Lincolnshire,The Kirkby-on-Bain Church of England Primary School,122,24,0,24
Lincolnshire,Frances Olive Anderson Church of England (Aided) Primary School,168,21,4,25
Lincolnshire,The Nettleham Church of England Voluntary Aided Junior School,223,21,7,28
Lincolnshire,Partney Church of England Aided Primary School,69,40,4,44
Lincolnshire,The Sibsey Free Primary School,172,33,2,35
Lincolnshire,Stickney Church of England Primary School,132,45,5,50
Lincolnshire,The Lincoln Bishop King Church of England Primary School,445,68,17,85
Lincolnshire,Spalding High School,965,119,2,121
Lincolnshire,"The Queen Elizabeth's High School, Gainsborough",1220,26,4,30
Lincolnshire,Cranwell Primary School (Foundation),303,50,12,62
Lincolnshire,The Butterwick Pinchbeck's Endowed CofE Primary School,272,31,10,41
Lincolnshire,Grimoldby Primary School,217,28,4,32
Lincolnshire,Wrangle Primary School,66,18,5,23
Lincolnshire,The Lancaster School,121,20,7,27
Lincolnshire,Barkston and Syston CofE Primary School,92,10,1,11
Lincolnshire,North Somercotes CofE Primary School,189,37,2,39
Lincolnshire,William Hildyard Church of England Primary and Nursery School,230,28,10,38
Lincolnshire,Lincoln Minster School,473,114,5,119
Lincolnshire,Witham Hall School,247,35,1,36
Lincolnshire,Dudley House School,22,1,0,1
Lincolnshire,Kirkstone House School,104,18,61,79
Lincolnshire,Ayscoughfee Hall School,115,5,0,5
Lincolnshire,St Hugh's School,168,0,3,3
Lincolnshire,Handel House Preparatory School,54,6,0,6
Lincolnshire,Stamford Endowed Schools,1251,362,4,366
Lincolnshire,Grantham Preparatory International School,114,12,3,15
Lincolnshire,The Viking School,39,6,0,6
Lincolnshire,Kisimul School,56,1,55,56
Lincolnshire,Copthill Independent Day School & Nursery,289,37,1,38
Lincolnshire,Greenwich House School,96,9,4,13
Lincolnshire,The Pilgrim School,9,1,8,9
Lincolnshire,The Lincoln St Christopher's School,227,0,227,227
Lincolnshire,"The St Francis Special School, Lincoln",164,0,164,164
Norfolk,Emneth Nursery School,75,0,0,0
Norfolk,King's Lynn Nursery School,79,0,0,0
Norfolk,Earlham Nursery School,85,0,0,0
Norfolk,Aldborough Primary School,124,10,0,10
Norfolk,Rosecroft Primary School,551,78,9,87
Norfolk,Bacton Primary School,78,9,1,10
Norfolk,Barford Primary School,93,17,3,20
Norfolk,The Bawburgh School,104,14,3,17
Norfolk,Blofield Primary School,214,18,2,20
Norfolk,Bressingham Primary School,139,13,1,14
Norfolk,Buxton Primary School,203,40,4,44
Norfolk,Caister Junior School,335,62,19,81
Norfolk,Caister Infant With Nursery School,233,50,6,56
Norfolk,Cantley Primary School,63,17,0,17
Norfolk,Colby Primary School,141,26,2,28
Norfolk,Freethorpe Community Primary and Nursery School,165,22,2,24
Norfolk,Frettenham Primary School,70,11,2,13
Norfolk,Great Ellingham Primary School,181,20,4,24
Norfolk,Hempnall Primary School,144,35,1,36
Norfolk,Hemsby Primary School,149,27,3,30
Norfolk,Hevingham Primary School,94,6,0,6
Norfolk,Hingham Primary School,151,25,7,32
Norfolk,Holt Community Primary School,188,22,4,26
Norfolk,Horning Community Primary School,33,7,0,7
Norfolk,Langham Village School,90,16,3,19
Norfolk,Little Melton Primary School,116,6,1,7
Norfolk,Ludham Primary School and Nursery,102,13,1,14
Norfolk,Marsham Primary School,21,8,3,11
Norfolk,Mundesley Infant School,74,7,0,7
Norfolk,Northrepps Primary School,40,1,4,5
Norfolk,Millfield Primary School,285,40,19,59
Norfolk,Ormesby Village Infant School,105,8,4,12
Norfolk,Poringland Primary School,465,31,2,33
Norfolk,Rackheath Primary School,203,36,3,39
Norfolk,Reedham Primary School,85,26,0,26
Norfolk,Rocklands Community Primary School,69,13,1,14
Norfolk,Roydon Primary School,259,34,5,39
Norfolk,Sheringham Community Primary School,449,102,14,116
Norfolk,Sprowston Junior School,201,17,17,34
Norfolk,Sprowston Infant School,150,27,18,45
Norfolk,Swanton Abbott Community Primary School,78,6,4,10
Norfolk,St William's Primary School,414,57,1,58
Norfolk,Trowse Primary School,167,20,2,22
Norfolk,Tunstead Primary School,86,10,9,19
Norfolk,Woodton Primary School,57,12,0,12
Norfolk,Browick Road Primary and Nursery School,261,22,0,22
Norfolk,Terrington St John Primary School,71,10,5,15
Norfolk,Tilney St Lawrence Community Primary School,92,5,3,8
Norfolk,Walpole Highway Primary School,48,10,2,12
Norfolk,Watlington Community Primary School,169,18,5,23
Norfolk,West Walton Community Primary School,209,25,11,36
Norfolk,Spixworth Infant School,115,10,2,12
Norfolk,West Winch Primary School,215,22,7,29
Norfolk,South Wootton Infant School,176,17,1,18
Norfolk,Cecil Gowing Infant School,163,26,3,29
Norfolk,Redcastle Family School,253,48,12,60
Norfolk,Fairstead Community Primary and Nursery School,418,42,13,55
Norfolk,"Suffield Park Infant and Nursery School, Cromer",168,48,4,52
Norfolk,Brundall Primary School,300,38,0,38
Norfolk,Stoke Holy Cross Primary School,203,22,6,28
Norfolk,Bure Valley School,246,35,3,38
Norfolk,Woodland View Junior School,140,23,0,23
Norfolk,Falcon Junior School,432,71,16,87
Norfolk,White Woman Lane Junior School,350,53,9,62
Norfolk,Ormesby Village Junior School,134,25,2,27
Norfolk,"Hethersett, Woodside Primary & Nursery School",492,53,11,64
Norfolk,St John's Community Primary School and Nursery,236,31,6,37
Norfolk,"Ashleigh Primary School and Nursery, Wymondham",487,61,16,77
Norfolk,Attleborough Primary School,374,50,8,58
Norfolk,Avenue Junior School,474,76,6,82
Norfolk,Magdalen Gates Primary School and Nursery,201,27,6,33
Norfolk,Colman Junior School,235,38,8,46
Norfolk,Colman Infant School,168,19,9,28
Norfolk,West Earlham Infant and Nursery School,261,70,5,75
Norfolk,West Earlham Junior School,234,42,14,56
Norfolk,"St George's Primary & Nursery School, Great Yarmouth",204,44,5,49
Norfolk,North Denes Primary School and Nursery,414,71,3,74
Norfolk,Hillside Primary School,213,26,15,41
Norfolk,Kinsale Infant School,131,14,2,16
Norfolk,"Dereham, Toftwood Community Junior School",345,49,5,54
Norfolk,John of Gaunt Infant and Nursery School,201,27,0,27
Norfolk,Mulbarton Primary School,438,38,8,46
Norfolk,Drake Primary School,421,40,21,61
Norfolk,Sparhawk Infant School & Nursery,206,25,3,28
Norfolk,Mundesley Junior School,109,19,5,24
Norfolk,"St Mary's Community Primary School, Beetley",181,32,3,35
Norfolk,"Downham Market, Hillcrest Primary School",465,44,5,49
Norfolk,Coltishall Primary School,198,10,2,12
Norfolk,Chapel Break Infant School,178,38,7,45
Norfolk,East Harling Primary School and Nursery,228,28,4,32
Norfolk,Terrington St Clement Community School,351,41,8,49
Norfolk,Acle St Edmund Voluntary Controlled Primary School,178,27,7,34
Norfolk,Ashill Voluntary Controlled Primary School,108,26,2,28
Norfolk,St Michael's Church of England VA Primary and Nursery School,162,22,5,27
Norfolk,Ellingham VC Primary School,105,17,2,19
Norfolk,Erpingham Voluntary Controlled Church of England Primary School,59,9,1,10
Norfolk,"Edmund de Moundeford VC Primary School, Feltwell",173,19,5,24
Norfolk,Happisburgh Primary and Early Years School,70,13,0,13
Norfolk,Hapton Church of England Voluntary Aided Primary School,31,11,1,12
Norfolk,Hainford VC Primary School,72,9,5,14
Norfolk,Hethersett VC Primary School,269,28,0,28
Norfolk,Hickling CofE VC Infant School,29,2,1,3
Norfolk,North Elmham CEVA Primary School part of Flourish Federation,56,11,2,13
Norfolk,Old Catton CofE VC Junior School,206,20,3,23
Norfolk,Pulham Church of England Primary School,128,49,1,50
Norfolk,Salhouse CofE Primary School,138,23,4,27
Norfolk,Saxlingham Nethergate CofE VC Primary School,66,12,4,16
Norfolk,Sutton CofE VC Infant School,52,8,0,8
Norfolk,Heartwood CofE VC Primary  & Nursery School,209,42,7,49
Norfolk,Preston Church of England Voluntary Controlled Primary School,127,16,3,19
Norfolk,Taverham VC CE Junior School,434,52,14,66
Norfolk,Thurton Primary School,106,18,1,19
Norfolk,Worstead Church of England Primary School,112,14,2,16
Norfolk,Scarning Voluntary Controlled Primary School,414,35,12,47
Norfolk,Denver Voluntary Controlled Primary School,101,16,0,16
Norfolk,Fleggburgh CofE Primary School,57,16,0,16
Norfolk,St Faiths CofE Primary School,93,16,2,18
Norfolk,Swanton Morley VC Primary School,183,26,2,28
Norfolk,Hindringham Church of England Voluntary Controlled Primary School,19,4,0,4
Norfolk,Great Massingham CofE Primary School,66,17,1,18
Norfolk,Neatishead Church of England Primary School,64,13,1,14
Norfolk,Harpley CofE VC Primary School,52,9,3,12
Norfolk,St Nicholas Priory CofE VA Primary School,426,80,15,95
Norfolk,Wreningham VC Primary School,112,16,2,18
Norfolk,Brooke Voluntary Controlled Church of England Primary School,141,20,3,23
Norfolk,Homefield VC CofE Primary School,241,31,3,34
Norfolk,Catfield Voluntary Controlled CofE Primary School,79,16,0,16
Norfolk,Blakeney Church of England Voluntary Aided Primary School,28,5,1,6
Norfolk,Carleton Rode Church of England Voluntary Aided Primary School,59,18,2,20
Norfolk,Cringleford CE VA Primary School,442,38,7,45
Norfolk,Earsham CE VA Primary School,91,14,1,15
Norfolk,Forncett St Peter Church of England Voluntary Aided Primary School,95,21,2,23
Norfolk,Little Plumstead Church of England Primary School,192,23,4,27
Norfolk,"Overstrand, the Belfry, Church of England Voluntary Aided Primary School",145,7,3,10
Norfolk,St. Mary's (Endowed) CofE VA Primary School,89,15,3,18
Norfolk,"All Saints Church of England Voluntary Aided Primary School, Winfarthing",40,13,2,15
Norfolk,Yaxham Church of England Voluntary Aided Primary School,68,22,2,24
Norfolk,Ingoldisthorpe Church of England Voluntary Aided Primary School,151,10,2,12
Norfolk,Ashwicken Church of England Voluntary Aided Primary School,112,19,1,20
Norfolk,All Saints Church of England CEVA Primary School Part of Flourish Federation,167,23,5,28
Norfolk,St Michael's VA Junior School,399,102,13,115
Norfolk,Alpington and Bergh Apton Church of England Voluntary Aided Primary School,147,15,5,20
Norfolk,"St Andrew's CofE VA Primary School, Lopham",48,15,1,16
Norfolk,Fairhaven Church of England Voluntary Aided Primary School,103,15,3,18
Norfolk,Aylsham High School,1145,221,43,264
Norfolk,Hunstanton Primary School,157,27,8,35
Norfolk,Loddon Junior School,206,31,1,32
Norfolk,Dereham Church of England Infant & Nursery School,172,22,4,26
Norfolk,Robert Kett Primary School,607,65,10,75
Norfolk,South Wootton Junior School,236,22,5,27
Norfolk,Barnham Broom Church of England Voluntary Aided Primary School,123,15,3,18
Norfolk,Rollesby Primary School,125,20,10,30
Norfolk,Loddon Infant and Nursery School,168,19,0,19
Norfolk,Wicklewood Primary School and Nursery,214,32,4,36
Norfolk,Toftwood Infant School,225,19,2,21
Norfolk,Riddlesworth Hall School,34,2,0,2
Norfolk,Gresham's School,927,312,7,319
Norfolk,Glebe House School,182,17,4,21
Norfolk,Langley School,414,5,11,16
Norfolk,Langley Preparatory School At Taverham Hall,334,52,7,59
Norfolk,Aurora Eccles School,176,0,176,176
Norfolk,Beeston Hall School,175,36,5,41
Norfolk,Town Close Co-Educational Preparatory School,467,57,0,57
Norfolk,Notre Dame Preparatory School (Norwich) Limited,169,27,0,27
Norfolk,Norwich High School for Girls,561,113,3,116
Norfolk,Norwich School,1200,104,2,106
Norfolk,Thetford Grammar School,208,38,6,44
Norfolk,Sheridan House School,66,0,66,66
Norfolk,All Saints School,72,1,71,72
Norfolk,Downham Preparatory School and Montessori Nursery,106,16,7,23
Norfolk,St Andrew's School,45,0,45,45
Norfolk,Sidestrand Hall School,194,0,194,194
Norfolk,Fred Nicholson School,173,0,173,173
Norfolk,Hall School,92,0,92,92
Norfolk,Sheringham Woodfields School,144,0,144,144
Norfolk,Chapel Green School,161,0,161,161
Norfolk,The Clare School,121,0,121,121
Norfolk,"The Parkside School, Norwich",179,0,179,179
Norfolk,"Harford Manor School, Norwich",99,0,99,99
Norfolk,"John Grant School, Caister-on-Sea",176,0,176,176
York,St Paul's Nursery School,73,18,5,23
North Yorkshire,Childhaven Community Nursery School,93,1,0,1
North Yorkshire,Brougham Street Nursery School,53,13,1,14
North Yorkshire,Otley Street Community Nursery School,67,0,0,0
York,Danesgate Community,134,44,87,131
York,Carr Infant School,219,20,3,23
York,Dringhouses Primary School,308,44,5,49
York,Fishergate Primary School,308,16,8,24
York,Poppleton Road Primary School,396,44,10,54
York,Clifton Green Primary School,413,79,14,93
North Yorkshire,Leeming and Londonderry Community Primary School,36,3,0,3
North Yorkshire,Goathland Primary School,14,0,0,0
York,Ralph Butterfield Primary School,313,28,7,35
North Yorkshire,"Staithes, Seton Community Primary School",78,5,3,8
North Yorkshire,Hunton and Arrathorne Community Primary School,69,9,2,11
North Yorkshire,Nawton Community Primary School,97,13,1,14
North Yorkshire,Applegarth Primary School,280,36,3,39
North Yorkshire,North and South Cowton Community Primary School,17,2,0,2
North Yorkshire,Osmotherley Primary School,45,7,0,7
North Yorkshire,Reeth Community Primary School,61,7,0,7
North Yorkshire,Romanby Primary School,276,29,1,30
North Yorkshire,Rosedale Abbey Community Primary School,24,3,0,3
North Yorkshire,Barrowcliff School,289,30,14,44
North Yorkshire,Gladstone Road Primary School,719,98,10,108
North Yorkshire,"Scarborough, Northstead Community Primary School",623,91,13,104
North Yorkshire,Slingsby Community Primary School,89,6,1,7
North Yorkshire,Snape Community Primary School,29,5,0,5
North Yorkshire,Stillington Primary School,32,8,1,9
North Yorkshire,Welburn Community Primary School,59,17,1,18
North Yorkshire,Mill Hill Community Primary School,185,66,6,72
North Yorkshire,Easingwold Community Primary School,278,30,6,36
North Yorkshire,Dishforth Airfield Community Primary School,103,24,5,29
North Yorkshire,Leeming RAF Community Primary School,168,29,6,35
North Yorkshire,Colburn Community Primary School,244,40,2,42
North Yorkshire,"Scarborough, Overdale Community Primary School",257,42,5,47
North Yorkshire,Linton-on-Ouse Primary School,63,12,1,13
North Yorkshire,"Catterick Garrison, Le Cateau Community Primary School",467,87,15,102
North Yorkshire,Sheriff Hutton Primary School,106,14,2,16
North Yorkshire,Wavell Community Junior School,170,32,6,38
North Yorkshire,"Catterick Garrison, Wavell Community Infant School",135,10,8,18
North Yorkshire,Wheatcroft Community Primary School,208,40,5,45
North Yorkshire,Pickering Community Junior School,214,31,3,34
North Yorkshire,Seamer and Irton Community Primary School,406,42,15,57
North Yorkshire,Cayton Community Primary School,201,28,3,31
North Yorkshire,Broomfield School,205,30,3,33
York,Stockton-on-the-Forest Primary School,92,11,3,14
North Yorkshire,Hutton Rudby Primary School,215,23,5,28
North Yorkshire,Lindhead School,223,25,2,27
North Yorkshire,Pickering Community Infant School,183,17,2,19
North Yorkshire,Thirsk Community Primary School,150,33,9,42
York,Wigginton Primary School,247,21,3,24
York,Headlands Primary School,286,19,4,23
North Yorkshire,Alverton Primary School,246,37,13,50
North Yorkshire,Amotherby Community Primary School,189,22,3,25
North Yorkshire,Appleton Wiske Community Primary School,76,7,1,8
North Yorkshire,Brompton Community Primary School,223,31,5,36
North Yorkshire,Brompton and Sawdon Community Primary School,67,12,1,13
North Yorkshire,East Ayton Community Primary School,174,21,2,23
North Yorkshire,Bentham Community Primary School,160,20,3,23
North Yorkshire,Boroughbridge Primary School,215,19,4,23
North Yorkshire,Bradleys Both Community Primary School,124,12,0,12
North Yorkshire,Burton Salmon Community Primary School,66,22,2,24
North Yorkshire,Cononley Community Primary School,150,24,1,25
North Yorkshire,Cowling Community Primary School,139,12,1,13
North Yorkshire,Fairburn Community Primary School,88,1,0,1
North Yorkshire,Kettlesing Felliscliffe Community Primary School,62,9,2,11
North Yorkshire,Giggleswick Primary School,73,8,1,9
North Yorkshire,Great Ouseburn Community Primary School,105,15,2,17
North Yorkshire,"Harrogate, Grove Road Community Primary School",303,90,24,114
North Yorkshire,Summerbridge Community Primary School,68,6,3,9
North Yorkshire,Hellifield Community Primary School,64,10,0,10
North Yorkshire,Hensall Community Primary School,141,12,3,15
North Yorkshire,Glasshouses Community Primary School,50,13,1,14
North Yorkshire,Kettlewell Primary School,26,1,1,2
North Yorkshire,Darley Community Primary School,65,10,0,10
North Yorkshire,Beckwithshaw Community Primary School,66,13,2,15
North Yorkshire,Scotton Lingerfield Primary School,89,12,3,15
North Yorkshire,Sicklinghall Community Primary School,51,10,2,12
North Yorkshire,"Skipton, Water Street Community Primary School",220,20,4,24
North Yorkshire,Staveley Community Primary School,62,11,1,12
North Yorkshire,Sutton-in-Craven Community Primary School,207,20,5,25
North Yorkshire,Thornton in Craven Community Primary School,95,7,1,8
North Yorkshire,Whitley and Eggborough Community Primary School,224,22,3,25
North Yorkshire,Moorside Primary School & Nursery,168,14,6,20
North Yorkshire,Thorpe Willoughby Community Primary School,259,36,15,51
North Yorkshire,"Barwic Parade Community Primary School, Selby",215,25,2,27
North Yorkshire,Ingleton Primary School,186,18,3,21
North Yorkshire,Glusburn Community Primary School,405,47,5,52
North Yorkshire,Barlby Bridge Community Primary School,174,28,5,33
North Yorkshire,Barlby Community Primary School,372,53,8,61
North Yorkshire,Hemingbrough Community Primary School,122,14,3,17
North Yorkshire,Hunmanby Primary School,242,27,7,34
North Yorkshire,Langton Primary School,110,10,1,11
North Yorkshire,Leavening Community Primary School,44,10,3,13
North Yorkshire,Luttons Community Primary School,46,15,1,16
North Yorkshire,North Duffield Community Primary School,115,7,5,12
North Yorkshire,Norton Community Primary School,606,71,11,82
North Yorkshire,Riccall Community Primary School,250,8,8,16
North Yorkshire,Filey Junior School,261,25,10,35
North Yorkshire,"Selby, Longman's Hill Community Primary School",201,16,4,20
North Yorkshire,"Sherburn in Elmet, Athelstan Community Primary School",518,76,5,81
North Yorkshire,Saltergate Community Junior School,203,51,1,52
North Yorkshire,Saltergate Infant School,183,34,3,37
North Yorkshire,"Aiskew, Leeming Bar Church of England Primary School",44,13,1,14
York,Saint Barnabas Church of England Voluntary Controlled Primary School,86,19,2,21
York,St Paul's Church of England Voluntary Controlled Primary School,187,19,7,26
North Yorkshire,St Hilda's Ampleforth Church of England Voluntary Controlled Primary School,28,5,0,5
North Yorkshire,Bainbridge Church of England Primary and Nursery School,65,2,0,2
North Yorkshire,Bedale Church of England Primary School,334,29,7,36
North Yorkshire,Bilsdale Midcable Chop Gate Church of England Voluntary Controlled Primary School,11,3,1,4
North Yorkshire,Brompton-on-Swale Church of England Primary School,199,26,2,28
North Yorkshire,West Burton Church of England Primary School,18,3,0,3
North Yorkshire,Crakehall Church of England Primary School,107,10,6,16
North Yorkshire,Crayke Church of England Voluntary Controlled Primary School,94,13,2,15
North Yorkshire,Danby Church of England Voluntary Aided School,41,2,0,2
North Yorkshire,Dishforth Church of England Voluntary Controlled Primary School,113,16,1,17
North Yorkshire,Sleights Church of England Voluntary Controlled Primary School,106,10,0,10
North Yorkshire,Foston Church of England Voluntary Controlled Primary School,67,8,4,12
North Yorkshire,Gillamoor Church of England Voluntary Controlled Primary School,57,16,0,16
North Yorkshire,"Marwood Church of England Voluntary Controlled Infant School, Great Ayton",50,10,0,10
North Yorkshire,Hackforth and Hornby Church of England Primary School,14,6,1,7
North Yorkshire,Hackness Church of England Voluntary Controlled Primary School,66,14,1,15
North Yorkshire,Hawsker Cum Stainsacre Church of England Voluntary Controlled Primary School,42,15,1,16
North Yorkshire,Hipswell Church of England Primary School,177,18,6,24
North Yorkshire,Hovingham Church of England Voluntary Controlled Primary School,0,0,0,0
North Yorkshire,Huby CofE Primary School,103,12,2,14
North Yorkshire,Husthwaite Church of England Voluntary Controlled Primary School,68,11,0,11
North Yorkshire,Ingleby Greenhow Church of England Voluntary Controlled Primary School,36,15,3,18
North Yorkshire,Kirby Hill Church of England (VC) Primary School,102,17,1,18
North Yorkshire,Lythe Church of England Voluntary Controlled Primary School,77,5,1,6
North Yorkshire,Pickhill Church of England Primary School,49,9,0,9
North Yorkshire,Sand Hutton Church of England Voluntary Controlled Primary School,60,13,4,17
North Yorkshire,Sessay Church of England Voluntary Controlled Primary School,87,12,3,15
North Yorkshire,Snainton Church of England Voluntary Controlled Primary School,55,5,3,8
North Yorkshire,South Kilvington Church of England Voluntary Controlled Primary School,89,13,3,16
North Yorkshire,Spennithorne Church of England Primary School,32,3,0,3
North Yorkshire,Sutton on the Forest Church of England Voluntary Controlled Primary School,93,12,1,13
North Yorkshire,Thornton Watlass Church of England Primary School,23,6,1,7
North Yorkshire,Warthill Church of England Voluntary Controlled Primary School,38,10,0,10
North Yorkshire,"St Nicholas Church of England Primary School, West Tanfield",44,5,3,8
North Yorkshire,Ruswarp Church of England Voluntary Controlled Primary School,74,10,0,10
North Yorkshire,Wykeham Church of England Voluntary Controlled Primary School,61,10,2,12
North Yorkshire,Fylingdales Church of England Voluntary Controlled Primary School,74,10,1,11
North Yorkshire,Cliffe Voluntary Controlled Primary School,90,15,0,15
York,Elvington Church of England Voluntary Controlled Primary School,118,12,1,13
North Yorkshire,"Hertford Vale Church of England Voluntary Controlled Primary School, Staxton",127,12,0,12
York,St Oswald's Church of England Voluntary Controlled Primary School,313,31,12,43
York,Lord Deramore's Primary School,216,23,3,26
York,Naburn Church of England Primary School,49,6,1,7
North Yorkshire,Settrington All Saints' Church of England Voluntary Controlled Primary School,85,9,2,11
North Yorkshire,Sherburn Church of England Voluntary Controlled Primary School,37,6,4,10
North Yorkshire,West Heslerton Church of England Voluntary Controlled Primary School,81,20,0,20
North Yorkshire,Gunnerside Methodist Primary School,26,1,0,1
North Yorkshire,Melsonby Methodist Primary School,32,8,0,8
North Yorkshire,Richmond Methodist Primary School,293,23,6,29
York,St Mary's Church of England Voluntary Controlled Primary School,101,16,3,19
North Yorkshire,Barlow Church of England Voluntary Controlled Primary School,78,10,1,11
North Yorkshire,"St Cuthbert's Church of England Primary School, Pateley Bridge",50,5,0,5
North Yorkshire,Birstwith Church of England Primary School,70,8,1,9
North Yorkshire,Bishop Monkton Church of England Primary School,102,11,5,16
North Yorkshire,Admiral Long Church of England Primary School,42,8,0,8
North Yorkshire,Burton Leonard Church of England Primary School,91,15,0,15
North Yorkshire,Chapel Haddlesey Church of England Voluntary Controlled Primary School,85,8,3,11
North Yorkshire,Cracoe and Rylstone Voluntary Controlled Church of England Primary School,34,1,0,1
North Yorkshire,Embsay Church of England Voluntary Controlled Primary School,207,24,5,29
North Yorkshire,Follifoot Church of England Primary School,55,7,3,10
North Yorkshire,"Fountains Earth, Lofthouse Church of England Endowed Primary School",15,5,1,6
North Yorkshire,Goldsborough Church of England Primary School,71,15,3,18
North Yorkshire,Grassington Church of England Voluntary Controlled Primary School,54,8,0,8
North Yorkshire,Green Hammerton Church of England Primary School,110,13,5,18
North Yorkshire,Hambleton Church of England Voluntary Controlled Primary School,180,25,4,29
North Yorkshire,Killinghall Church of England Primary School,181,13,2,15
North Yorkshire,Kirkby Malzeard Church of England Primary School,90,11,4,15
North Yorkshire,Kirk Hammerton Church of England Primary School,69,10,0,10
North Yorkshire,Kirk Smeaton Church of England Voluntary Controlled Primary School,117,13,2,15
North Yorkshire,Long Marston Church of England Voluntary Controlled Primary School,38,5,0,5
North Yorkshire,Markington Church of England Primary & Nursery School,33,5,0,5
North Yorkshire,North Stainley Church of England Primary School,43,11,1,12
North Yorkshire,Ripley Endowed Church of England School,34,11,0,11
North Yorkshire,Ripon Cathedral Church of England Primary School,205,21,2,23
North Yorkshire,Selby Abbey Church of England Voluntary Controlled Primary School,347,70,4,74
North Yorkshire,Settle Church of England Voluntary Controlled Primary School,221,29,2,31
North Yorkshire,Sharow Church of England Primary School,100,8,4,12
North Yorkshire,Skelton Newby Hall Church of England Primary School,5,3,0,3
North Yorkshire,Christ Church Church of England Voluntary Controlled Primary School,145,14,2,16
North Yorkshire,Spofforth Church of England Controlled Primary School,111,12,5,17
North Yorkshire,Sutton in Craven Church of England Voluntary Controlled Primary School,107,20,1,21
North Yorkshire,Threshfield School,102,12,1,13
North Yorkshire,Wistow Parochial Church of England Voluntary Controlled Primary School,125,23,2,25
North Yorkshire,Gargrave Church of England Voluntary Controlled Primary School,94,10,5,15
North Yorkshire,Kildwick Church of England Voluntary Controlled Primary School,143,17,3,20
North Yorkshire,Askrigg Voluntary Controlled Primary School,37,3,0,3
North Yorkshire,Bolton-On-Swale St Mary's CofE Primary School,110,8,0,8
North Yorkshire,St Peter's Brafferton Church of England Voluntary Aided Primary School,75,15,0,15
North Yorkshire,Carlton and Faceby Church of England Voluntary Aided Primary School,51,11,1,12
North Yorkshire,Michael Syddall Church of England Aided Primary School,200,34,7,41
North Yorkshire,Egton Church of England Voluntary Aided Primary School,45,4,1,5
North Yorkshire,Kirkby and Great Broughton Church of England Voluntary Aided Primary School,129,8,4,12
North Yorkshire,Masham CofE VA Primary School,108,15,1,16
North Yorkshire,Middleham Church of England Aided School,50,4,0,4
North Yorkshire,"St Martin's Church of England Voluntary Aided Primary School, Scarborough",276,42,9,51
North Yorkshire,Terrington Church of England Voluntary Aided Primary School,34,5,0,5
North Yorkshire,Burneston Church of England Voluntary Aided Primary School,102,8,0,8
North Yorkshire,Austwick Church of England VA Primary School,62,5,1,6
North Yorkshire,The Boyle and Petyt Primary School,83,14,0,14
North Yorkshire,Burnsall Voluntary Aided Primary School,50,6,1,7
North Yorkshire,Cawood Church of England Voluntary Aided Primary School,153,14,2,16
North Yorkshire,Kirkby in Malhamdale United Voluntary Aided Primary School,55,5,1,6
North Yorkshire,Long Preston Endowed Voluntary Aided Primary School,50,8,4,12
North Yorkshire,Barkston Ash Catholic Primary School,135,19,0,19
North Yorkshire,St Wilfrid's Catholic Primary School,148,20,2,22
North Yorkshire,Risedale School,589,137,21,158
North Yorkshire,Thirsk School & Sixth Form College,986,165,20,185
North Yorkshire,Caedmon College Whitby,780,90,24,114
North Yorkshire,Eskdale School,404,47,8,55
North Yorkshire,Bedale High School,547,103,14,117
York,Huntington School,1509,155,30,185
North Yorkshire,The Wensleydale School & Sixth Form,345,84,20,104
North Yorkshire,Malton School,1019,57,22,79
North Yorkshire,King James's School,1554,197,39,236
North Yorkshire,Settle College,617,94,15,109
North Yorkshire,Upper Wharfedale School,356,56,18,74
North Yorkshire,Ripon Grammar School,919,63,4,67
North Yorkshire,Boroughbridge High School,437,109,22,131
North Yorkshire,Nidderdale High School,393,97,18,115
North Yorkshire,Selby High School Specialist School for the Arts and Science,1149,162,26,188
York,Joseph Rowntree School,1278,106,42,148
North Yorkshire,Ermysted's Grammar School,838,36,2,38
York,All Saints RC School,1421,148,22,170
North Yorkshire,Nun Monkton Primary Foundation School,41,0,1,1
York,Bootham School,654,83,3,86
York,St Peter's School 2-18,1244,152,0,152
North Yorkshire,Queen Mary's School,235,77,6,83
York,The Mount School (York),197,30,1,31
North Yorkshire,Scarborough College,534,109,2,111
North Yorkshire,Terrington Hall School,185,36,0,36
North Yorkshire,Fyling Hall School,179,35,6,41
North Yorkshire,Ampleforth College,414,184,3,187
North Yorkshire,Aysgarth School,205,65,1,66
North Yorkshire,Giggleswick School,451,47,0,47
North Yorkshire,Harrogate Ladies' College,591,98,5,103
North Yorkshire,Queen Ethelburga's College,844,35,0,35
North Yorkshire,Belmont Grosvenor School,124,25,0,25
North Yorkshire,Read School,253,46,15,61
North Yorkshire,Queen Margaret's School,214,57,0,57
North Yorkshire,Cundall Manor School,348,95,1,96
North Yorkshire,Moorland Waldorf School,4,0,0,0
North Yorkshire,Brackenfield School,146,39,0,39
North Yorkshire,Ashville College,790,102,1,103
York,York Steiner School,167,21,2,23
North Yorkshire,Wharfedale Montessori School,30,0,0,0
North Yorkshire,Brompton Hall School,59,0,59,59
North Yorkshire,Breckenbrough School,66,0,66,66
North Yorkshire,Welburn Hall School,94,0,94,94
North Yorkshire,The Dales School,73,0,73,73
North Yorkshire,Springhead School,96,0,96,96
North Yorkshire,Springwater School,110,0,110,110
North Yorkshire,Brooklands School,87,0,87,87
North Yorkshire,Mowbray School,308,0,308,308
North Northamptonshire,Ronald Tree Nursery School,115,19,3,22
North Northamptonshire,Croyland Nursery School & Day Nursery,110,2,0,2
North Northamptonshire,Highfield Nursery School,86,5,1,6
West Northamptonshire,Gloucester Nursery School,86,2,0,2
West Northamptonshire,Wallace Road Nursery School,43,4,0,4
West Northamptonshire,Whitehills Nursery School,45,6,0,6
West Northamptonshire,Parklands Nursery School,55,0,0,0
Leeds,The New Bewerley Community Primary School,397,96,15,111
Hackney,Springfield Community Primary School,211,33,9,42
West Northamptonshire,Blisworth Community Primary School,169,20,1,21
West Northamptonshire,Brington Primary School,43,4,0,4
North Northamptonshire,Broughton Primary School,204,22,0,22
West Northamptonshire,Bugbrooke Community Primary School,253,26,3,29
West Northamptonshire,The Bramptons Primary School,98,1,2,3
North Northamptonshire,Corby Old Village Primary School,203,19,3,22
West Northamptonshire,Cosgrove Village Primary School,47,18,4,22
West Northamptonshire,Crick Primary School,189,25,2,27
West Northamptonshire,Denton Primary School,110,14,2,16
North Northamptonshire,Great Doddington Primary,138,12,3,15
West Northamptonshire,Greatworth Primary School,56,5,0,5
West Northamptonshire,Harlestone Primary School,51,10,1,11
West Northamptonshire,Helmdon Primary School,110,6,1,7
North Northamptonshire,Higham Ferrers Junior School,336,24,6,30
West Northamptonshire,Long Buckby Junior School,196,32,4,36
West Northamptonshire,Long Buckby Infant School,132,12,0,12
West Northamptonshire,Maidwell Primary School,68,6,0,6
North Northamptonshire,Nassington Primary School,82,5,0,5
West Northamptonshire,Overstone Primary School,172,16,2,18
West Northamptonshire,Pitsford Primary School,58,15,1,16
West Northamptonshire,John Hellins Primary School,207,10,3,13
West Northamptonshire,Roade Primary School,317,50,4,54
North Northamptonshire,"Alfred Street Junior School, Rushden",81,17,3,20
North Northamptonshire,South End Infant School,265,40,5,45
North Northamptonshire,Tennyson Road Infant School,55,4,1,5
West Northamptonshire,Walgrave Primary School,144,22,2,24
North Northamptonshire,Warmington School,82,9,1,10
North Northamptonshire,The Avenue Infant School,177,30,6,36
West Northamptonshire,Yardley Hastings Primary School,109,11,0,11
West Northamptonshire,Yelvertoft Primary School,96,10,2,12
North Northamptonshire,South End Junior School,352,47,5,52
West Northamptonshire,"The Grange School, Daventry",438,77,4,81
North Northamptonshire,Higham Ferrers Nursery and Infant School,258,26,5,31
North Northamptonshire,Meadowside Primary School,397,31,2,33
North Northamptonshire,Earls Barton Primary School,468,29,4,33
North Northamptonshire,Whitefriars Primary School,413,38,5,43
West Northamptonshire,Earl Spencer Primary School,392,55,16,71
West Northamptonshire,Vernon Terrace Primary School,244,34,13,47
West Northamptonshire,Lyncrest Primary School,223,36,5,41
West Northamptonshire,Chiltern Primary School,237,35,6,41
West Northamptonshire,Whitehills Primary School,416,21,3,24
West Northamptonshire,Hopping Hill Primary School,448,59,10,69
West Northamptonshire,Boothville Primary School,659,93,12,105
West Northamptonshire,Barry Primary School,455,28,5,33
North Northamptonshire,Denfield Park Primary School,440,63,17,80
West Northamptonshire,Kingsthorpe Grove Primary School,478,63,38,101
West Northamptonshire,Duston Eldean Primary School,417,32,12,44
North Northamptonshire,Barton Seagrave Primary School,627,48,4,52
West Northamptonshire,Hunsbury Park Primary School,311,61,32,93
West Northamptonshire,Ashton CofE Primary School,31,7,1,8
West Northamptonshire,Brackley Church of England Junior School,199,17,7,24
West Northamptonshire,Brixworth CofE VC Primary School,489,45,10,55
West Northamptonshire,Croughton All Saints CofE Primary School,107,13,2,15
West Northamptonshire,East Haddon Church of England Primary School,80,4,1,5
West Northamptonshire,Flore Church of England Primary School,85,3,2,5
West Northamptonshire,Gayton Church of England Primary School,64,5,1,6
North Northamptonshire,Geddington Church of England Primary School,193,12,3,15
North Northamptonshire,Grendon Church of England Primary School,114,8,1,9
West Northamptonshire,Harpole Primary School,185,26,1,27
West Northamptonshire,Pattishall Church of England Primary School,139,16,5,21
West Northamptonshire,Stoke Bruerne Church of England Primary School,66,9,2,11
West Northamptonshire,Syresham St James CofE Primary School and Nursery,109,14,1,15
North Northamptonshire,Titchmarsh Church of England Primary School,100,23,0,23
North Northamptonshire,All Saints CEVA Primary School and Nursery,228,29,1,30
West Northamptonshire,West Haddon Endowed Church of England Primary School,243,17,1,18
West Northamptonshire,Whittlebury Church of England Primary School,64,11,1,12
West Northamptonshire,Yardley Gobion Church of England Primary School,87,11,2,13
North Northamptonshire,Brigstock Latham's Church of England Primary School,91,10,1,11
North Northamptonshire,Kings Cliffe Endowed Primary School,222,24,4,28
West Northamptonshire,Clipston Endowed Voluntary Controlled Primary School,103,25,0,25
West Northamptonshire,St Andrew's Ceva Primary School,352,30,4,34
West Northamptonshire,Little Houghton Church of England Primary,96,15,0,15
West Northamptonshire,Newbottle and Charlton Church of England Primary School,109,15,2,17
West Northamptonshire,Tiffield Church of England Voluntary Aided Primary School,44,6,0,6
North Northamptonshire,Wilby Church of England Primary School,87,15,0,15
West Northamptonshire,"St Mary's Catholic Primary School, Aston-le-Walls",70,4,1,5
North Northamptonshire,"St Patrick's Catholic Primary School, Corby",238,9,6,15
West Northamptonshire,The Bliss Charity School,185,19,2,21
North Northamptonshire,The Latimer Arts College,1097,51,14,65
West Northamptonshire,Delapre Primary School,604,75,3,78
West Northamptonshire,Bridgewater Primary School,666,55,13,68
West Northamptonshire,Millway Primary School,392,78,9,87
West Northamptonshire,All Saints CofE VA Primary School,393,43,4,47
West Northamptonshire,Moulton Primary School,610,47,8,55
North Northamptonshire,Millbrook Infant School,253,21,6,27
North Northamptonshire,Millbrook Junior School,430,51,7,58
North Northamptonshire,Thrapston Primary School,480,76,10,86
North Northamptonshire,Stanion Church of England (Aided) Primary School,107,5,2,7
West Northamptonshire,Winchester House School,315,72,0,72
North Northamptonshire,St Peter's School,103,15,0,15
West Northamptonshire,Maidwell Hall,130,17,2,19
North Northamptonshire,Oundle School,1134,174,0,174
North Northamptonshire,Wellingborough School,856,64,1,65
West Northamptonshire,Spratton Hall School,398,55,1,56
West Northamptonshire,Cambian Potterspury Lodge School,38,0,38,38
West Northamptonshire,Quinton House School,412,88,1,89
West Northamptonshire,Akeley Wood Junior School,251,43,3,46
West Northamptonshire,Carrdus School,124,21,0,21
North Northamptonshire,Laxton Junior School,257,73,1,74
West Northamptonshire,Northampton High School,504,81,1,82
West Northamptonshire,Bosworth Independent College,217,34,0,34
West Northamptonshire,Overstone Park School,120,0,89,89
West Northamptonshire,Pitsford School,273,59,2,61
West Northamptonshire,Fairfields School,123,0,123,123
West Northamptonshire,The Gateway School,74,0,74,74
West Northamptonshire,Kings Meadow School,40,1,39,40
Northumberland,Acomb First School,66,10,2,12
Northumberland,Allendale Primary School,126,29,4,33
Northumberland,Swansfield Park Primary School,356,55,9,64
Northumberland,Amble Links First School,178,12,1,13
Northumberland,Amble First School,118,13,3,16
Northumberland,Bedlington West End Primary School,255,32,1,33
Northumberland,Bedlington Station Primary School,232,54,6,60
Northumberland,Stakeford Primary School,179,81,8,89
Northumberland,Cambois Primary School,104,16,32,48
Northumberland,Choppington Primary School,120,30,1,31
Northumberland,Stead Lane Primary School,236,57,9,66
Northumberland,Bellingham Primary School,74,11,1,12
Northumberland,Spittal Community School,121,28,6,34
Northumberland,Tweedmouth West First School,114,17,7,24
Northumberland,Tweedmouth Prior Park First School,125,36,1,37
Northumberland,Branton Community Primary School,16,4,0,4
Northumberland,Eastlea Primary School,215,55,6,61
Northumberland,Beaconhill Community Primary School,221,28,5,33
Northumberland,Cramlington Shanklea Primary School,317,35,11,46
Northumberland,Holywell Village First School,166,17,7,24
Northumberland,Broomhill First School,76,8,4,12
Northumberland,Red Row First School,94,15,2,17
Northumberland,Ellington Primary School,215,34,3,37
Northumberland,Linton Primary School,21,8,4,12
Northumberland,Stamfordham Primary School,84,5,1,6
Northumberland,Hexham First School,109,32,0,32
Northumberland,Morpeth First School,332,19,5,24
Northumberland,Seahouses Primary School,79,9,4,13
Northumberland,Otterburn Primary School,54,9,2,11
Northumberland,Pegswood Primary School,158,31,2,33
Northumberland,Rothbury First School,76,7,2,9
Northumberland,Beaufront First School,69,10,1,11
Northumberland,Seaton Delaval First School,186,37,9,46
Northumberland,New Hartley First School,147,11,2,13
Northumberland,Seghill First School,104,29,2,31
Northumberland,Greenhaugh Primary School,23,6,0,6
Northumberland,Slaley First School,48,8,1,9
Northumberland,Stannington First School,123,6,4,10
Northumberland,Cambo First School,46,2,1,3
Northumberland,Kielder Primary School and Nursery,12,1,1,2
Northumberland,Seaton Sluice First School,184,17,12,29
Northumberland,Wooler First School,93,13,1,14
Northumberland,Shilbottle Primary School,86,5,1,6
Northumberland,Bothal Primary School,725,99,11,110
Northumberland,Swarland Primary School,88,15,1,16
Northumberland,The Sele First School,397,32,3,35
Northumberland,Mowbray Primary School,230,32,3,35
Northumberland,Belford Primary School,84,18,3,21
Northumberland,Ringway Primary School,177,20,4,24
Northumberland,Scremerston First School,54,19,1,20
Northumberland,Horton Grange Primary School,511,75,6,81
Northumberland,New Delaval Primary School,259,33,3,36
Northumberland,Newsham Primary School,453,70,10,80
Northumberland,Hipsburn Primary School,104,9,1,10
Northumberland,Burnside Primary School,421,40,2,42
Northumberland,Hareside Primary School,427,59,8,67
Northumberland,Cramlington Northburn Primary School,328,21,8,29
Northumberland,Berwick St Mary's Church of England First School,93,18,5,23
Northumberland,Chollerton Church of England Aided First School,39,4,1,5
Northumberland,Felton Church of England Primary School,108,8,2,10
Northumberland,Henshaw Church of England Voluntary Aided Primary School,81,12,6,18
Northumberland,Longhoughton Church of England Primary School,94,10,0,10
Northumberland,Whittingham Church of England Primary School,98,9,1,10
Northumberland,St Michael's Church of England Primary School,121,26,3,29
Northumberland,Bedlington Whitley Memorial Church of England Primary School,283,55,17,72
Northumberland,Holy Trinity Church of England First School,161,10,2,12
Northumberland,Longhorsley St Helen's Church of England Aided First School,92,11,3,14
Northumberland,Greenhead Church of England Primary School,44,8,2,10
Northumberland,Broomhaugh (VA) Church of England First School,71,9,3,12
Northumberland,Corbridge (VA) Church of England First School,157,12,1,13
Northumberland,Ellingham Church of England Aided Primary School,38,4,0,4
Northumberland,Embleton Vincent Edwards Church of England Primary School,70,13,3,16
Northumberland,"Hugh Joicey Church of England First School, Ford",47,11,1,12
Northumberland,Whitley Chapel Church of England First School,43,6,1,7
Northumberland,Holy Island Church of England First School,3,0,0,0
Northumberland,Humshaugh Church of England First School,48,5,0,5
Northumberland,Morpeth All Saints Church of England Aided First School,226,20,0,20
Northumberland,Newbrough Church of England Primary School,75,10,1,11
Northumberland,Tritlington Church of England First School,32,7,0,7
Northumberland,Wark Church of England Primary School,46,10,1,11
Northumberland,Whalton Church of England Aided Primary School,41,6,1,7
Northumberland,Corbridge Middle School,361,50,12,62
Northumberland,Haydon Bridge High School,423,48,11,59
Northumberland,Seaton Sluice Middle School,307,51,13,64
Northumberland,Whytrig Community Middle School,291,42,19,61
Northumberland,Tweedmouth Community Middle School,359,62,8,70
Northumberland,Bellingham Middle School and Sports College,71,11,6,17
Northumberland,Glendale Middle School,103,25,1,26
Northumberland,Berwick Middle School,334,31,3,34
Northumberland,The Duchess's Community High School,1443,224,44,268
Northumberland,James Calvert Spence College,742,97,16,113
Northumberland,Astley Community High School,563,44,26,70
Northumberland,Longridge Towers School,346,44,4,48
Northumberland,Mowden Hall School,201,28,2,30
Northumberland,Cleaswell Hill School,211,1,210,211
Northumberland,Cramlington Hillcrest School,114,1,113,114
Northumberland,Barndale House School,69,0,69,69
Northumberland,The Grove Special School,49,0,49,49
Northumberland,The Dales School,188,0,188,188
Northumberland,Collingwood School & Media Arts College,269,0,269,269
Nottinghamshire,Annesley Primary and Nursery School,220,19,1,20
Nottingham,Bentinck Primary and Nursery School,227,39,0,39
Nottingham,Cantrell Primary and Nursery School,463,46,2,48
Nottingham,Carrington Primary and Nursery School,229,23,2,25
Nottingham,Dunkirk Primary and Nursery School,353,74,3,77
Nottingham,Melbury Primary School,222,42,0,42
Nottingham,Middleton Primary and Nursery School,633,50,6,56
Nottinghamshire,Nettleworth Infant and Nursery School,259,16,0,16
Nottinghamshire,Leas Park Junior School,276,46,0,46
Nottingham,Heathfield Primary and Nursery School,707,72,3,75
Nottinghamshire,John T Rice Infant and Nursery School,192,28,2,30
Nottinghamshire,Newlands Junior School,228,48,0,48
Nottingham,Walter Halls Primary and Early Years School,437,32,4,36
Nottinghamshire,Croft Primary School,394,98,3,101
Nottingham,Southwold Primary School and Early Years' Centre,225,27,2,29
Nottinghamshire,Priestsic Primary and Nursery School,442,55,5,60
Nottinghamshire,Woodland View Primary School,350,86,5,91
Nottingham,Rise Park Primary and Nursery School,464,33,2,35
Nottingham,Crabtree Farm Primary School,377,89,3,92
Nottingham,Welbeck Primary School,360,39,2,41
Nottingham,Mellers Primary School,453,43,14,57
Nottingham,Haydn Primary School,458,62,2,64
Nottinghamshire,Healdswood Infants' and Nursery School,218,36,0,36
Nottinghamshire,Dalestorth Primary and Nursery School,359,48,1,49
Nottingham,Hempshill Hall Primary School,430,51,2,53
Nottinghamshire,Hetts Lane Infant and Nursery School,199,23,4,27
Nottinghamshire,Eastlands Junior School (Welbeck Federation of Schools),106,11,0,11
Nottinghamshire,Netherfield Infant School (Welbeck Federation of Schools),98,7,0,7
Nottinghamshire,Sherwood Junior School,186,36,2,38
Nottinghamshire,Arno Vale Junior School,238,11,0,11
Nottinghamshire,Woodthorpe Infant School,180,12,1,13
Nottinghamshire,Coppice Farm Primary School,196,14,0,14
Nottinghamshire,Pinewood Infant and Nursery School,193,15,4,19
Nottinghamshire,Mapperley Plains Primary and Nursery School,340,42,1,43
Nottinghamshire,Standhill Infants' School,132,10,1,11
Nottinghamshire,Priory Junior School,237,33,2,35
Nottinghamshire,Phoenix Infant and Nursery School,185,14,1,15
Nottinghamshire,Westdale Infant School,211,14,0,14
Nottinghamshire,Bramcote Hills Primary School,414,19,5,24
Nottinghamshire,Beeston Rylands Junior School,180,26,1,27
Nottinghamshire,Trent Vale Infant School,182,17,0,17
Nottinghamshire,Eskdale Junior School,260,23,0,23
Nottinghamshire,Albany Junior School,190,17,1,18
Nottinghamshire,Albany Infant and Nursery School,168,7,0,7
Nottinghamshire,William Lilley Infant and Nursery School,174,24,2,26
Nottinghamshire,Toton Bispham Drive Junior School,240,28,2,30
Nottinghamshire,Toton Banks Road Infant and Nursery School,177,22,5,27
Nottinghamshire,Hallcroft Infant and Nursery School,103,11,0,11
Nottingham,Glade Hill Primary & Nursery School,440,104,12,116
Nottinghamshire,Brinsley Primary and Nursery School,211,17,2,19
Nottinghamshire,Lawrence View Primary and Nursery School,211,38,6,44
Nottinghamshire,Larkfields Junior School,236,43,2,45
Nottinghamshire,Bagthorpe Primary School,168,7,1,8
Nottinghamshire,Holly Hill Primary and Nursery School,329,41,8,49
Nottinghamshire,Jacksdale Primary and Nursery School,216,22,2,24
Nottinghamshire,Westwood Infant and Nursery School,63,3,0,3
Nottinghamshire,Beardall Fields Primary and Nursery School,457,59,3,62
Nottinghamshire,Broomhill Junior School,273,33,0,33
Nottinghamshire,Butler's Hill Infant and Nursery School,240,38,6,44
Nottinghamshire,Edgewood Primary and Nursery School,334,34,2,36
Nottinghamshire,Leen Mills Primary School,338,13,0,13
Nottinghamshire,Lovers Lane Primary and Nursery School,166,27,0,27
Nottinghamshire,Lady Bay Primary School,418,36,2,38
Nottinghamshire,Jesse Gray Primary School,425,5,4,9
Nottinghamshire,West Bridgford Infant School,239,8,0,8
Nottinghamshire,West Bridgford Junior School,361,21,2,23
Nottinghamshire,Redlands Primary and Nursery School,429,37,1,38
Nottinghamshire,Sir Edmund Hillary Primary and Nursery School,453,50,0,50
Nottinghamshire,Chuter Ede Primary School,609,53,6,59
Nottinghamshire,Beckingham Primary School,80,6,1,7
Nottinghamshire,Carnarvon Primary School,475,28,5,33
Nottinghamshire,Manor Park Infant and Nursery School,191,5,0,5
Nottinghamshire,Ramsden Primary School,233,12,2,14
Nottinghamshire,Clarborough Primary School,206,21,1,22
Nottinghamshire,John Blow Primary School,178,15,0,15
Nottinghamshire,Lantern Lane Primary and Nursery School,437,38,6,44
Nottinghamshire,East Markham Primary School,197,30,0,30
Nottinghamshire,King Edwin Primary and Nursery School,464,65,3,68
Nottinghamshire,Elkesley Primary and Nursery School,92,15,1,16
Nottinghamshire,Everton Primary School,109,10,0,10
Nottinghamshire,Gotham Primary School,161,14,2,16
Nottinghamshire,Queen Eleanor Primary School,63,5,1,6
Nottinghamshire,Willow Brook Primary School,203,2,1,3
Nottinghamshire,Kinoulton Primary School,139,2,0,2
Nottinghamshire,Kirklington Primary School,102,13,0,13
Nottinghamshire,Lambley Primary School,173,14,1,15
Nottinghamshire,Mattersey Primary School,36,1,0,1
Nottinghamshire,Misson Primary School,81,10,1,11
Nottinghamshire,Misterton Primary and Nursery School,175,28,3,31
Nottinghamshire,Newstead Primary and Nursery School,135,27,0,27
Nottinghamshire,Abbey Gates Primary School,232,38,5,43
Nottinghamshire,Normanton-on-Soar Primary School,48,6,0,6
Nottinghamshire,North Clifton Primary School,25,2,0,2
Nottinghamshire,Muskham Primary School,172,20,3,23
Nottinghamshire,Maun Infant and Nursery School,200,37,1,38
Nottinghamshire,Orston Primary School,160,0,2,2
Nottinghamshire,Radcliffe-on-Trent Infant and Nursery School,252,8,2,10
Nottinghamshire,Radcliffe-on-Trent Junior School,334,34,3,37
Nottinghamshire,Rampton Primary School,97,18,0,18
Nottinghamshire,Lake View Primary and Nursery School,204,33,4,37
Nottinghamshire,James Peacock Infant and Nursery School,303,7,2,9
Nottinghamshire,Sutton Bonington Primary School,154,7,1,8
Nottinghamshire,Sutton-On-Trent Primary and Nursery School,126,13,0,13
Nottinghamshire,Walkeringham Primary School,58,11,0,11
Nottinghamshire,Willoughby Primary School,44,4,2,6
Nottingham,Claremont Primary and Nursery School,421,66,3,69
Nottingham,Snape Wood Primary and Nursery School,167,45,2,47
Nottinghamshire,Round Hill Primary School,518,18,3,21
Nottinghamshire,Stanhope Primary and Nursery School,343,29,2,31
Nottinghamshire,Kingsway Primary School,334,44,3,47
Nottinghamshire,Morven Park Primary and Nursery School,466,50,4,54
Nottinghamshire,Arnold Mill Primary and Nursery School,340,40,3,43
Nottinghamshire,Orchard Primary School and Nursery,360,76,0,76
Nottinghamshire,Holly Primary School,322,9,0,9
Nottinghamshire,Prospect Hill Infant and Nursery School,215,17,4,21
Nottinghamshire,Prospect Hill Junior School,221,33,0,33
Nottinghamshire,Church Vale Primary School and Foundation Unit,222,19,1,20
Nottinghamshire,Carr Hill Primary and Nursery School,356,34,0,34
Nottingham,Forest Fields Primary and Nursery School,647,114,10,124
Nottinghamshire,Heatherley Primary School,328,33,2,35
Nottinghamshire,St Edmund's CofE (C) Primary School,249,19,1,20
Nottinghamshire,St Andrew's CofE Primary and Nursery School,361,30,0,30
Nottinghamshire,All Hallows CofE Primary School,209,21,0,21
Nottinghamshire,St John's CofE Primary School,94,12,0,12
Nottinghamshire,Underwood Church of England Primary School,176,10,0,10
Nottinghamshire,Ranby CofE Primary School,99,13,0,13
Nottinghamshire,Bunny CofE Primary School,104,9,0,9
Nottinghamshire,St Wilfrid's CofE Primary School,208,24,3,27
Nottinghamshire,Caunton Dean Hole CofE Primary School,26,7,2,9
Nottinghamshire,Coddington CofE Primary and Nursery School,412,31,2,33
Nottinghamshire,Costock CofE Primary School,82,7,1,8
Nottinghamshire,Cuckney CofE Primary School,127,5,1,6
Nottinghamshire,Dunham-on-Trent CofE Primary School,90,4,1,5
Nottinghamshire,Kneesall CofE Primary School,106,7,0,7
Nottinghamshire,Langar CofE Primary School,101,13,1,14
Nottinghamshire,St Matthew's CofE Primary School,44,2,0,2
Nottinghamshire,Norwell CofE Primary School,55,4,1,5
Nottinghamshire,St Peter's CofE Junior School,361,34,3,37
Nottinghamshire,Lowe's Wong Anglican Methodist Junior School,323,18,2,20
Nottinghamshire,Trowell CofE Primary School,173,9,1,10
Nottinghamshire,Walesby CofE Primary School,114,7,2,9
Nottinghamshire,North Wheatley Church of England Primary School,133,13,0,13
Nottinghamshire,St John's CofE Primary School,201,12,0,12
Nottinghamshire,Bramcote CofE Primary School,194,25,2,27
Nottinghamshire,Christ Church C of E Primary School,144,11,0,11
Nottinghamshire,St Luke's CofE (Aided) Primary School,172,7,0,7
Nottinghamshire,St Anne's CofE (Aided) Primary School,198,20,0,20
Nottinghamshire,The Primary School of St Mary and St Martin,140,6,0,6
Nottinghamshire,All Saints Anglican/Methodist Primary School,96,2,0,2
Nottinghamshire,Gamston CofE (Aided) Primary School,99,8,2,10
Nottinghamshire,St Peter's CofE Primary and Nursery School,109,11,0,11
Nottinghamshire,Lowdham CofE Primary School,202,9,2,11
Nottinghamshire,Linby-cum-Papplewick CofE (VA) Primary School,104,13,0,13
Nottinghamshire,Sturton CofE Primary School,90,1,0,1
Nottinghamshire,Sutton-Cum-Lound CofE School,92,10,1,11
Nottinghamshire,Wood's Foundation CofE Primary School,184,8,1,9
Nottinghamshire,St Patrick's Catholic Primary School,106,14,1,15
Nottinghamshire,Holy Family Catholic Primary School,200,23,1,24
Nottinghamshire,Chilwell School,1053,56,7,63
Nottinghamshire,Highfields School,118,6,0,6
Nottinghamshire,Worksop College,687,84,1,85
Nottingham,Hollygirt School,207,45,9,54
Nottingham,St Joseph's School,108,16,0,16
Nottingham,Nottingham High School,1166,174,0,174
Nottinghamshire,Wellow House School,179,25,7,32
Nottinghamshire,Plumtree School,100,14,0,14
Nottinghamshire,Orchard School,95,8,1,9
Nottingham,Nottingham Girls' High School,707,117,2,119
Nottinghamshire,Salterford House School,93,17,0,17
Nottingham,Iona School,68,11,1,12
Nottinghamshire,Derrymount School,93,0,93,93
Nottinghamshire,Carlton Digby School,91,0,91,91
Nottinghamshire,St Giles School,159,0,159,159
Nottinghamshire,Dawn House School,77,0,77,77
Nottinghamshire,Ash Lea School,100,0,100,100
Nottinghamshire,Bracken Hill School,154,0,154,154
Nottingham,Rosehill School,119,0,119,119
Oxfordshire,Comper Foundation Stage School,54,10,0,10
Oxfordshire,Headington Quarry Foundation Stage School,96,19,0,19
Oxfordshire,Grandpont Nursery School,39,12,0,12
Oxfordshire,Slade Nursery School,98,19,0,19
Oxfordshire,Lydalls Nursery School,68,12,1,13
Oxfordshire,The ACE Centre Nursery School,44,16,0,16
Oxfordshire,Wheatley Nursery School,51,7,2,9
Oxfordshire,Orchard Fields Community School,428,120,3,123
Oxfordshire,Queensway School,430,81,10,91
Oxfordshire,The Grange Community Primary School,306,53,13,66
Oxfordshire,Enstone Primary School,83,16,4,20
Oxfordshire,Great Tew County Primary School,97,9,2,11
Oxfordshire,Kingham Primary School,232,15,3,18
Oxfordshire,Five Acres Primary School,360,82,13,95
Oxfordshire,Brookside Primary School,314,46,10,56
Oxfordshire,Longfields Primary and Nursery School,396,36,11,47
Oxfordshire,Whitchurch Primary School,140,11,1,12
Oxfordshire,King's Meadow Primary School,455,48,6,54
Oxfordshire,Carterton Primary School,279,29,9,38
Oxfordshire,Gateway Primary School,239,27,6,33
Oxfordshire,St Nicholas' Primary and Nursery School,432,41,27,68
Oxfordshire,Stonesfield Primary School,96,17,2,19
Oxfordshire,William Fletcher Primary School,266,33,9,42
Oxfordshire,North Kidlington Primary School,306,50,7,57
Oxfordshire,RAF Benson Community Primary School,175,20,5,25
Oxfordshire,Tetsworth Primary School,75,14,1,15
Oxfordshire,Barley Hill Primary School,518,97,15,112
Oxfordshire,Mill Lane Community Primary School,231,37,4,41
Oxfordshire,Nettlebed Community School,147,17,3,20
Oxfordshire,Sonning Common Primary School,373,42,7,49
Oxfordshire,South Stoke Primary School,32,4,1,5
Oxfordshire,Woodcote Primary School,174,24,5,29
Oxfordshire,Valley Road School,178,23,1,24
Oxfordshire,Badgemore Primary School,132,30,8,38
Oxfordshire,East Oxford Primary School,287,43,1,44
Oxfordshire,Windmill Primary School,627,86,10,96
Oxfordshire,West Oxford Community Primary School,229,14,8,22
Oxfordshire,Chilton County Primary School,312,33,5,38
Oxfordshire,Drayton Community Primary School,210,25,4,29
Oxfordshire,Harwell Primary School,206,38,8,46
Oxfordshire,Dry Sandford Primary School,101,16,3,19
Oxfordshire,Stockham Primary School,211,41,7,48
Oxfordshire,Thomas Reade Primary School,216,31,4,35
Oxfordshire,Wood Farm Primary School,402,83,19,102
Oxfordshire,Edward Feild Primary School,280,43,9,52
Oxfordshire,John Hampden Primary School,457,61,11,72
Oxfordshire,Stephen Freeman Community Primary School,451,68,10,78
Oxfordshire,Carswell Community Primary School,218,34,7,41
Oxfordshire,West Witney Primary School & Nursery,439,53,3,56
Oxfordshire,Long Furlong Primary School,227,20,7,27
Oxfordshire,Caldecott Primary School,425,105,14,119
Oxfordshire,Cropredy Church of England Primary School,170,30,2,32
Oxfordshire,Chadlington Church of England Primary School,103,9,5,14
Oxfordshire,Hook Norton Church of England Primary School,294,34,10,44
Oxfordshire,Bloxham Church of England Primary School,396,80,9,89
Oxfordshire,Fritwell Church of England Primary School,141,17,4,21
Oxfordshire,Charlton-on-Otmoor Church of England Primary School,90,7,5,12
Oxfordshire,Chesterton Church of England Voluntary Aided Primary School,182,26,5,31
Oxfordshire,Fringford Church of England Primary School,99,12,4,16
Oxfordshire,Launton Church of England Primary School,161,14,5,19
Oxfordshire,Clanfield CofE Primary School,98,14,1,15
Oxfordshire,Aston and Cote Church of England Primary School,186,17,2,19
Oxfordshire,Ducklington Primary School,211,19,0,19
Oxfordshire,Hailey Church of England Primary School,107,10,0,10
Oxfordshire,St Kenelm's Church of England (VC) School,141,35,2,37
Oxfordshire,Bletchingdon Parochial Church of England Primary School,87,7,4,11
Oxfordshire,Combe CofE Primary School,117,14,1,15
Oxfordshire,Woodstock Church of England Primary School,322,36,3,39
Oxfordshire,Bladon Church of England Primary School,98,9,5,14
Oxfordshire,Aston Rowant Church of England Primary School,78,13,5,18
Oxfordshire,"St Andrew's Church of England Primary School, Chinnor",415,41,18,59
Oxfordshire,Clifton Hampden Church of England Primary School,89,11,1,12
Oxfordshire,Lewknor Church of England Primary School,76,9,1,10
Oxfordshire,Dorchester St Birinus Church of England School,68,13,1,14
Oxfordshire,Great Milton Church of England Primary School,169,25,5,30
Oxfordshire,Marsh Baldon CofE Primary School,72,23,3,26
Oxfordshire,Crowmarsh Gifford Church of England School,235,20,5,25
Oxfordshire,Peppard Church of England Primary School,93,13,1,14
Oxfordshire,Stoke Row CofE Primary School,63,12,4,16
Oxfordshire,Church Cowley St James Church of England Primary School,461,86,5,91
Oxfordshire,"St Andrew's Church of England Primary School, Oxford",242,37,11,48
Oxfordshire,New Hinksey Church of England Primary School,139,16,2,18
Oxfordshire,"St Michael's CofE Primary School, Oxford City",199,17,3,20
Oxfordshire,Cumnor Church of England School (Voluntary Controlled),207,23,4,27
Oxfordshire,The Ridgeway Church of England (C) Primary School,97,15,1,16
Oxfordshire,Long Wittenham (Church of England) Primary School,82,12,1,13
Oxfordshire,Longworth Primary School,76,17,4,21
Oxfordshire,Marcham Church of England (Voluntary Controlled) Primary School,182,22,9,31
Oxfordshire,Radley Church of England Primary School,118,16,2,18
Oxfordshire,Stanford In the Vale CofE Primary School,201,29,2,31
Oxfordshire,"St Michaels CofE Primary School, Steventon Village",210,18,3,21
Oxfordshire,Sunningwell Church of England Primary School,68,5,1,6
Oxfordshire,"St Nicolas Church of England Primary School, Abingdon",419,59,17,76
Oxfordshire,Hagbourne Church of England Primary School,209,24,6,30
Oxfordshire,Uffington Church of England Primary School,106,17,6,23
Oxfordshire,St Francis Church of England Primary School,265,49,6,55
Oxfordshire,Trinity Church of England Primary School,299,26,3,29
Oxfordshire,Wychwood Church of England Primary School,293,37,5,42
Oxfordshire,St Swithun's CofE Primary School,413,54,12,66
Oxfordshire,St Blaise CofE Primary School,126,15,4,19
Oxfordshire,St Leonard's Church of England Primary School,362,53,5,58
Oxfordshire,Great Rollright Church of England (Aided) Primary School,109,14,3,17
Oxfordshire,Kirtlington Church of England Primary School,72,7,1,8
Oxfordshire,St Edburg's Church of England (VA) School,452,82,16,98
Oxfordshire,Ewelme CofE Primary School,73,6,1,7
Oxfordshire,Little Milton Church of England Primary School,39,9,0,9
Oxfordshire,Checkendon Church of England (A) Primary School,55,5,1,6
Oxfordshire,Goring Church of England Aided Primary School,162,18,2,20
Oxfordshire,Shiplake Church of England School,130,11,1,12
Oxfordshire,"Sacred Heart Catholic Primary School, Henley-on-Thames",118,11,2,13
Oxfordshire,"St Mary's Catholic Primary School, Bicester",248,40,12,52
Oxfordshire,St Barnabas' Church of England Aided Primary School,187,22,2,24
Oxfordshire,St Ebbe's Church of England Aided Primary School,318,48,11,59
Oxfordshire,St Mary and John Church of England Primary School,386,54,9,63
Oxfordshire,St Philip and James' Church of England Aided Primary School Oxford,401,26,6,32
Oxfordshire,"St Joseph's Catholic Primary School, Oxford",413,45,9,54
Oxfordshire,St Aloysius' Catholic Primary School,218,16,4,20
Oxfordshire,Appleton Church of England (A) Primary School,189,22,6,28
Oxfordshire,Ashbury with Compton Beauchamp Church of England (A) Primary School,87,10,6,16
Oxfordshire,Shellingford Church of England (Voluntary Aided) School,95,17,2,19
Oxfordshire,Wootton St Peter's Church of England Primary School,96,17,2,19
Oxfordshire,St Amand's Catholic Primary School,115,21,2,23
Oxfordshire,St Edmund's Catholic Primary School,211,42,5,47
Oxfordshire,"St Mary's Church of England (Aided) Primary School, Chipping Norton",195,30,7,37
Oxfordshire,All Saints Church of England (Aided) Primary School,434,60,5,65
Oxfordshire,Carterton Community College,639,99,24,123
Oxfordshire,Shenington Church of England Primary School,88,26,5,31
Oxfordshire,Tudor Hall School,322,109,1,110
Oxfordshire,Bloxham School,553,150,0,150
Oxfordshire,Rupert House School,203,20,0,20
Oxfordshire,Kingham Hill School,369,37,6,43
Oxfordshire,Sibford School,423,199,2,201
Oxfordshire,St John's Priory School,78,8,0,8
Oxfordshire,St Mary's Preparatory,126,31,1,32
Oxfordshire,The Oratory School,372,93,0,93
Oxfordshire,Cokethorpe School,611,48,0,48
Oxfordshire,Shiplake College,517,265,5,270
Oxfordshire,Oratory Preparatory School,317,25,0,25
Oxfordshire,Christ Church Cathedral School,137,15,0,15
Oxfordshire,Dragon School,810,146,1,147
Oxfordshire,Headington School,1065,106,0,106
Oxfordshire,New College School,158,26,0,26
Oxfordshire,St Edward's School,779,218,0,218
Oxfordshire,Summer Fields School,337,70,0,70
Oxfordshire,Wychwood School,124,64,3,67
Oxfordshire,Rye St Antony,265,68,1,69
Oxfordshire,Cothill House,163,30,0,30
Oxfordshire,Our Lady's Abingdon,366,157,0,157
Oxfordshire,St Hugh's School,337,82,0,82
Oxfordshire,Radley College,761,160,0,160
Oxfordshire,Pinewood School,408,68,0,68
Oxfordshire,Cranford House School Trust Limited,546,70,0,70
Oxfordshire,Moulsford Preparatory School,387,86,0,86
Oxfordshire,The Manor Preparatory School,373,58,1,59
Oxfordshire,Oxford High School,864,144,1,145
Oxfordshire,Magdalen College School,977,168,1,169
Oxfordshire,Abingdon School,1285,197,0,197
Oxfordshire,St Helen and St Katharine,721,135,1,136
Oxfordshire,The King's School,200,49,1,50
Oxfordshire,Emmanuel Christian School,64,3,2,5
Oxfordshire,d'Overbroeck's,742,228,1,229
Oxfordshire,Windrush Valley School,102,8,0,8
Oxfordshire,Bruern Abbey School,176,21,21,42
Oxfordshire,The Unicorn School,107,54,53,107
Oxfordshire,Park School,48,2,46,48
Oxfordshire,Woodeaton Manor School,85,0,85,85
Oxfordshire,Mulberry Bush School,22,0,22,22
Oxfordshire,Swalcliffe Park School CIO,73,0,73,73
Oxfordshire,Frank Wise School,121,0,121,121
Oxfordshire,John Watson School,110,0,110,110
Oxfordshire,Oxfordshire Hospital School,0,0,0,0
Telford and Wrekin,Madeley Nursery School,65,11,2,13
Telford and Wrekin,Oakengates Nursery School,72,11,0,11
Telford and Wrekin,The Linden Centre,32,1,28,29
County Durham,Silver Tree Primary School and Nursery,169,29,4,33
Shropshire,Cheswardine Primary and Nursery School,56,6,3,9
Telford and Wrekin,Church Aston Infant School,51,4,3,7
Shropshire,Church Preen Primary School,42,8,1,9
Telford and Wrekin,Donnington Wood Infant School and Nursery Centre,163,15,2,17
Shropshire,Gobowen Primary School,213,18,3,21
Telford and Wrekin,High Ercall Primary School,146,23,3,26
Shropshire,Highley Community Primary School,255,39,2,41
Shropshire,Hinstock Primary School,141,25,3,28
Shropshire,Hodnet Primary School,174,19,2,21
Telford and Wrekin,Lawley Primary School,427,34,6,40
Telford and Wrekin,Lilleshall Primary School,213,35,1,36
Shropshire,Minsterley Primary School,133,19,1,20
Telford and Wrekin,Newport Infant School,255,25,4,29
Shropshire,Norbury Primary School and Nursery,67,9,0,9
Shropshire,Crowmoor Primary School and Nursery,187,24,2,26
Shropshire,Harlescott Junior School,393,90,12,102
Shropshire,Sundorne Infant School and Nursery,346,51,8,59
Shropshire,Sheriffhales Primary School,67,3,3,6
Shropshire,Buntingsdale Primary School and Nursery,84,15,0,15
Shropshire,Stoke-on-Tern Primary School,133,17,2,19
Shropshire,Weston Rhyn Primary School,184,45,4,49
Telford and Wrekin,Wombridge Primary School,275,55,3,58
Shropshire,Woore Primary and Nursery School,80,5,1,6
Telford and Wrekin,Wrockwardine Wood Infant School and Nursery,202,35,1,36
Shropshire,Much Wenlock Primary School,209,30,5,35
Shropshire,Albrighton Primary School & Nursery,346,33,10,43
Shropshire,Shifnal Primary School,401,27,8,35
Telford and Wrekin,Holmer Lake Primary School,235,30,2,32
Telford and Wrekin,William Reynolds Primary School,453,103,7,110
Shropshire,John Wilkinson Primary School and Nursery,207,23,2,25
Telford and Wrekin,Moorfield Primary School,278,19,2,21
Shropshire,Belvidere Primary School,277,42,2,44
Telford and Wrekin,Ladygrove Primary School,457,87,6,93
Telford and Wrekin,Randlay Primary School,351,77,9,86
Telford and Wrekin,Captain Webb Primary School,486,58,6,64
Telford and Wrekin,Aqueduct Primary School,248,38,5,43
Telford and Wrekin,John Randall Primary School,217,48,2,50
Shropshire,The Martin Wilson School,223,47,2,49
Telford and Wrekin,Apley Wood Primary School,419,58,3,61
Telford and Wrekin,Teagues Bridge Primary School,275,31,2,33
Shropshire,The Meadows Primary School,277,55,6,61
Telford and Wrekin,Muxton Primary School,414,45,7,52
Telford and Wrekin,Hollinswood Primary School,404,45,10,55
Shropshire,Adderley CofE Primary School,30,5,2,7
Shropshire,St Mary's CofE Primary School,196,23,2,25
Shropshire,Beckbury CofE Primary School,53,3,1,4
Shropshire,Bicton CofE Primary School and Nursery,151,21,5,26
Shropshire,Brockton CofE Primary School,66,10,0,10
Shropshire,Chirbury CofE VC Primary School & Busy Bees Nursery,92,10,1,11
Shropshire,St Lawrence CofE Primary School,256,42,12,54
Shropshire,Cockshutt CofE Primary School and Nursery,69,16,1,17
Shropshire,Christ Church CofE Primary School,129,22,6,28
Shropshire,Criftins CofE Primary School,101,16,3,19
Telford and Wrekin,Donnington Wood CofE Voluntary Controlled Junior School,211,35,4,39
Telford and Wrekin,St Peter's Church of England Controlled Primary School and Nursery,225,20,5,25
Shropshire,Farlow CofE Primary School,41,10,0,10
Shropshire,St Andrew's CofE Primary School,78,7,8,15
Shropshire,Hadnall CofE Primary School,112,15,2,17
Shropshire,Kinlet CofE Primary School,36,6,0,6
Shropshire,Kinnerley Church of England Controlled Primary School,87,4,4,8
Shropshire,Longnor CofE Primary School,113,15,2,17
Shropshire,Morda CofE Primary School,106,39,4,43
Shropshire,Moreton Say CofE  Primary School,100,11,1,12
Shropshire,Myddle CofE Primary School,126,15,4,19
Shropshire,Newcastle CofE Primary School,22,3,1,4
Telford and Wrekin,Newport Church of England Voluntary Controlled Junior School,325,41,8,49
Shropshire,Newtown CofE Primary School,121,21,0,21
Shropshire,Norton-in-Hales CofE Primary School,85,17,3,20
Shropshire,Pontesbury CofE Primary School,215,33,5,38
Shropshire,Bomere Heath CofE Primary School,127,33,2,35
Telford and Wrekin,St Lawrence Church of England Voluntary Controlled Primary School,87,14,1,15
Shropshire,Rushbury CofE Primary School,51,5,0,5
Shropshire,St John the Baptist CofE (Controlled) Primary School and Nursery,96,23,0,23
Shropshire,Selattyn CofE Primary School,93,9,0,9
Shropshire,St Andrew's CofE Primary School,365,21,7,28
Shropshire,Oxon CofE Primary School,427,58,5,63
Shropshire,St Giles CofE Primary School,307,44,6,50
Telford and Wrekin,Tibberton Church of England Primary School,137,17,1,18
Shropshire,Trefonen CofE Primary School,149,21,1,22
Shropshire,St Lucia's CofE Primary School & Nursery,86,8,2,10
Shropshire,Welshampton CofE Primary School,64,12,1,13
Shropshire,West Felton CofE Primary School,142,9,3,12
Shropshire,Weston Lullingfields CofE School,33,4,2,6
Shropshire,Wistanstow CofE Primary School,72,11,0,11
Shropshire,Long Mountain CofE Primary School,128,22,1,23
Shropshire,Stiperstones CofE Primary School,25,3,0,3
Telford and Wrekin,Wrockwardine Wood Church of England Junior School,260,40,3,43
Shropshire,Broseley CE Primary School,236,35,1,36
Shropshire,St Thomas and St Anne CofE Primary School,98,11,4,15
Telford and Wrekin,John Fletcher of Madeley Primary School,284,48,8,56
Telford and Wrekin,St George's Church of England Primary School,564,83,6,89
Shropshire,Bryn Offa CofE Primary School,139,7,0,7
Shropshire,St Laurence CofE Primary School,214,33,6,39
Shropshire,Brown Clee CofE Primary School,118,8,3,11
Shropshire,Baschurch CofE Primary School,204,23,3,26
Shropshire,St Mary's Bluecoat CofE (VA) Primary School,207,14,9,23
Shropshire,St Mary's CofE Primary School,65,6,0,6
Shropshire,Claverley CofE Primary School,99,14,1,15
Shropshire,Clunbury CofE Primary School,67,9,1,10
Telford and Wrekin,Coalbrookdale and Ironbridge CofE Primary School,208,26,6,32
Shropshire,Longden CofE Primary School,167,19,3,22
Shropshire,Lydbury North CofE (A) Primary School,50,7,1,8
Shropshire,Whittington CofE (VA) Primary School,227,24,17,41
Shropshire,Worfield Endowed CofE Primary School,159,13,2,15
Shropshire,St John's Catholic Primary School,193,16,3,19
Telford and Wrekin,St Peter and St Paul Catholic Primary School,197,23,3,26
Shropshire,Our Lady and St Oswald's Catholic Primary School,134,20,4,24
Shropshire,Shrewsbury Cathedral Catholic Primary School and Nursery,188,32,8,40
Telford and Wrekin,St Patrick's Catholic Primary School,238,34,6,40
Telford and Wrekin,St Mary's Catholic Primary School,194,36,0,36
Telford and Wrekin,St Matthew's Church of England Aided Primary School and Nursery Centre,309,31,1,32
Telford and Wrekin,St Luke's Catholic Primary School,155,24,4,28
Shropshire,Corvedale CofE Primary School,79,6,0,6
Shropshire,Onny CofE (A) Primary School,107,16,1,17
Shropshire,"The Community College, Bishop's Castle",520,33,8,41
Telford and Wrekin,The Burton Borough School,1150,139,20,159
Shropshire,Bedstone College,145,28,6,34
Shropshire,Ellesmere College,577,164,5,169
Shropshire,Adcote School for Girls,222,33,1,34
Shropshire,Moreton Hall School,411,85,2,87
Shropshire,Packwood Haugh School,219,46,0,46
Shropshire,Prestfelde School,338,20,1,21
Shropshire,Shrewsbury School,828,206,1,207
Telford and Wrekin,The Old Hall School,236,62,1,63
Telford and Wrekin,Wrekin College,566,110,0,110
Telford and Wrekin,Castle House School,97,10,1,11
Shropshire,Oswestry School,479,113,4,117
Shropshire,St Winefride's Convent School,101,8,1,9
Shropshire,Birchfield School,163,17,3,20
Shropshire,Moor Park School,210,38,0,38
Shropshire,Shrewsbury High School,357,29,2,31
Telford and Wrekin,Overley Hall School,21,0,21,21
Shropshire,Concord College,571,56,0,56
Telford and Wrekin,Thomas Telford School,1545,73,2,75
Telford and Wrekin,Haughton School,187,0,187,187
Telford and Wrekin,Southall School,183,0,183,183
Telford and Wrekin,The Bridge at HLC,213,0,213,213
Somerset,Castle Cary Community Primary School,219,38,7,45
Somerset,Coxley Primary School,56,14,2,16
Somerset,Ditcheat Primary School,93,8,4,12
Somerset,Dunster First School,126,12,2,14
Somerset,Vallis First School,231,22,5,27
Somerset,Keinton Mandeville Primary School,159,20,5,25
Somerset,Kingsbury Episcopi Primary School,154,17,1,18
Somerset,Meare Village Primary School,107,16,4,20
Somerset,Merriott Primary School,126,24,4,28
Somerset,Milborne Port Primary School,159,23,0,23
Somerset,Priddy Primary School,34,4,0,4
Somerset,Shepton Mallet Community Infants' School & Nursery,218,39,3,42
Somerset,Stoke St Michael Primary School,54,11,1,12
Somerset,Elmhurst Junior School,282,29,4,33
Somerset,Hindhayes Infant School,172,24,0,24
Somerset,Wincanton Primary School,381,49,11,60
Somerset,Wookey Primary School,108,18,4,22
Somerset,Bowlish Infant School,110,8,1,9
Somerset,Ashcott Primary School,105,9,2,11
Somerset,Eastover Primary School,413,51,26,77
Somerset,Hamp Nursery and Infants' School,230,98,4,102
Somerset,Burnham-On-Sea Community Infant School,225,24,9,33
Somerset,Catcott Primary School,156,14,4,18
Somerset,North Newton Community Primary School,85,9,3,12
Somerset,Somerset Bridge Primary School,434,41,16,57
Somerset,Westonzoyland Community Primary School,163,6,3,9
Somerset,Bishops Hull Primary School,217,19,6,25
Somerset,Churchstanton Primary School,71,10,3,13
Somerset,Milverton Community Primary School and Pre-School,204,18,4,22
Somerset,Sampford Arundel Community Primary School,46,10,0,10
Somerset,Stawley Primary School,60,10,0,10
Somerset,Wellsprings Primary School,290,27,14,41
Somerset,Beech Grove Primary School,299,60,9,69
Somerset,Wiveliscombe Primary School,201,13,4,17
Somerset,Parkfield Primary School,427,41,9,50
Somerset,Barwick and Stoford Community Primary School,61,16,1,17
Somerset,East Coker Community Primary School,221,28,5,33
Somerset,South Petherton Junior School,139,19,0,19
Somerset,Milford Infants' School,252,31,6,37
Somerset,Reckleford Infant School and Nursery,109,21,1,22
Somerset,Birchfield Community Primary School,421,40,14,54
Somerset,Ilchester Community School,271,22,5,27
Somerset,Kingsmoor Primary School,174,16,1,17
Somerset,Holway Park Community Primary School,336,56,25,81
Somerset,Baltonsborough Church of England Voluntary Controlled Primary School,89,7,3,10
Somerset,Beckington Church of England First School,74,9,2,11
Somerset,Berkley Church of England First School,97,14,0,14
Somerset,Butleigh Church of England Primary School,85,14,2,16
Somerset,Charlton Mackrell CofE Primary School,84,9,3,12
Somerset,Bishop Henderson Church of England Primary School,158,17,2,19
Somerset,Ashlands Church of England Primary School,153,8,2,10
Somerset,St Bartholomew's Church of England Primary School,186,24,6,30
Somerset,Curry Mallet Church of England Primary School,75,9,3,12
Somerset,Curry Rivel Church of England VC Primary School,202,16,7,23
Somerset,St Aldhelm's Church of England Primary School,163,23,3,26
Somerset,All Saints CofE VC Infants School,54,4,1,5
Somerset,Evercreech Church of England Primary School,182,26,5,31
Somerset,Exford Church of England First School,29,3,2,5
Somerset,Trinity Church of England First School,287,31,4,35
Somerset,St John's Church of England Voluntary Controlled Infants School,199,17,4,21
Somerset,"St Nicholas CofE Primary School, Henstridge",108,17,1,18
Somerset,High Ham Church of England Primary School,152,20,2,22
Somerset,Hinton St George Church of England Primary School,83,11,5,16
Somerset,Herne View Church of England Primary,491,44,13,57
Somerset,Lovington Church of England Primary School,51,12,2,14
Somerset,Mells Church of England First School,66,8,2,10
Somerset,Stogumber CofE Primary School,45,6,0,6
Somerset,Abbas and Templecombe Church of England Primary School,109,12,2,14
Somerset,Walton Church of England Voluntary Controlled Primary School,140,19,0,19
Somerset,St Cuthbert's CofE Junior School,168,29,3,32
Somerset,St Lawrence's CofE Primary School,43,3,0,3
Somerset,West Pennard Church of England Primary School,208,10,6,16
Somerset,Upton Noble CofE VC Primary School,171,13,0,13
Somerset,St Paul's Church of England VC Junior School,330,63,10,73
Somerset,St Mary's Voluntary Controlled Church of England Primary School,483,27,13,40
Somerset,St Andrew's Church of England Voluntary Controlled Junior School,325,47,10,57
Somerset,Cannington Church of England Primary School,181,17,4,21
Somerset,Nether Stowey Church of England Primary School,164,14,2,16
Somerset,Creech St Michael Church of England Primary School,278,29,7,36
Somerset,Kingston St Mary Church of England Primary School,98,9,0,9
Somerset,Langford Budville Church of England Primary School,37,10,0,10
Somerset,Rockwell Green Church of England Primary School,204,40,7,47
Somerset,Stoke St Gregory Church of England Primary School,62,7,1,8
Somerset,Berrow Church of England Primary School,170,29,1,30
Somerset,Ash Church of England Primary School,133,18,0,18
Somerset,Chilthorne Domer Church School,142,19,4,23
Somerset,Haselbury Plucknett Church of England First School,58,13,2,15
Somerset,Norton-sub-Hamdon Church of England Primary School,102,9,1,10
Somerset,West Chinnock Church of England Primary School,51,9,1,10
Somerset,West Coker CofE VC Primary School,29,5,1,6
Somerset,Rode Methodist VC First School,69,8,2,10
Somerset,Chewton Mendip Church of England VA Primary School,117,15,0,15
Somerset,Combe St Nicholas Church of England VA Primary School,92,4,2,6
Somerset,Croscombe Church of England Primary School,48,9,0,9
Somerset,Crowcombe CofE VA Primary School,50,9,1,10
Somerset,Cutcombe Church of England First School,34,5,0,5
Somerset,St Benedict's Church of England Voluntary Aided Junior School,189,37,10,47
Somerset,Kilmersdon Church of England Primary School,166,19,11,30
Somerset,Long Sutton CofE Primary School,107,15,9,24
Somerset,Norton St Philip Church of England First School,55,2,1,3
Somerset,St Dubricius Church of England VA School,97,17,2,19
Somerset,St Benedict's Catholic Primary School,179,31,2,33
Somerset,Timberscombe Church of England First School,32,4,0,4
Somerset,"St John's Church of England Voluntary Aided First School, Frome",243,51,4,55
Somerset,"St Louis Catholic Primary School, Frome",176,18,3,21
Somerset,Thurlbear Church of England Primary School,207,12,7,19
Somerset,Trull Church of England VA Primary School,255,7,5,12
Somerset,St George's Catholic School,225,20,4,24
Somerset,"Bishop Henderson Church of England Primary School, Taunton",439,53,10,63
Somerset,South Petherton Church of England Infants and Pre School,103,12,1,13
Somerset,"St Margaret's School, Tintinhull",83,10,3,13
Somerset,Martock Church of England VA Primary School,201,25,5,30
Somerset,Knights Templar Community Church School & Nursery,193,34,6,40
Somerset,Frome Community College,1283,164,34,198
Somerset,Dulverton Junior School,64,21,3,24
Somerset,Robert Blake School,973,162,27,189
Somerset,Heathfield Community School,1383,244,63,307
Somerset,Wadham School,816,108,23,131
Somerset,Bruton Primary School,255,22,4,26
Somerset,St John's Church of England Primary School,212,41,4,45
Somerset,King's Bruton,367,47,0,47
Somerset,Perrott Hill,183,43,0,43
Somerset,All Hallows School,258,73,5,78
Somerset,Downside School,353,103,0,103
Somerset,Millfield School,1312,373,1,374
Somerset,King's College Taunton,475,81,0,81
Somerset,Queen's College,645,102,1,103
Somerset,Taunton School,740,112,3,115
Somerset,Wells Cathedral School,777,115,4,119
Somerset,Marchant Holliday School,48,0,48,48
Somerset,Millfield Preparatory School,472,111,0,111
Somerset,Chard School,61,15,0,15
Somerset,Wellington School,903,117,1,118
Somerset,Hazlegrove Preparatory School,414,46,0,46
Somerset,Sedgemoor Manor School,63,0,63,63
Somerset,King's Hall School,296,47,1,48
Somerset,Polden Bower School,194,0,194,194
Somerset,Fairmead School,146,0,146,146
Somerset,Fiveways Special School,94,0,94,94
Somerset,Avalon School,60,0,60,60
Staffordshire,Hednesford Nursery School,23,0,0,0
Staffordshire,Oaklands Nursery School,28,0,1,1
Stoke-on-Trent,Bentilee Nursery School,58,9,0,9
Stoke-on-Trent,The Willows Primary School,687,60,19,79
Stoke-on-Trent,Heron Cross Primary School,379,61,5,66
Stoke-on-Trent,Ball Green Primary School,346,50,13,63
Stoke-on-Trent,Holden Lane Primary School,225,41,3,44
Stoke-on-Trent,Hillside Primary School,238,25,6,31
Stoke-on-Trent,Sandford Hill Primary School,456,63,6,69
Staffordshire,Christ Church Primary School,318,39,4,43
Staffordshire,Victoria Community School,368,78,7,85
Staffordshire,Tower View Primary School,372,71,3,74
Staffordshire,The Croft Primary School,198,22,4,26
Staffordshire,Ravensmead Primary School,332,59,11,70
Staffordshire,Wood Lane Primary School,96,18,3,21
Staffordshire,Moor First School,76,2,3,5
Staffordshire,Squirrel Hayes First School,78,25,4,29
Staffordshire,Bridgtown Primary School,307,32,1,33
Staffordshire,Chadsmoor Community Infants and Nursery School,169,38,0,38
Staffordshire,Five Ways Primary School,613,30,8,38
Staffordshire,West Hill Primary School,368,47,5,52
Staffordshire,Cheadle Primary School,365,70,10,80
Staffordshire,Millfield Primary School,385,42,5,47
Staffordshire,St Stephen's Primary School,289,41,0,41
Staffordshire,Fulford Primary School,85,16,0,16
Staffordshire,Thomas Barnes Primary School,106,4,0,4
Staffordshire,Dove Bank Primary School,164,19,2,21
Staffordshire,Talbot First School,34,3,1,4
Staffordshire,Springhead Primary School,198,30,3,33
Staffordshire,Longwood Primary School,168,21,3,24
Staffordshire,Green Lea First School,66,2,0,2
Staffordshire,Hassell Primary School,176,22,3,25
Staffordshire,May Bank Infants' School,170,5,1,6
Staffordshire,Westlands Primary School,204,23,1,24
Staffordshire,Oakridge Primary School,219,3,2,5
Staffordshire,Bhylls Acre Primary School,199,33,1,34
Staffordshire,Springfields First School,161,17,2,19
Staffordshire,Endon Hall Primary School,192,16,4,20
Staffordshire,Ashcroft Infants' School,134,3,0,3
Staffordshire,Thomas Russell Junior School,253,23,5,28
Staffordshire,Hayes Meadow Primary School,171,26,2,28
Staffordshire,Florendine Primary School,251,27,5,32
Staffordshire,Willows Primary School,377,61,3,64
Staffordshire,Glenthorne Community Primary School,322,34,8,42
Staffordshire,Springcroft Primary School,215,10,3,13
Staffordshire,Pirehill First School,281,52,4,56
Staffordshire,Hanbury's Farm Community Primary School,175,32,3,35
Staffordshire,Oakhill Primary School,116,20,1,21
Staffordshire,Chancel Primary School,213,29,5,34
Staffordshire,The John Bamford Primary School,303,39,8,47
Staffordshire,Lane Green First School,149,21,6,27
Staffordshire,Jerome Primary School,209,29,6,35
Staffordshire,Amington Heath Primary School and Nursery,153,30,5,35
Staffordshire,Perton First School,286,29,9,38
Staffordshire,Gorsemoor Primary School,444,54,7,61
Staffordshire,Cheslyn Hay Primary School,421,39,1,40
Staffordshire,Landywood Primary School,365,36,0,36
Staffordshire,Blakeley Heath Primary School,364,59,7,66
Staffordshire,Westfield Primary School,417,43,1,44
Staffordshire,Cooper Perry Primary School,206,27,3,30
Staffordshire,Tillington Manor Primary School,222,70,4,74
Staffordshire,St Leonard's Primary School,211,26,3,29
Staffordshire,Doxey Primary and Nursery School,193,51,1,52
Staffordshire,Burton Manor Primary School,299,50,0,50
Staffordshire,Flash Ley Primary School,188,26,3,29
Staffordshire,Chase Terrace Primary School,280,37,3,40
Staffordshire,Fulfen Primary School,409,58,6,64
Stoke-on-Trent,Burnwood Community Primary School,577,124,11,135
Stoke-on-Trent,St Paul's CofE (C) Primary School,216,29,5,34
Staffordshire,All Saints CofE (C) Primary School,181,23,2,25
Staffordshire,Hugo Meynell CofE (VC) Primary School,193,22,5,27
Staffordshire,Barlaston CofE (VC) First School,122,11,2,13
Staffordshire,Berkswich CofE (VC) Primary School,215,15,1,16
Staffordshire,Betley CofE VC Primary School,103,15,1,16
Staffordshire,St Anne's CofE (VC) Primary School,198,27,2,29
Staffordshire,Chadsmoor CofE (VC) Junior School,220,53,4,57
Staffordshire,St Andrew's CofE (C) Primary School,55,9,1,10
Staffordshire,Mary Howard CofE (VC) Primary School,49,5,1,6
Staffordshire,St John's CofE (C) Primary School,187,16,0,16
Staffordshire,Christ Church CofE (C) Primary School,418,39,2,41
Staffordshire,St Bartholomew's CofE (C) School,44,10,5,15
Staffordshire,St Peter's CofE (VC) First School,48,3,1,4
Staffordshire,St Chad's CofE (C) Primary School,267,32,1,33
Staffordshire,St Luke's CofE (C) Primary School,194,43,8,51
Staffordshire,St Margaret's CofE (VC) Junior School,228,24,1,25
Staffordshire,St Chad's CofE (VC) First School,128,18,1,19
Staffordshire,All Saints CofE (C) First School,54,5,0,5
Staffordshire,St Michael's CofE (C) First School,221,25,2,27
Staffordshire,St John's CofE (C) Primary School,109,23,4,27
Staffordshire,Tittensor CofE (C) First School,71,6,2,8
Staffordshire,Sir John Offley CofE (VC) Primary School,147,22,4,26
Staffordshire,Baldwins Gate CofE(VC) Primary School,164,23,5,28
Staffordshire,Hob Hill CE/Methodist (VC) Primary School,248,36,2,38
Staffordshire,Holy Trinity CofE (C) Primary School,185,37,4,41
Staffordshire,St Paul's CofE (C) Primary School,140,29,1,30
Staffordshire,All Saints CofE (VC) Primary School,59,7,4,11
Stoke-on-Trent,St John's CofE (A) Primary School,330,34,8,42
Stoke-on-Trent,Hanley St Luke's CofE Aided Primary School,429,69,10,79
Staffordshire,St Modwen's Catholic Primary School,373,24,5,29
Staffordshire,St Peter's CofE (A) Primary School,141,11,3,14
Staffordshire,Ilam CofE (VA) Primary School,54,5,0,5
Staffordshire,St Mary's CofE (A) Primary School,50,4,0,4
Staffordshire,St Michael's CofE (A) First School,150,16,2,18
Staffordshire,St Mary's CofE (A) First School,204,30,4,34
Staffordshire,St Leonard's CofE (A) Primary School,131,16,3,19
Staffordshire,St Mary's Catholic Primary School,193,31,0,31
Staffordshire,St Joseph and St Theresa Catholic Primary,209,17,2,19
Staffordshire,St Joseph's Catholic Primary School,206,13,2,15
Staffordshire,St Joseph's Catholic Primary School,212,28,4,32
Staffordshire,St Joseph's Catholic Primary School,205,22,4,26
Staffordshire,St Elizabeth's Catholic Primary School,188,23,0,23
Staffordshire,St Bernadette's Catholic Primary School,107,12,1,13
Staffordshire,St Gabriel's Catholic Primary School,392,52,4,56
Staffordshire,SS Peter and Paul Catholic Primary School,130,24,7,31
Staffordshire,St Thomas More Catholic Primary School,211,15,2,17
Staffordshire,St Leonard's CofE (A) First School,33,1,0,1
Staffordshire,Paget High School,686,85,0,85
Staffordshire,Norton Canes High School,467,69,35,104
Staffordshire,Blythe Bridge High School,1031,90,15,105
Staffordshire,Codsall Community High School,1051,124,13,137
Staffordshire,King Edward VI School,1607,133,18,151
Staffordshire,Walton Priory Middle School,512,74,10,84
Staffordshire,Perton Middle School,444,76,6,82
Staffordshire,Abbot Beyne School,790,105,23,128
Staffordshire,Bilbrook CofE (VC) Middle School,141,35,8,43
Staffordshire,Corbett VA CofE Primary School,85,7,1,8
Staffordshire,Stafford Manor High School,472,78,5,83
Staffordshire,Cardinal Griffin Catholic College,883,133,12,145
Staffordshire,St. Dominic's Grammar School,286,82,2,84
Staffordshire,Denstone College,776,140,6,146
Staffordshire,Lichfield Cathedral School,535,73,3,76
Staffordshire,St Dominic's Priory School,189,44,6,50
Staffordshire,The Yarlet School,172,26,1,27
Staffordshire,Edenhurst Preparatory School,186,14,2,16
Stoke-on-Trent,St Joseph's Preparatory School,83,15,3,18
Staffordshire,Chase Grammar School,177,32,0,32
Staffordshire,Newcastle-under-Lyme School,867,71,1,72
Staffordshire,Maple Hayes Hall School,112,1,111,112
Staffordshire,Stafford Grammar School,446,47,2,49
Staffordshire,Roaches School,46,13,33,46
Staffordshire,Horton Lodge Community Special School,57,0,57,57
Stoke-on-Trent,Portland School and Specialist College,95,0,95,95
Stoke-on-Trent,Abbey Hill School and College,355,0,355,355
Staffordshire,Hednesford Valley High School,177,0,177,177
Staffordshire,Sherbrook Primary School,135,0,135,135
Staffordshire,Marshlands School,132,0,132,132
Suffolk,Highfield Nursery School,107,11,0,11
Suffolk,Bildeston Primary School,118,14,2,16
Suffolk,Elmswell Community Primary School,322,29,2,31
Suffolk,Pot Kiln Primary School,316,49,5,54
Suffolk,New Cangle Community Primary School,196,28,2,30
Suffolk,Hundon Community Primary School,75,9,1,10
Suffolk,Lakenheath Community Primary School,269,29,11,40
Suffolk,Lavenham Community Primary School,117,11,4,15
Suffolk,Nayland Primary School,207,19,2,21
Suffolk,Exning Primary School,222,43,17,60
Suffolk,Stanton Community Primary School,223,27,9,36
Suffolk,Guildhall Feoffment Community Primary School,325,31,6,37
Suffolk,Westgate Community Primary School and Nursery,289,40,13,53
Suffolk,Sexton's Manor Community Primary School,191,22,3,25
Suffolk,Hadleigh Community Primary School,514,51,1,52
Suffolk,Paddocks Primary School,189,25,1,26
Suffolk,Bucklesham Primary School,99,19,3,22
Suffolk,Carlton Colville Primary School,437,45,8,53
Suffolk,Copdock Primary School,82,10,0,10
Suffolk,Earl Soham Community Primary School,71,10,0,10
Suffolk,Fairfield Infant School,310,34,1,35
Suffolk,Grundisburgh Primary School,159,20,0,20
Suffolk,Holbrook Primary School,186,31,3,34
Suffolk,Hollesley Primary School,98,21,2,23
Suffolk,"Heath Primary School, Kesgrave",572,59,8,67
Suffolk,Bealings School,105,19,2,21
Suffolk,Melton Primary School,177,24,3,27
Suffolk,Otley Primary School,54,5,1,6
Suffolk,Somersham Primary School,93,14,3,17
Suffolk,Trimley St Mary Primary School,387,46,5,51
Suffolk,Trimley St Martin Primary School,196,35,13,48
Suffolk,Waldringfield Primary School,98,15,6,21
Suffolk,Witnesham Primary School,97,5,4,9
Suffolk,Woodbridge Primary School,195,5,2,7
Suffolk,Colneis Junior School,355,41,9,50
Suffolk,Gorseland Primary School,441,32,28,60
Suffolk,Kingsfleet Primary School,203,7,3,10
Suffolk,Kyson Primary School,405,28,9,37
Suffolk,Ranelagh Primary School,304,37,8,45
Suffolk,Ravenswood Community Primary School,435,49,9,58
Suffolk,Clifford Road Primary School & Nursery,436,22,8,30
Suffolk,Dale Hall Community Primary School,414,63,8,71
Suffolk,Stratford St Mary Primary School,92,9,1,10
Suffolk,Oulton Broad Primary School,371,33,4,37
Suffolk,Ickworth Park Primary School,197,9,1,10
Suffolk,Wood Ley Community Primary School,315,32,3,35
Suffolk,Birchwood Primary School,208,23,3,26
Suffolk,Sebert Wood Community Primary School,392,54,3,57
Suffolk,Sandlings Primary School,69,11,1,12
Suffolk,Acton Church of England Voluntary Controlled Primary School,169,9,2,11
Suffolk,Barnham Church of England Voluntary Controlled Primary School,157,36,2,38
Suffolk,Barningham Church of England Voluntary Controlled Primary School,81,10,3,13
Suffolk,Barrow Church of England Voluntary Controlled Primary School,201,15,3,18
Suffolk,Boxford Church of England Voluntary Controlled Primary School,183,13,3,16
Suffolk,Bures Church of England Voluntary Controlled Primary School,199,16,2,18
Suffolk,Cavendish Church of England Primary School,83,10,1,11
Suffolk,Cockfield Church of England Voluntary Controlled Primary School,67,3,0,3
Suffolk,Thurlow Voluntary Controlled Primary School,59,10,0,10
Suffolk,Great Waldingfield Church of England Voluntary Controlled Primary School,193,18,3,21
Suffolk,Honington Church of England Voluntary Controlled Primary School,170,32,2,34
Suffolk,Hopton Church of England Voluntary Controlled Primary School,88,10,0,10
Suffolk,"All Saints' Church of England Voluntary Controlled Primary School, Lawshall",171,13,3,16
Suffolk,Moulton Church of England Voluntary Controlled Primary School,203,25,2,27
Suffolk,Norton CEVC Primary School,209,29,1,30
Suffolk,Risby Church of England Voluntary Controlled Primary School,207,8,4,12
Suffolk,Walsham-le-Willows Church of England Voluntary Controlled Primary School,128,24,2,26
Suffolk,Whatfield Church of England Voluntary Controlled Primary School,40,12,2,14
Suffolk,Bawdsey Church of England Voluntary Controlled Primary School,64,13,1,14
Suffolk,Benhall St Mary's Church of England Voluntary Controlled Primary School,76,17,1,18
Suffolk,Bramford Church of England Voluntary Controlled Primary School,210,39,3,42
Suffolk,Corton Church of England Voluntary Aided Primary School,123,19,3,22
Suffolk,East Bergholt Church of England Voluntary Controlled Primary School,201,18,1,19
Suffolk,Great Finborough Church of England Voluntary Controlled Primary School,127,13,2,15
Suffolk,Kelsale Church of England Voluntary Controlled Primary School,171,22,6,28
Suffolk,Tattingstone Church of England Voluntary Controlled Primary School,63,7,2,9
Suffolk,Wilby Church of England Voluntary Controlled Primary School,100,14,1,15
Suffolk,Worlingham Church of England Voluntary Controlled Primary School,339,45,5,50
Suffolk,Capel St Mary Church of England Voluntary Controlled Primary School,278,23,3,26
Suffolk,Worlingworth Church of England Voluntary Controlled Primary School,77,11,2,13
Suffolk,Blundeston Church of England Voluntary Controlled Primary School,182,16,4,20
Suffolk,Bentley Church of England Voluntary Controlled Primary School,56,10,2,12
Suffolk,St Gregory Church of England Voluntary Controlled Primary School,229,11,21,32
Suffolk,St Botolph's Church of England Voluntary Controlled Primary School,176,18,1,19
Suffolk,St Edmundsbury Church of England Voluntary Aided Primary School,230,47,4,51
Suffolk,St Joseph's Roman Catholic Primary School,162,14,0,14
Suffolk,St Edmund's Catholic Primary School,437,83,34,117
Suffolk,Creeting St Mary Church of England Voluntary Aided Primary School,98,12,4,16
Suffolk,Stonham Aspal Church of England Voluntary Aided Primary School,190,27,0,27
Suffolk,Sir Robert Hitcham Church of England Voluntary Aided School,164,17,7,24
Suffolk,Framlingham Sir Robert Hitcham's Church of England Voluntary Aided Primary School,364,55,4,59
Suffolk,Orford Church of England Voluntary Aided Primary School,51,13,4,17
Suffolk,"St John's Church of England Voluntary Aided Primary School, Ipswich",207,14,1,15
Suffolk,"St Margaret's Church of England Voluntary Aided Primary School, Ipswich",420,41,5,46
Suffolk,"St Mark's Catholic Primary School, Ipswich",209,16,3,19
Suffolk,Thurston Community College,1570,164,30,194
Suffolk,Northgate High School,1732,173,51,224
Suffolk,King Edward VI CEVC School,1196,230,43,273
Suffolk,Stoke College,150,46,6,52
Suffolk,Orwell Park School,231,41,0,41
Suffolk,Saint Felix School,279,65,12,77
Suffolk,Summerhill School,62,10,3,13
Suffolk,Fairstead House,213,29,0,29
Suffolk,Old Buckenham Hall School,216,55,1,56
Suffolk,Barnardiston Hall Preparatory School,217,34,4,38
Suffolk,South Lee School,157,30,1,31
Suffolk,Bramfield House School,112,0,112,112
Suffolk,Ipswich School,1145,130,0,130
Suffolk,St Joseph's College,594,105,1,106
Suffolk,Framlingham College,578,130,1,131
Suffolk,The Old School,63,10,0,10
Suffolk,Culford School,848,129,0,129
Suffolk,Woodbridge School,745,104,0,104
Suffolk,Ipswich High School,498,77,1,78
Suffolk,Royal Hospital School,686,140,1,141
Suffolk,Centre Academy East Anglia,59,4,54,58
Suffolk,Finborough School,680,0,0,0
Suffolk,Brookes UK,144,21,14,35
Suffolk,Felixstowe International College,30,5,1,6
Suffolk,Hillside Special School,85,0,85,85
Surrey,Chertsey Nursery School,97,11,20,31
Surrey,Dorking Nursery School,106,27,10,37
Surrey,The Wharf Nursery School,92,14,1,15
Surrey,Kingswood Primary School,199,17,3,20
Surrey,Walton-on-the-Hill Primary School,209,28,9,37
Surrey,Charlwood Village Primary School,102,19,4,23
Surrey,North Downs Primary School,419,44,10,54
Surrey,Trumps Green Infant School,170,15,6,21
Surrey,Manorcroft Primary School,394,49,15,64
Surrey,Ewell Grove Primary and Nursery School,453,75,5,80
Surrey,Epsom Primary and Nursery School,519,149,30,179
Surrey,The Orchard Infant School,258,22,11,33
Surrey,Long Ditton Infant and Nursery School,184,12,4,16
Surrey,Thames Ditton Infant School,262,13,4,17
Surrey,Felbridge Primary School,204,25,1,26
Surrey,Beacon Hill Community Primary School,205,33,8,41
Surrey,Shottermill Junior School,250,29,8,37
Surrey,Shottermill Infant School,173,4,1,5
Surrey,Horley Infant School,267,37,3,40
Surrey,Barnett Wood Infant School,144,4,2,6
Surrey,Fetcham Village Infant School,174,6,3,9
Surrey,Dormansland Primary School,202,15,2,17
Surrey,Earlswood Infant and Nursery School,390,31,6,37
Surrey,Oatlands School,266,14,7,21
Surrey,Bagshot Infant School,154,17,18,35
Surrey,West Byfleet Infant School,262,24,8,32
Surrey,Wood Street Infant School,87,9,5,14
Surrey,The Greville Primary School,663,53,16,69
Surrey,Bushy Hill Junior School,240,33,7,40
Surrey,Hurst Green Infant School,101,10,1,11
Surrey,Meath Green Junior School,356,37,10,47
Surrey,Milford School,175,23,3,26
Surrey,Heather Ridge Infant School,176,17,1,18
Surrey,Oakfield Junior School,254,27,24,51
Surrey,Godstone Primary and Nursery School,214,29,8,37
Surrey,Banstead Community Junior School,331,28,13,41
Surrey,Worplesdon Primary School,535,80,40,120
Surrey,West Ashtead Primary School,261,26,11,37
Surrey,Prior Heath Infant School,180,10,3,13
Surrey,Shawfield Primary School,206,38,6,44
Surrey,The Grange Community Infant School,256,23,9,32
Surrey,Hurst Park Primary School,447,80,11,91
Surrey,Ongar Place Primary School,210,35,8,43
Surrey,Godalming Junior School,241,32,7,39
Surrey,Moss Lane School,159,14,4,18
Surrey,Badshot Lea Village Infant School,148,15,16,31
Surrey,Polesden Lacey Infant School,78,9,5,14
Surrey,Burhill Primary School,611,84,20,104
Surrey,Grovelands Primary School,507,82,8,90
Surrey,Bell Farm Primary School,686,81,40,121
Surrey,Audley Primary School,211,36,6,42
Surrey,Meadowcroft Community Infant School,88,8,1,9
Surrey,Stamford Green Primary School and Nursery,717,65,10,75
Surrey,Onslow Infant School,174,12,4,16
Surrey,Earlswood Junior School,447,49,17,66
Surrey,Reigate Priory Community Junior School,584,87,12,99
Surrey,Thorpe Lea Primary School,237,28,8,36
Surrey,St Ann's Heath Junior School,304,54,6,60
Surrey,Manby Lodge Infant School,267,20,5,25
Surrey,William Cobbett Primary School,459,48,42,90
Surrey,Tillingbourne Junior School,360,32,11,43
Surrey,West Byfleet Junior School,356,55,15,70
Surrey,Meath Green Infant School,267,25,9,34
Surrey,Clarendon Primary School,253,26,8,34
Surrey,Chennestone Primary School,338,45,14,59
Surrey,Beauclerc Infant and Nursery School,110,8,2,10
Surrey,Langshott Primary School,410,46,5,51
Surrey,Hythe Primary School,424,77,33,110
Surrey,Claygate Primary School,355,54,8,62
Surrey,Ashford Park Primary School,629,58,38,96
Surrey,Ash Grange Nursery and Primary School,313,62,11,73
Surrey,Stepgates Community School,279,114,22,136
Surrey,Lingfield Primary School,453,54,16,70
Surrey,Chandlers Field Primary School,394,53,33,86
Surrey,Town Farm Primary School & Nursery,467,99,14,113
Surrey,Epsom Downs Primary School and Children's Centre,438,65,16,81
Surrey,Furzefield Primary School,452,81,26,107
Surrey,Walsh Memorial CofE Controlled Infant School,174,26,3,29
Surrey,Lyne and Longcross CofE Aided Primary School,206,30,3,33
Surrey,Valley End CofE Infant School,153,3,5,8
Surrey,"St Martin's CofE Controlled Primary School, Dorking",374,34,21,55
Surrey,The Royal Kent CofE Primary School,211,21,4,25
Surrey,Farncombe Church of England Infant School,120,11,1,12
Surrey,St Paul's CofE Infant School,86,12,2,14
Surrey,St Mary's CofE Voluntary Controlled Infant School,76,13,2,15
Surrey,"St Mary's CofE Controlled Primary School, Byfleet",444,36,9,45
Surrey,Powell Corderoy Primary School,196,25,6,31
Surrey,Bisley CofE Primary School,372,57,7,64
Surrey,Walsh CofE Junior School,205,54,19,73
Surrey,Witley CofE Controlled Infant School,86,12,1,13
Surrey,Merrow CofE Controlled Infant School,148,25,2,27
Surrey,St James CofE Primary School,441,67,10,77
Surrey,St John's CofE Aided Primary School,457,33,14,47
Surrey,St Peter and St Paul Church Primary School,130,9,0,9
Surrey,Chilworth CofE (Aided) Infant School,70,5,0,5
Surrey,St Lawrence CofE (Aided) Primary School,207,25,2,27
Surrey,St Michael's CofE Aided Infant School,59,8,0,8
Surrey,St Paul's CofE (Aided) Primary School,419,43,12,55
Surrey,St Jude's Church of England Junior School,203,20,10,30
Surrey,Thorpe CofE Aided Primary School,198,35,9,44
Surrey,St James CofE Aided Primary School,216,23,9,32
Surrey,"St Matthew's CofE Aided Infant School, Cobham",63,4,0,4
Surrey,"St Lawrence CofE Aided Junior School, East Molesey",294,54,12,66
Surrey,Long Ditton St Mary's CofE (Aided) Junior School,235,25,7,32
Surrey,Ewhurst CofE Aided Infant School,62,9,1,10
Surrey,St Peter's CofE Primary School,438,53,8,61
Surrey,"St Mary's CofE Aided Infant School, Frensham",91,12,0,12
Surrey,St John's CofE Aided Infant School,85,2,1,3
Surrey,Busbridge CofE Aided Junior School,238,27,9,36
Surrey,St Nicolas CofE Aided Infant School,89,8,1,9
Surrey,St Giles' CofE (Aided) Infant School,65,5,3,8
Surrey,Limpsfield CofE Infant School,163,4,3,7
Surrey,Newdigate CofE Endowed Aided Infant School,71,11,3,14
Surrey,Nutfield Church CofE Primary School,202,8,1,9
Surrey,St Mary's CofE Primary School,631,61,13,74
Surrey,Puttenham CofE Infant School,91,2,1,3
Surrey,Reigate Parish Church Primary  School,418,36,13,49
Surrey,St Peter's CofE Infant School,76,6,1,7
Surrey,All Saints CofE Aided Infant School,88,8,2,10
Surrey,Clandon CofE Aided Primary School,88,19,9,28
Surrey,The Chandler CofE Aided Junior School,313,57,15,72
Surrey,Horsell CofE Aided Junior School,356,41,5,46
Surrey,Wonersh and Shamley Green CofE Aided Primary School,209,21,7,28
Surrey,St Francis Catholic Primary School,401,54,18,72
Surrey,St Joseph's Catholic Primary School,175,16,4,20
Surrey,St Joseph's Catholic Primary School,435,35,9,44
Surrey,"St Cuthbert's Catholic Primary School, Englefield Green",191,9,6,15
Surrey,St Peter's Catholic Primary School,420,22,6,28
Surrey,"St Paul's Catholic Primary School, Thames Ditton",326,17,3,20
Surrey,Send CofE Primary School,398,57,7,64
Surrey,St Anne's Catholic Primary School,403,37,10,47
Surrey,St Clement's Catholic Primary School,218,25,5,30
Surrey,Ashford CofE Primary School,390,52,7,59
Surrey,Laleham CofE VA Primary School,403,51,6,57
Surrey,St Nicholas CofE Primary School,558,66,18,84
Surrey,Littleton CofE Infant School,108,13,0,13
Surrey,"St Joseph's Catholic Primary School, Redhill",626,51,15,66
Surrey,"St Dunstan's Catholic Primary School, Woking",632,63,9,72
Surrey,St Bartholomew's CofE Aided Primary School,400,26,12,38
Surrey,Bramley CofE Aided Infant School and Nursery,119,20,2,22
Surrey,Grayswood Church of England (Aided) Primary School,182,11,4,15
Surrey,Shere CofE Aided Infant School,73,29,2,31
Surrey,Glebelands School,770,149,22,171
Surrey,Ash Manor School,1102,163,18,181
Surrey,Oakwood School,1516,302,23,325
Surrey,St Andrew's Catholic School,1518,59,27,86
Surrey,St Bede's School,1922,27,41,68
Surrey,Royal Alexandra and Albert School,1097,112,35,147
Surrey,The Priory CofE Voluntary Aided School,645,137,34,171
Surrey,Hawkedale Primary School,211,14,8,22
Surrey,"Holy Trinity, Guildford, CofE Aided Junior School",381,36,6,42
Surrey,Yattendon School,382,49,9,58
Surrey,Burstow Primary School,437,51,7,58
Surrey,Park Mead Primary,417,56,21,77
Surrey,Tadworth Primary School,407,40,15,55
Surrey,Wallace Fields Junior School,272,37,7,44
Surrey,Burpham Foundation Primary School,431,49,20,69
Surrey,The Winston Churchill School A Specialist Sports College,1504,144,20,164
Surrey,All Hallows Catholic School,1412,170,23,193
Surrey,Aberdour Preparatory School,337,55,3,58
Surrey,Banstead Preparatory School,244,75,3,78
Surrey,St Catherine's School,849,142,2,144
Surrey,Reeds School,797,189,4,193
Surrey,Prior's Field School,421,154,0,154
Surrey,Cranleigh School,1016,364,2,366
Surrey,Parkside School,265,38,0,38
Surrey,Bishopsgate School,384,82,0,82
Surrey,Kingswood House School,250,66,34,100
Surrey,St Christopher's School Trust (Epsom) Ltd,164,9,1,10
Surrey,Epsom College,1097,203,2,205
Surrey,Rowan Preparatory School,300,52,3,55
Surrey,Claremont Fan Court School,1098,152,1,153
Surrey,Milbourne Lodge School,278,39,1,40
Surrey,Duke of Kent School,317,54,1,55
Surrey,Edgeborough School,367,63,0,63
Surrey,Frensham Heights School,499,172,0,172
Surrey,Charterhouse,935,193,0,193
Surrey,St Hilary's School,268,46,10,56
Surrey,Guildford High School,1002,102,1,103
Surrey,Rydes Hill Preparatory School,146,16,1,17
Surrey,Tormead School,787,133,1,134
Surrey,Amesbury School,338,63,1,64
Surrey,St Edmunds school Trust Ltd,541,102,5,107
Surrey,The Royal School,315,78,4,82
Surrey,City of London Freemen's School,944,108,1,109
Surrey,Downsend School,661,132,1,133
Surrey,Manor House School,278,49,4,53
Surrey,St John's School,839,254,2,256
Surrey,The Hawthorns School,504,68,1,69
Surrey,Dunottar School,473,137,0,137
Surrey,Micklefield School,235,39,0,39
Surrey,Feltonfleet,497,52,0,52
Surrey,The Danesfield Manor School,142,12,3,15
Surrey,St George's College Weybridge,1038,183,1,184
Surrey,Woodcote House School,83,21,1,22
Surrey,King Edward's School Witley,437,102,0,102
Surrey,Barrow Hills School,235,61,0,61
Surrey,St Andrew's Woking School Trust,316,47,0,47
Surrey,Aldro,229,46,0,46
Surrey,Woldingham School,613,128,0,128
Surrey,Lyndhurst School,110,20,0,20
Surrey,Oakhyrst Grange School,152,7,3,10
Surrey,Shrewsbury House Pre Preparatory School,84,4,0,4
Surrey,Notre Dame School,467,137,2,139
Surrey,Belmont School,191,69,1,70
Surrey,Glenesk School,126,25,1,26
Surrey,Little Downsend Epsom,51,3,0,3
Surrey,Ewell Castle School,694,17,10,27
Surrey,St Ives School,127,4,0,4
Surrey,"Moon Hall School, Reigate",180,79,101,180
Surrey,Hazelwood School,579,41,1,42
Surrey,Lingfield College,930,344,6,350
Surrey,Box Hill School,404,1,0,1
Surrey,Danes Hill School,704,68,0,68
Surrey,Ripley Court School,175,54,1,55
Surrey,Barfield Prep School,274,49,1,50
Surrey,Longacre School,269,46,1,47
Surrey,Chinthurst School,282,80,1,81
Surrey,Hoe Bridge School,474,56,6,62
Surrey,Greenfield School,345,51,3,54
Surrey,Halstead Preparatory School,167,11,0,11
Surrey,St Teresa's School,644,150,1,151
Surrey,More House School,474,159,315,474
Surrey,St Johns Beaumont,214,22,2,24
Surrey,Little Downsend Leatherhead,108,8,1,9
Surrey,Copthorne Preparatory School,265,69,0,69
Surrey,Hall Grove School,415,55,0,55
Surrey,Halliford School,449,162,3,165
Surrey,Staines Preparatory School,305,34,3,37
Surrey,Cranmore,502,80,0,80
Surrey,Essendene Lodge School,112,14,0,14
Surrey,ACS Cobham International School,1292,238,5,243
Surrey,Reigate Grammar School,1489,217,1,218
Surrey,T A S I S,654,120,0,120
Surrey,Royal Grammar School Guildford,1313,156,0,156
Surrey,Sir William Perkins's School,573,70,1,71
Surrey,Caterham School,999,228,0,228
Surrey,The Yehudi Menuhin School,87,3,0,3
Surrey,Coworth-Flexlands School,116,41,1,42
Surrey,Little Downsend Ashtead,65,3,1,4
Surrey,Warlingham Park School,102,11,5,16
Surrey,Knowl Hill School,62,1,61,62
Surrey,Weston Green Preparatory School,193,21,2,23
Surrey,Hurtwood House School,355,110,1,111
Surrey,St George's Junior School,627,98,2,100
Surrey,Caterham Prep,276,33,0,33
Surrey,Notre Dame Preparatory School,239,43,0,43
Surrey,Gosden House School,125,0,125,125
Surrey,St Piers School,62,0,62,62
Surrey,Moor House School & College,208,3,205,208
Surrey,St Joseph's Specialist Trust,73,0,73,73
Surrey,Sunnydown School,87,0,87,87
Surrey,Limpsfield Grange School,94,0,94,94
Surrey,Walton Leigh School,87,0,87,87
Surrey,Woodlands School,106,8,98,106
Surrey,Clifton Hill School,80,0,80,80
Surrey,Brooklands School - Split Site,166,4,162,166
Surrey,Manor Mead School,148,8,140,148
Surrey,Portesbery School,124,4,120,124
Surrey,Freemantles School,218,0,218,218
Surrey,Meath School,76,1,75,76
Surrey,Philip Southcote School,201,0,201,201
Surrey,Woodfield School,158,0,158,158
Warwickshire,Atherstone Nursery School,63,19,0,19
Warwickshire,Bedworth Heath Nursery School,71,16,1,17
Warwickshire,Whitnash Nursery School,72,11,3,14
Warwickshire,Kenilworth Nursery School & Early Years Training Centre,59,17,0,17
Warwickshire,Warwick Nursery School,71,5,4,9
Warwickshire,Stockingford Maintained Nursery School,65,9,1,10
Warwickshire,Nursery Hill Primary School,109,33,2,35
Warwickshire,Claverdon Primary School,202,23,1,24
Warwickshire,Wheelwright Lane Primary School,216,21,2,23
Warwickshire,Great Alne Primary School,70,12,2,14
Warwickshire,Michael Drayton Junior School,580,79,10,89
Warwickshire,Nathaniel Newton Infant School,270,19,3,22
Warwickshire,Hurley Primary School,198,61,2,63
Warwickshire,Quinton Primary School,222,53,5,58
Warwickshire,Snitterfield Primary School,98,26,3,29
Warwickshire,Thomas Jolyffe Primary School,380,34,6,40
Warwickshire,Bridgetown Primary School,416,30,8,38
Warwickshire,Welford-on-Avon Primary School,260,28,6,34
Warwickshire,Lighthorne Heath Primary School,77,29,5,34
Warwickshire,Chilvers Coton Community Infant School,231,14,8,22
Warwickshire,Galley Common Infant School,167,14,0,14
Warwickshire,Whitestone Infant School,268,32,4,36
Warwickshire,Thorns Community Infant School,152,9,1,10
Warwickshire,Clinton Primary School,217,19,3,22
Warwickshire,Park Hill Junior School,260,25,7,32
Warwickshire,Clapham Terrace Community Primary School and Nursery,224,18,6,24
Warwickshire,Telford Junior School,357,35,2,37
Warwickshire,Westgate Primary School,189,40,6,46
Warwickshire,Whitnash Primary School,361,59,11,70
Warwickshire,Newburgh Primary School,367,59,7,66
Warwickshire,Telford Infant School,261,16,2,18
Warwickshire,Briar Hill Infant School,267,26,8,34
Warwickshire,Brookhurst Primary School,412,16,2,18
Warwickshire,Emscote Infant School,175,39,9,48
Warwickshire,Long Lawford Primary School,542,52,5,57
Warwickshire,Abbots Farm Infant School,179,18,1,19
Warwickshire,Eastlands Primary School,209,15,6,21
Warwickshire,Northlands Primary School,208,24,7,31
Warwickshire,Bilton Infant School,166,5,6,11
Warwickshire,Abbots Farm Junior School,263,28,12,40
Warwickshire,Bawnmore Community Infant School,167,23,4,27
Warwickshire,High Meadow Community School,207,22,5,27
Warwickshire,Exhall Junior School,162,34,5,39
Warwickshire,Chetwynd Junior School,361,70,5,75
Warwickshire,Glendale Infant School,269,45,4,49
Warwickshire,Boughton Leigh Junior School,478,75,7,82
Warwickshire,Boughton Leigh Infant School,250,21,3,24
Warwickshire,Croft Junior School,333,74,4,78
Warwickshire,Bishopton Primary School,241,29,5,34
Warwickshire,Priors Field Primary School,211,23,7,30
Warwickshire,Milverton Primary School,324,17,8,25
Warwickshire,Race Leys Infant School,143,45,6,51
Warwickshire,Brownsover Community Infant School,196,21,3,24
Warwickshire,Water Orton Primary School,323,28,14,42
Warwickshire,Alveston CofE Primary School,211,33,3,36
Warwickshire,Bidford-on-Avon CofE Primary School,315,43,3,46
Warwickshire,Ettington CofE Primary School,198,14,9,23
Warwickshire,Hampton Lucy CofE Primary School,88,24,3,27
Warwickshire,Ilmington CofE Primary School,117,18,0,18
Warwickshire,Loxley CofE Community Primary School,40,9,0,9
Warwickshire,Mappleborough Green CofE Primary School,116,7,3,10
Warwickshire,Shottery St Andrew's CofE Primary School,84,20,0,20
Warwickshire,"All Saints CofE Primary School and Nursery, Nuneaton",245,64,9,73
Warwickshire,Abbey CofE Infant School,205,14,7,21
Warwickshire,"St Paul's CofE Primary School, Nuneaton",433,52,9,61
Warwickshire,Bishops Tachbrook CofE Primary School,210,19,2,21
Warwickshire,Cubbington CofE Primary School,204,16,6,22
Warwickshire,St Nicholas CofE Primary School,420,38,3,41
Warwickshire,Lapworth CofE Primary School,170,14,3,17
Warwickshire,Radford Semele CofE Primary School,209,13,4,17
Warwickshire,All Saints' CofE Junior School,208,47,7,54
Warwickshire,St. Margaret's CofE Junior School,358,64,11,75
Warwickshire,Clifton-upon-Dunsmore CofE Primary School,226,31,2,33
Warwickshire,Wolston St Margaret's CofE Primary School,219,27,3,30
Warwickshire,Wolvey CofE Primary School,182,25,4,29
Warwickshire,Holy Trinity CofE Primary School,405,38,7,45
Warwickshire,Bilton CofE Junior School,420,85,11,96
Warwickshire,Shustoke CofE Primary School,200,39,1,40
Warwickshire,The Canons C of E Primary School,624,53,5,58
Warwickshire,Moreton Morrell CofE Primary School,96,15,2,17
Warwickshire,Wilmcote CofE (Voluntary Aided) Primary School,73,11,0,11
Warwickshire,"St Paul's CofE Primary School, Leamington Spa",331,36,9,45
Warwickshire,Dunchurch Boughton CofE (Voluntary Aided) Junior School,257,28,6,34
Warwickshire,"St Mary's Catholic Primary School, Southam",155,25,1,26
Warwickshire,St Peter's Catholic Primary School,103,5,1,6
Warwickshire,St Patrick's Catholic Primary School,201,38,2,40
Warwickshire,St Anthony's Catholic Primary School,219,42,4,46
Warwickshire,St Mary Immaculate Catholic Primary School,120,12,1,13
Warwickshire,St Joseph's Catholic Primary School,205,25,2,27
Warwickshire,"Our Lady's Catholic Primary School, Princethorpe",108,8,1,9
Warwickshire,Barford St Peter's CofE Primary School,211,23,2,25
Warwickshire,Wolverton Primary School,82,9,1,10
Warwickshire,Middlemarch School,194,24,11,35
Warwickshire,Dunnington CofE Primary School,100,14,1,15
Warwickshire,Dunchurch Infant School,179,17,2,19
Warwickshire,The Avon Valley School and Performing Arts College,1096,158,23,181
Warwickshire,Crackley Hall School,317,50,5,55
Warwickshire,Bilton Grange School,380,53,2,55
Warwickshire,Arnold Lodge School,409,29,5,34
Warwickshire,The Kingsley School,303,47,2,49
Warwickshire,Rugby School,862,106,0,106
Warwickshire,The Croft Preparatory School,374,40,2,42
Warwickshire,Warwick Preparatory School,494,39,1,40
Warwickshire,Warwick School,1243,83,2,85
Warwickshire,Crescent School,184,17,0,17
Warwickshire,Princethorpe College,924,258,2,260
Warwickshire,King's High School,794,118,0,118
Warwickshire,Arc School Old Arley,62,0,62,62
Warwickshire,Stratford Preparatory School,62,6,0,6
Warwickshire,Exhall Grange Specialist School,253,0,253,253
Warwickshire,Evergreen School,278,0,278,278
West Sussex,Bognor Regis Nursery School,144,39,1,40
West Sussex,Chichester Nursery School,112,30,2,32
West Sussex,Horsham Nursery School,149,19,2,21
West Sussex,Boundstone Nursery School,121,34,0,34
Cheshire East,Aidenswood,3,0,0,0
West Sussex,Aldingbourne Primary School,213,22,2,24
West Sussex,Bosham Primary School,199,19,4,23
West Sussex,Shelley Primary School,409,38,6,44
West Sussex,Camelsdale Primary School,214,35,2,37
West Sussex,Colgate Primary School,139,10,1,11
West Sussex,West Green Primary School,202,25,5,30
West Sussex,East Wittering Community Primary School,294,44,4,48
West Sussex,Funtington Primary School,96,19,2,21
West Sussex,Hollycombe Primary School,104,16,4,20
West Sussex,Trafalgar Community Infant School,244,23,5,28
West Sussex,"Northolmes Junior School, Horsham",156,25,0,25
West Sussex,Littlehaven Infant School,104,11,0,11
West Sussex,Barns Green Primary School,131,10,3,13
West Sussex,North Lancing Primary School,405,111,11,122
West Sussex,Loxwood Primary School,170,23,5,28
West Sussex,Northchapel Community Primary School,48,7,0,7
West Sussex,North Mundham Primary School,209,15,1,16
West Sussex,Plaistow and Kirdford Primary School,192,13,1,14
West Sussex,Rudgwick Primary School,214,11,3,14
West Sussex,Rusper Primary School,105,9,0,9
West Sussex,Sidlesham Primary School,139,19,3,22
West Sussex,Stedham Primary School,45,8,2,10
West Sussex,Thakeham Primary School,101,13,5,18
West Sussex,Upper Beeding Primary School,327,55,8,63
West Sussex,Westbourne Primary School,204,20,5,25
West Sussex,West Chiltington Community Primary School,201,27,9,36
West Sussex,Wisborough Green Primary School,207,39,2,41
West Sussex,Durrington Infant School,296,40,6,46
West Sussex,"Elm Grove Primary School, Worthing",190,24,5,29
West Sussex,Field Place Infant School,266,63,16,79
West Sussex,"Vale School, Worthing",606,65,7,72
West Sussex,Thorney Island Community Primary School,215,22,2,24
West Sussex,"Bersted Green Primary School, Bognor Regis",290,60,7,67
West Sussex,Storrington Primary School,407,57,9,66
West Sussex,Southbourne Infant School,174,12,2,14
West Sussex,Southbourne Junior School,235,41,4,45
West Sussex,Jessie Younghusband Primary School,211,17,5,22
West Sussex,"Arunside School, Horsham",411,59,5,64
West Sussex,Shoreham Beach Primary School,204,30,6,36
West Sussex,Heron Way Primary School,412,35,1,36
West Sussex,Three Bridges Primary School,679,66,29,95
West Sussex,"Pound Hill Junior School, Crawley",356,68,4,72
West Sussex,Glebe Primary School,520,62,10,72
West Sussex,Swiss Gardens Primary School,410,23,6,29
West Sussex,Leechpool Primary School,418,30,12,42
West Sussex,East Preston Infant School,264,21,5,26
West Sussex,Parklands Community Primary School,426,50,23,73
West Sussex,"Bartons Primary School, Bognor Regis",207,23,2,25
West Sussex,Lyminster Primary School,214,28,10,38
West Sussex,Rose Green Infant School,265,30,6,36
West Sussex,Ashurst Wood Primary School,136,9,3,12
West Sussex,Manor Field Primary School,477,44,4,48
West Sussex,London Meed Community Primary School,400,39,13,52
West Sussex,Handcross Primary School,249,47,3,50
West Sussex,Hassocks Infant School,270,15,2,17
West Sussex,Woodgate Primary School,123,36,9,45
West Sussex,The Windmills Junior School,371,39,5,44
West Sussex,The Gattons Infant School,269,27,1,28
West Sussex,Southway Junior School,349,39,9,48
West Sussex,"Fairway Infant School, Copthorne",173,16,2,18
West Sussex,"Birchwood Grove Community Primary School, Burgess Hill",415,43,10,53
West Sussex,Estcots Primary School,419,51,2,53
West Sussex,North Heath Community Primary School,408,44,4,48
West Sussex,"Hawthorns Primary School, Durrington",149,26,11,37
West Sussex,Durrington Junior School,303,71,27,98
West Sussex,Thomas A Becket Infant School,526,42,7,49
West Sussex,Thomas A Becket Junior School,716,89,15,104
West Sussex,Sheddingdean Community Primary School,196,17,4,21
West Sussex,Georgian Gardens Community Primary School,411,59,14,73
West Sussex,Lyndhurst Infant School,252,50,10,60
West Sussex,Chesswood Junior School,560,162,18,180
West Sussex,Maidenbower Infant School,240,33,2,35
West Sussex,The Meads Primary School,317,33,8,41
West Sussex,Holbrook Primary School,412,30,5,35
West Sussex,Springfield Infant School and Nursery,176,31,5,36
West Sussex,Bramber Primary School,195,38,9,47
West Sussex,Amberley CofE Primary School,53,7,2,9
West Sussex,Ashington CofE Primary School,193,31,8,39
West Sussex,Birdham CE Primary School,123,14,2,16
West Sussex,South Bersted CofE Primary School,202,28,6,34
West Sussex,Boxgrove CofE Primary School,69,14,1,15
West Sussex,Chidham Parochial Primary School,191,38,6,44
West Sussex,"St James' CofE Primary School, Coldwaltham",78,15,2,17
West Sussex,Compton and Up Marden CofE Primary School,70,14,1,15
West Sussex,Duncton CofE Junior School,59,6,1,7
West Sussex,Eastergate CofE Primary School,205,31,3,34
West Sussex,Ferring C of E Primary School,185,24,2,26
West Sussex,Fishbourne CofE Primary School,210,29,5,34
West Sussex,Fittleworth CofE Village School,127,5,4,9
West Sussex,Jolesfield CofE Primary School,148,18,1,19
West Sussex,Lavant CofE Primary School,112,14,3,17
West Sussex,"Holy Trinity CofE Primary School, Lower Beeding",83,5,0,5
West Sussex,Midhurst CofE Primary School,194,19,3,22
West Sussex,Rake CofE Primary School,96,16,1,17
West Sussex,Petworth Cof E Primary School,169,20,5,25
West Sussex,Rogate CofE Primary School,66,12,1,13
West Sussex,Shipley CofE Primary School,78,8,0,8
West Sussex,Singleton CofE Primary School,64,10,2,12
West Sussex,Slindon CofE Primary School,80,13,1,14
West Sussex,Slinfold CofE Primary School,127,21,4,25
West Sussex,Steyning CofE Primary School,387,50,20,70
West Sussex,Walberton and Binsted CofE Primary School,211,22,2,24
West Sussex,Warnham CofE Primary School,206,33,3,36
West Sussex,St Mary's CofE Primary School,96,16,2,18
West Sussex,West Wittering Parochial Church of England School,102,17,0,17
West Sussex,Yapton CE Primary School,298,27,10,37
West Sussex,William Penn School,99,18,2,20
West Sussex,Easebourne CofE Primary School,226,39,5,44
West Sussex,West Dean CofE Primary School,100,16,2,18
West Sussex,St Peter's CofE Primary School,96,16,2,18
West Sussex,Balcombe CofE Controlled Primary School,137,17,4,21
West Sussex,Bolney CofE Primary School,101,17,1,18
West Sussex,St Augustine's CofE Primary School,96,15,0,15
West Sussex,Turners Hill CofE Primary School,142,21,3,24
West Sussex,Twineham CofE Primary School,68,17,4,21
West Sussex,West Hoathly CofE Primary School,134,18,0,18
West Sussex,Copthorne CofE Junior School,211,26,4,30
West Sussex,St. Mark's CofE Primary School,105,20,7,27
West Sussex,West Park CofE Primary (Controlled) School,820,96,22,118
West Sussex,Harting CofE Primary School,117,20,2,22
West Sussex,St Margaret's CofE Primary School,401,38,5,43
West Sussex,Arundel CofE Primary School,204,20,5,25
West Sussex,Ashurst CofE Primary School,51,6,0,6
West Sussex,Nyewood CofE Junior School,311,45,6,51
West Sussex,Bury CofE Primary School,74,15,1,16
West Sussex,St Mary's CofE Primary School,92,11,1,12
West Sussex,St Peter's CofE (Aided) Primary School,118,11,1,12
West Sussex,St John the Baptist CofE Primary School,135,19,8,27
West Sussex,St Peter's CofE Primary School,385,47,15,62
West Sussex,St Mary's CofE (Aided) Primary School,204,29,5,34
West Sussex,St Andrew's CofE Primary School,138,31,1,32
West Sussex,Broadwater CofE Primary School,430,35,9,44
West Sussex,Heene CofE Primary School,395,41,8,49
West Sussex,"St Philip's Catholic Primary School, Arundel",202,16,4,20
West Sussex,St Mary's Catholic Primary School,314,39,10,49
West Sussex,St Richard's Catholic Primary School,322,49,6,55
West Sussex,St John's Catholic Primary School,202,16,3,19
West Sussex,"St Catherine's Catholic Primary School, Littlehampton",232,26,5,31
West Sussex,St Margaret's CofE Primary School,408,49,14,63
West Sussex,Goring-By-Sea CofE (Aided) Primary School,424,41,15,56
West Sussex,"St Francis of Assisi Catholic Primary School, Crawley",422,51,7,58
West Sussex,St Andrew's CofE Primary School,210,15,10,25
West Sussex,St Mary's Church of England Primary School,310,49,3,52
West Sussex,"Bishop Tufnell CofE Primary School, Felpham",419,49,8,57
West Sussex,"English Martyrs Catholic Primary School, Worthing",161,27,6,33
West Sussex,"Nyewood CofE Infant School, Bognor Regis",220,31,4,35
West Sussex,"St Robert Southwell Catholic Primary School, Horsham",199,28,7,35
West Sussex,"Holy Trinity CofE Primary School, Cuckfield",417,69,7,76
West Sussex,"St Mary's CofE Primary School, East Grinstead",201,28,5,33
West Sussex,St Giles CofE Primary School,113,15,0,15
West Sussex,St Peter's Catholic Primary School,204,44,3,47
West Sussex,"St Wilfrid's Catholic Primary School, Burgess Hill",418,55,10,65
West Sussex,Tanbridge House School,1525,253,30,283
West Sussex,The Forest School,1023,187,21,208
West Sussex,Millais School,1347,311,14,325
West Sussex,"Weald School, The",1736,408,26,434
West Sussex,Bourne Community College,756,132,31,163
West Sussex,Ifield Community College,1202,190,14,204
West Sussex,Felpham Community College,1512,216,12,228
West Sussex,The Angmering School,1345,140,68,208
West Sussex,Oathall Community College,1185,208,21,229
West Sussex,Downlands Community School,1225,170,19,189
West Sussex,Imberhorne School,1624,415,39,454
West Sussex,Sackville School,1719,342,36,378
West Sussex,"Davison Church of England High School for Girls, Worthing",1295,153,36,189
West Sussex,St Andrew's CofE High School,650,158,21,179
West Sussex,"St Wilfrid's Catholic Comprehensive School, Crawley",1061,156,34,190
West Sussex,St Oscar Romero Catholic School,923,170,33,203
West Sussex,"Holy Trinity CofE Secondary School, Crawley",1320,262,16,278
West Sussex,Oakwood School,306,52,0,52
West Sussex,Westbourne House School,385,156,2,158
West Sussex,Cottesmore School,196,30,0,30
West Sussex,Christ's Hospital,836,151,0,151
West Sussex,Lancing College,600,98,0,98
West Sussex,Dorset House School,137,56,1,57
West Sussex,Seaford College,950,433,0,433
West Sussex,Pennthorpe School,248,66,2,68
West Sussex,Shoreham College,378,80,1,81
West Sussex,Windlesham House School,328,56,1,57
West Sussex,Lancing College Preparatory School at Worthing,202,23,0,23
West Sussex,Our Lady of Sion School,380,50,3,53
West Sussex,Conifers School,81,13,1,14
West Sussex,Slindon College,95,32,63,95
West Sussex,Sompting Abbotts School,110,6,0,6
West Sussex,The Prebendal School,94,0,2,2
West Sussex,Farlington School,340,96,1,97
West Sussex,Great Ballard School,168,36,8,44
West Sussex,Rikkyo School-in-England,196,0,0,0
West Sussex,Ardingly College,1072,124,0,124
West Sussex,Burgess Hill Girls,566,70,1,71
West Sussex,Great Walstead School,337,92,0,92
West Sussex,Hurstpierpoint College,1321,357,0,357
West Sussex,Worth School,660,211,1,212
West Sussex,Farney Close School,60,0,60,60
West Sussex,Philpots Manor School,38,0,38,38
West Sussex,Handcross Park School,392,40,0,40
West Sussex,Central Education Ltd,16,0,16,16
West Sussex,Brambletye School,294,49,2,51
West Sussex,Highfield and Brookham Schools,469,56,8,64
West Sussex,Muntham House School,118,0,118,118
West Sussex,St Anthony's School,235,0,235,235
West Sussex,Manor Green College,213,0,213,213
West Sussex,Palatine Primary School,190,1,189,190
West Sussex,"Queen Elizabeth II Silver Jubilee School, Horsham",126,1,125,126
West Sussex,Oak Grove College,275,0,275,275
West Sussex,Manor Green Primary School,217,0,217,217
West Sussex,"Fordwater School, Chichester",152,0,152,152
West Sussex,Herons Dale School,140,0,140,140
West Sussex,"Cornfield School, Littlehampton",68,0,68,68
Swindon,EOTAS Swindon,63,51,10,61
Wiltshire,Bratton Primary School,139,18,2,20
Wiltshire,St Paul's Primary School,152,43,5,48
Swindon,Chiseldon Primary & Nursery School,204,42,1,43
Wiltshire,Neston Primary School,197,24,11,35
Wiltshire,Monkton Park Primary School,262,40,3,43
Wiltshire,Gomeldon Primary School,138,22,2,24
Wiltshire,Hilmarton Primary School,103,34,5,39
Wiltshire,Horningsham Primary School,73,14,0,14
Wiltshire,Luckington Community School,47,5,1,6
Wiltshire,Stanton St Quintin Primary and Nursery School,85,20,1,21
Wiltshire,Ramsbury Primary School,196,26,1,27
Wiltshire,Harnham Infants' School,229,37,8,45
Swindon,Beechcroft Infant School,238,27,11,38
Swindon,Even Swindon Primary School,663,95,24,119
Swindon,Lainesmead Primary School and Nursery,419,45,7,52
Swindon,Wanborough Primary School,205,14,1,15
Wiltshire,Westbury Infant School,208,30,21,51
Wiltshire,Wootton Bassett Infants' School,134,21,3,24
Swindon,Lawn Primary and Nursery School,482,61,13,74
Wiltshire,Kiwi Primary School,358,48,23,71
Swindon,Colebrook Junior School,196,38,3,41
Swindon,Westrop Primary & Nursery School,375,56,18,74
Wiltshire,Priestley Primary School,284,38,9,47
Wiltshire,The Grove Primary School,382,51,14,65
Wiltshire,Princecroft Primary School,218,23,5,28
Wiltshire,Redland Primary School,294,42,3,45
Wiltshire,Longleaze Primary School,255,36,7,43
Wiltshire,Mere School,214,33,6,39
Wiltshire,Woodlands Primary School,206,64,4,68
Wiltshire,"Salisbury, Manor Fields Primary School",219,28,27,55
Wiltshire,Holbrook Primary School,225,46,4,50
Wiltshire,Kings Lodge Primary School,289,39,7,46
Wiltshire,Walwayne Court School,258,47,12,59
Wiltshire,Bitham Brook Primary School,396,42,8,50
Wiltshire,Charter Primary School,215,23,23,46
Wiltshire,Newtown Community Primary School,179,26,3,29
Swindon,Haydonleigh Primary School,596,59,6,65
Wiltshire,Ashton Keynes Church of England Primary School,216,31,4,35
Swindon,Bishopstone Church of England Primary School,43,8,0,8
Wiltshire,Box Church of England Primary School,162,15,0,15
Wiltshire,Christ Church Church of England Controlled Primary School,435,37,6,43
Wiltshire,Longford CofE (VC) Primary School,65,12,0,12
Wiltshire,Broad Hinton Church of England Primary School,90,14,2,16
Wiltshire,Broad Town Church of England Primary School,56,17,2,19
Wiltshire,"St Nicholas Church of England VC Primary School, Bromham",78,29,4,33
Wiltshire,Cherhill CofE School,205,29,7,36
Wiltshire,Colerne CofE Primary School,243,37,5,42
Wiltshire,St Sampson's Church of England Primary School,306,59,5,64
Wiltshire,Crockerton CofE Primary School,101,15,1,16
Wiltshire,Crudwell CofE Primary School,131,22,1,23
Wiltshire,Collingbourne Church of England Primary School,95,13,2,15
Wiltshire,Durrington Church of England Controlled Junior School,179,34,7,41
Wiltshire,Heddington Church of England Primary School,75,9,5,14
Wiltshire,Hilperton Church of England Voluntary Controlled Primary School,149,24,3,27
Wiltshire,Holt Voluntary Controlled Primary School,152,30,5,35
Wiltshire,Hullavington CofE Primary and Nursery School,164,14,2,16
Wiltshire,Kington St Michael Church of England Primary School,140,14,4,18
Wiltshire,Lacock Church of England Primary School,67,7,1,8
Wiltshire,Langley Fitzurse Church of England Primary School,98,23,3,26
Wiltshire,Lea and Garsdon Church of England Primary School,120,20,2,22
Wiltshire,Newton Tony Church of England Voluntary Controlled School,87,9,0,9
Wiltshire,North Bradley CofE Primary School,191,30,9,39
Wiltshire,Oaksey CofE Primary School,89,16,3,19
Wiltshire,Preshute Church of England Primary School,185,14,4,18
Wiltshire,"St Mary's Church of England Primary School, Purton",330,48,10,58
Wiltshire,Harnham Church of England Controlled Junior School,306,65,7,72
Wiltshire,Shalbourne CofE Primary School,30,10,0,10
Wiltshire,Sherston CofE Primary School,114,12,4,16
Wiltshire,Southwick Church of England Primary School,183,33,3,36
Wiltshire,Staverton Church of England Voluntary Controlled Primary School,258,30,4,34
Wiltshire,Stratford-sub-Castle Church of England Voluntary Controlled Primary School,146,22,6,28
Wiltshire,Sutton Veny CofE School,163,16,1,17
Wiltshire,Urchfont Church of England Primary School,93,8,2,10
Wiltshire,The Minster CofE Primary School,210,18,1,19
Wiltshire,Westbury Church of England Junior School,258,54,25,79
Wiltshire,Westbury Leigh CofE Primary School,293,35,11,46
Wiltshire,Winterbourne Earls Church of England Primary School,195,21,3,24
Wiltshire,Sambourne Church of England Voluntary Controlled Primary School,111,17,3,20
Wiltshire,Minety Church of England Primary School,130,18,1,19
Wiltshire,"St Barnabas Church of England School, Market Lavington",117,11,1,12
Wiltshire,Coombe Bissett Church of England Primary School,113,11,2,13
Wiltshire,Dinton CofE Primary School,82,11,2,13
Wiltshire,"St John's Church of England Primary School, Tisbury",118,25,4,29
Wiltshire,Brinkworth Earl Danby's Church of England Primary,154,21,0,21
Wiltshire,St Michael's CofE Aided Primary,199,22,6,28
Wiltshire,Baydon St Nicholas Church of England Primary School,101,18,2,20
Wiltshire,Chapmanslade Church of England Voluntary Aided Primary School,99,9,1,10
Wiltshire,Chilton Foliat Church of England Primary School,101,13,0,13
Wiltshire,Derry Hill Church of England Voluntary Aided Primary School,208,28,3,31
Wiltshire,"St Nicholas Church of England Primary School, Porton",143,32,1,33
Wiltshire,"St Andrew's Church of England Voluntary Aided Primary School, Laverstock",202,21,7,28
Wiltshire,Sarum St Paul's CofE (VA) Primary School,218,19,7,26
Wiltshire,St Martin's CofE Voluntary Aided Primary School,156,21,3,24
Wiltshire,Whiteparish All Saints Church of England Primary School,87,19,2,21
Wiltshire,"Christ The King Catholic School, Amesbury",114,22,18,40
Wiltshire,"St Joseph's Catholic Primary School, Malmesbury",128,29,0,29
Wiltshire,"St Osmund's Catholic Primary School, Salisbury",205,28,6,34
Wiltshire,"St John's Catholic Primary School, Trowbridge",308,24,8,32
Wiltshire,Wardour Catholic Primary School,86,15,1,16
Wiltshire,"St Patrick's Catholic Primary School, Corsham",184,42,4,46
Wiltshire,Broad Chalke CofE Primary School,200,17,4,21
Wiltshire,Chilmark and Fonthill Bishop Church of England Aided Primary School,59,4,4,8
Wiltshire,Semley Church of England Voluntary Aided Primary School,119,16,0,16
Swindon,Oliver Tomkins Church of England Junior School,201,35,1,36
Swindon,Oliver Tomkins Church of England Infant and Nursery School,177,10,0,10
Wiltshire,"Hindon Church of England Voluntary Aided Primary School, St Mary's and St John's",61,11,1,12
Wiltshire,Alderbury and West Grimstead Church of England Primary School,151,19,5,24
Wiltshire,Kennet Valley Church of England Aided Primary School,75,8,0,8
Wiltshire,The Stonehenge School,1019,207,31,238
Wiltshire,St Joseph's Catholic School,594,132,24,156
Wiltshire,Downton CofE VA Primary School,268,34,4,38
Wiltshire,Frogwell Primary School,199,32,32,64
Wiltshire,Studley Green Primary School,207,43,42,85
Wiltshire,"St George's Catholic Primary School, Warminster",142,24,4,28
Wiltshire,St Mary's Catholic Primary School,169,15,4,19
Wiltshire,Paxcroft Primary School,295,68,6,74
Wiltshire,Ludgershall Castle Primary School,284,44,7,51
Wiltshire,Clarendon Junior School (Clarendon Federation),289,45,7,52
Wiltshire,Clarendon Infants' School,242,67,14,81
Wiltshire,Matravers School,890,81,20,101
Wiltshire,Stonar School,407,92,3,95
Wiltshire,St Mary's School (Snr) and St Margaret's School (Prep),524,69,0,69
Wiltshire,Marlborough College,1010,165,0,165
Wiltshire,Chafyn Grove School,204,43,3,46
Wiltshire,Salisbury Cathedral School,220,35,1,36
Wiltshire,Godolphin School,428,138,4,142
Wiltshire,Sandroyd School,223,49,0,49
Wiltshire,Warminster School,556,96,4,100
Wiltshire,Avondale Preparatory School,96,8,4,12
Wiltshire,Heywood Prep,254,58,0,58
Wiltshire,St Francis School,209,25,1,26
Wiltshire,Leehurst Swan School,182,40,4,44
Wiltshire,Dauntsey's School,873,228,0,228
Wiltshire,Cricklade Manor Prep,230,15,0,15
Wiltshire,Appleford School,156,0,127,127
Swindon,Maranatha Christian School,77,7,1,8
Wiltshire,Calder House School,35,23,12,35
Swindon,Crowdys Hill School,265,0,265,265
Wiltshire,Downland School,97,0,97,97
Lincolnshire,"The Kingsdown Nursery School, Lincoln",80,9,0,9
Lincolnshire,The Gainsborough Nursery School,99,0,0,0
Lincolnshire,Boston Nursery School,51,13,1,14
Milton Keynes,Moorlands Centre Nursery School,34,7,0,7
Redbridge,Apex Primary School,118,4,0,4
Sheffield,Heritage Park School,96,0,96,96
Sheffield,Holgate Meadows School,95,1,94,95
Dorset,Holy Trinity Church of England VC Primary School & Community Nursery,519,114,14,128
Suffolk,On Track Education Centre (Mildenhall),27,0,27,27
Redbridge,Redbridge Primary School,877,74,22,96
Dorset,St George's Community Primary School,427,114,11,125
Wirral,The Observatory School,116,1,115,116
Manchester,Ashgate Specialist Support Primary School,150,0,150,150
"Herefordshire, County of",Riverside Primary School,633,97,10,107
Leicestershire,Oakwood Community School,45,1,42,43
Wokingham,CAMHS Phoenix School,0,0,0,0
Cornwall,Three Bridges,14,0,14,14
Solihull,Grace Academy Solihull,899,201,22,223
Salford,Primrose Hill Primary School and Children's Centre,456,85,8,93
Norfolk,Norwich Steiner School,105,40,2,42
St. Helens,Learn 4 Life School,4,2,2,4
Leicester,Madani Girls' School,391,20,3,23
Hampshire,Wellstead Primary School,413,44,9,53
County Durham,Seaview Primary School,288,91,8,99
Brent,Wembley Primary School,868,104,29,133
Hammersmith and Fulham,Thomas's Fulham,425,63,0,63
Islington,The Children's House Upper School,109,4,0,4
Birmingham,Al-Ameen Primary School,161,6,0,6
Reading,John Madejski Academy,891,135,21,156
Milton Keynes,Drayton Park School,333,38,3,41
Nottinghamshire,Forest Town Primary School,395,46,0,46
Stockton-on-Tees,Ingleby Mill Primary School,528,36,7,43
South Gloucestershire,Bowsland Green Primary School,227,35,8,43
St. Helens,Broad Oak Community Primary School,642,120,6,126
Lancashire,Longsands Community Primary School,208,6,5,11
Lancashire,Mossgate Primary School,207,49,5,54
Cheshire West and Chester,Rivacre Valley Primary School,295,70,9,79
Leeds,New Horizon Community School,40,0,0,0
Hampshire,Kingscourt School,136,6,2,8
Lincolnshire,Bicker Preparatory School and Early Years,26,7,0,7
Bolton,Al Jamiah Al Islamiyyah,172,0,0,0
Salford,Beis Ruchel Girls School,264,29,1,30
Liverpool,Dovecot Primary School,191,39,2,41
Hackney,Rushmore Primary School,461,76,24,100
Hackney,Gayhurst Community School,546,79,18,97
Wolverhampton,Bilston Church of England Primary School,437,70,8,78
County Durham,Finchale Primary School,214,16,3,19
Dorset,Dorchester Learning Centre,38,6,31,37
Manchester,Manchester Islamic Grammar School for Girls,224,21,0,21
Walsall,Emmanuel School,54,10,0,10
Wirral,Heygarth Primary School,408,48,15,63
Hampshire,Mill Hill Primary School,196,35,6,41
Bury,St Stephen's Church of England Primary School,226,38,10,48
Buckinghamshire,The Stoke Poges School,431,21,10,31
Lancashire,Fleetwood Flakefleet Primary School,483,58,11,69
Barking and Dagenham,Monteagle Primary School,670,81,44,125
Camden,Christopher Hatton Primary School,218,50,6,56
Waltham Forest,Ainslie Wood Primary School,454,74,14,88
Hertfordshire,North Herts Education Support Centre,2,2,0,2
Hertfordshire,Chessbrook Education Support Centre,7,4,3,7
Kirklees,Heckmondwike Primary School,464,47,7,54
Tower Hamlets,Arnhem Wharf Primary School,610,93,29,122
Leicester,Oaklands School,103,1,102,103
Barking and Dagenham,Richard Alibon Primary School with ARP for Cognitive and Learning Difficulties : SEN Base,574,70,32,102
Haringey,Alexandra Primary School,403,63,9,72
Hertfordshire,Stevenage Education Support Centre,8,8,0,8
Hertfordshire,Southfield School,85,0,85,85
Cumbria,Appletree School,14,1,13,14
Leicester,Ellesmere College,418,0,414,414
Slough,Penn Wood Primary and Nursery School,694,130,19,149
Wakefield,Shay Lane Primary (J and I) School,215,24,4,28
Stockton-on-Tees,Mandale Mill Primary School,378,29,3,32
Warwickshire,The Dassett CofE Primary School,104,10,2,12
Manchester,Birchfields Primary School,664,62,19,81
Newham,Sandringham Primary School,993,108,24,132
St. Helens,Queen's Park CofE/Urc Primary School,393,32,13,45
Wigan,St Jude's Catholic Primary School Wigan,178,64,8,72
Wiltshire,"Churchfields, the Village School",121,14,0,14
Liverpool,Lawrence Community Primary School,442,59,9,68
Salford,Ellenbrook Community Primary School,436,44,6,50
Wandsworth,Thomas's Clapham,652,126,1,127
Barnet,Tashbar of Edgware,213,36,5,41
Suffolk,Acorn Cottage The Lodge,1,1,0,1
Suffolk,Gable End,6,5,1,6
Lewisham,Abbey Manor College,75,33,0,33
Bradford,Crystal Gardens Primary School,137,2,0,2
Wakefield,Northfield Primary School: With Communication Resource,368,41,35,76
Hampshire,Bushy Leaze Early Years Centre,87,29,0,29
Wakefield,Upton Primary School,457,67,16,83
Wakefield,Moorthorpe Primary (J and I ) School,284,37,15,52
Wakefield,South Kirkby Common Road Infant and Nursery School,201,10,3,13
Wakefield,South Elmsall Carlton Junior and Infant School,436,85,8,93
Warwickshire,Coten End Primary School,651,35,6,41
Warwickshire,Sydenham Primary School,412,130,6,136
Warwickshire,St John's Primary School,246,37,9,46
Warwickshire,Provost Williams CofE Primary School,162,30,5,35
Warwickshire,St Andrew's Benn CofE (Voluntary Aided) Primary School,336,58,4,62
Warwickshire,The Revel CofE (Aided) Primary School,304,31,8,39
Warwickshire,Bournebrook CofE Primary School,130,9,3,12
Warwickshire,St Matthew's Bloxam CofE Primary School,207,26,5,31
Warwickshire,St Lawrence CofE (Voluntary Aided) Primary School,189,21,4,25
Warwickshire,Paddox Primary School,639,61,16,77
Warwickshire,Binley Woods Primary School,179,30,6,36
Warwickshire,Hillmorton Primary School,386,44,2,46
Warwickshire,Wembrook Primary School,682,73,19,92
Warwickshire,Arden Forest Infant School,177,32,4,36
Warwickshire,Milby Primary School,424,27,7,34
Warwickshire,Weddington Primary School,468,50,13,63
Warwickshire,Newdigate Primary and Nursery School,326,87,8,95
Warwickshire,Goodyers End Primary School,387,68,19,87
Warwickshire,Exhall Cedars Infant School,108,25,4,29
Blackpool,Spen Brook School,11,0,11,11
Middlesbrough,Macmillan Academy,1530,257,26,283
Bradford,Dixons City Academy,900,105,22,127
Warwickshire,Knightlow CofE Primary School,218,29,7,36
Westminster,Paddington Academy,1232,103,27,130
Tameside,The Limes School,5,4,1,5
Croydon,Ridgeway Primary School,654,82,8,90
Southwark,Bessemer Grange Primary School,558,71,15,86
Barking and Dagenham,Godwin Primary School,455,109,10,119
Greenwich,Middle Park Primary School,428,90,12,102
Kirklees,Mount Pleasant Primary School,672,87,16,103
Leicester,Dovelands Primary School,553,46,6,52
Cheshire West and Chester,St Oswald's CofE Aided Primary School,134,1,3,4
Shropshire,Trinity CofE Primary School,154,18,4,22
Hackney,William Patten Primary School,434,54,17,71
Sutton,Muschamp Primary School and Language Opportunity Base,635,76,58,134
Kent,New Ash Green Primary School,413,65,7,72
County Durham,Framwellgate Moor Primary School,362,27,10,37
Gateshead,Hill Top School,131,0,131,131
County Durham,King Street Primary School,216,53,11,64
Kent,St. Edmund's Church of England Primary School,169,43,7,50
Bracknell Forest,Harmans Water Primary School,476,66,9,75
Warwickshire,Shrubland Street Community Primary School,216,27,7,34
Kent,Kings Hill School Primary and Nursery,485,46,11,57
East Sussex,Harlands Primary School,264,26,3,29
Wigan,"Sacred Heart Catholic Primary School, Hindley Green",177,25,3,28
Enfield,Russet House School,137,0,137,137
Liverpool,Sandfield Park School,91,0,91,91
Oxfordshire,Langford Village Community Primary School,430,59,15,74
Wakefield,Badsworth Church of England Voluntary Controlled Junior and Infant School,196,22,5,27
Wakefield,"Ryhill Junior, Infant and Nursery School",233,28,6,34
Wakefield,Ackworth Howard Church of England Voluntary Controlled Junior and Infant School,230,10,3,13
South Gloucestershire,Manorbrook Primary School,200,25,6,31
Kent,Lighthouse School,30,0,29,29
Bradford,Tracks,0,0,0,0
Worcestershire,Perryfields Primary Pupil Referral Unit,9,6,2,8
Worcestershire,The Beacon Primary Pupil Referral Unit,16,10,6,16
"Herefordshire, County of",Herefordshire Pupil Referral Service,51,31,12,43
Newham,Central Park Primary School,939,69,10,79
Nottinghamshire,Newark Orchard School,161,1,160,161
Barnet,Hasmonean Primary School,222,26,9,35
West Sussex,Crawley Down Village CofE,414,58,4,62
Leicester,Avenue Primary School,548,75,6,81
Staffordshire,Options Trent Acres School,92,0,92,92
Nottingham,Southglade Primary and Nursery School,454,88,4,92
Nottingham,Westglade Primary School,233,56,0,56
Nottingham,Robin Hood Primary School,484,91,4,95
Salford,Cadishead Primary School,333,47,7,54
Redbridge,Highlands Primary School,689,69,25,94
Salford,Etz Chaim Boys School,232,109,15,124
Somerset,Newbury Manor School,46,0,46,46
Nottingham,Henry Whipple Primary School,203,27,2,29
Rutland,The Shires,21,0,21,21
Bath and North East Somerset,Newbridge Primary School,405,54,7,61
Kent,Hythe Bay CofE Primary School,297,33,27,60
Northumberland,Central Primary School,716,158,20,178
St. Helens,Mill Green School,116,0,116,116
Tower Hamlets,Stephen Hawking School,90,0,90,90
Lancashire,Belmont School,127,0,127,127
Barnet,Beis Soroh Schneirer,324,32,1,33
Manchester,Oswald Road Primary School,665,97,20,117
Shropshire,Oakwood School,5,0,1,1
Sunderland,Albany Village Primary School,206,39,0,39
Salford,Grosvenor Road Primary School,558,77,8,85
Bolton,St George's CofE Primary School,289,50,3,53
Croydon,Oakwood School,154,31,2,33
Waltham Forest,Barn Croft Primary School,213,45,24,69
Brent,Brondesbury College London,119,4,0,4
Hackney,The Petchey Academy,1036,148,58,206
Oxfordshire,Chilworth House School,36,0,36,36
Liverpool,North Liverpool Academy,1327,230,19,249
West Berkshire,iCollege Alternative Provision,55,13,28,41
Hampshire,Hollywater School,139,0,139,139
Blackpool,Stanley Primary School,563,82,2,84
Surrey,Riverview CofE Primary and Nursery School VA,180,27,8,35
Staffordshire,The William Amory Primary School,202,9,1,10
Gateshead,Harlow Green Community Primary School,401,46,4,50
North Northamptonshire,Rowan Gate Primary School -Two Sites and Satellite,232,0,232,232
Gateshead,Rowlands Gill Community Primary School,207,33,11,44
Sheffield,Watercliffe Meadow Community Primary School,497,119,9,128
Stockport,Vale View Primary School,445,67,38,105
Luton,Beech Hill Community Primary School,918,170,25,195
Haringey,Stroud Green Primary School,382,28,6,34
Leicester,West Gate School,186,0,186,186
Hertfordshire,Dacorum Education Support Centre,5,3,0,3
Barking and Dagenham,Trinity School,302,7,295,302
Sutton,Culvers House Primary School,442,62,3,65
Liverpool,Emmaus Church of England and Catholic Primary School,477,73,18,91
Gateshead,Kells Lane Primary School,449,22,4,26
Gateshead,Chopwell Primary School,224,30,4,34
Devon,The Topsham School,218,16,10,26
Greenwich,Discovery Primary School,648,190,24,214
Leeds,Valley View Community Primary School,458,74,2,76
Surrey,St Joseph's Catholic Primary School,627,77,16,93
Hampshire,Holbrook Primary School,218,38,34,72
Hampshire,Bedenham Primary School,254,51,27,78
Nottingham,Jamia Al-Hudaa Residential College,174,0,0,0
Barnet,Talmud Torah Tiferes Shlomo,304,45,1,46
Sheffield,Al-Mahad Al-Islami,76,2,2,4
North Yorkshire,The Faculty of Queen Ethelburga's,368,16,0,16
Surrey,Cranmere Primary School,428,57,9,66
Brighton and Hove,Drive Preparatory School,52,3,18,21
Barnet,Finchley and Acton Yochien School,99,4,2,6
West Sussex,Castlewood Primary School,197,16,3,19
Kirklees,Al-Furqaan Preparatory School,142,5,0,5
Trafford,Trafford Alternative Education Provision,39,18,19,37
Wakefield,Denby Grange School,50,0,50,50
Lancashire,Progress School,12,0,12,12
West Sussex,Manor House School,38,0,38,38
Hackney,Hoxton Garden Primary,334,40,14,54
Ealing,Grange Primary School,733,74,11,85
Bracknell Forest,Whitegrove Primary School,419,43,9,52
West Northamptonshire,Camrose Early Years Centre for Children & Families,114,1,1,2
Wolverhampton,West Park Primary School,309,50,4,54
Derbyshire,Codnor Community Primary School Church of England Controlled,251,18,2,20
Barnsley,Athersley North Primary School,318,46,8,54
Lancashire,Red Rose School,35,0,35,35
Birmingham,Green Oak Academy,77,2,0,2
Hammersmith and Fulham,The Fulham Prep School Ltd,647,162,0,162
County Durham,Lanchester Endowed Parochial Primary School,463,52,5,57
Hackney,Beis Aharon School,293,60,29,89
Shropshire,Darwin School,8,5,3,8
Surrey,ACS Egham International School,502,152,1,153
Luton,The Gill Blowers Nursery School,134,25,2,27
Cumbria,Pennine Way Primary School,567,44,23,67
Sandwell,Hanbury Primary School,478,50,12,62
Kent,Beech Grove School,83,5,0,5
West Sussex,West Sussex Alternative Provision College,139,109,30,139
Sandwell,Uplands Manor Primary School and Nursery,844,110,36,146
West Sussex,"Chalkhill Education Centre, Chalkhill Hospital",3,3,0,3
Milton Keynes,Emerson Valley School,454,52,3,55
Wokingham,Loddon Primary School,603,62,9,71
Cambridgeshire,Wheatfields Primary School,329,35,6,41
Gateshead,Dryden School,57,0,57,57
Hounslow,The Woodbridge Park Education Service,101,47,54,101
Newcastle upon Tyne,West Jesmond Primary School,617,46,12,58
Essex,Church Langley Community Primary School,489,54,4,58
Sandwell,The Priory Primary School,445,79,13,92
Gateshead,Gibside School,181,1,180,181
North Lincolnshire,Westcliffe Primary School,337,32,14,46
Halton,All Saints Upton Church of England Voluntary Controlled Primary School,201,41,3,44
Islington,Montem Primary School,314,55,19,74
Essex,Brinkley Grove Primary School,415,90,4,94
Northumberland,Lowick Church of England Voluntary Controlled First School,28,5,1,6
Sandwell,King George V Primary School,226,25,5,30
South Gloucestershire,Bailey's Court Primary School,422,64,11,75
Wigan,St Cuthbert's Catholic Primary School Wigan,394,119,9,128
North East Lincolnshire,Grange Primary School,317,67,5,72
North Northamptonshire,Pen Green Centre for Children and Their Families,145,35,7,42
County Durham,Newker Primary School,414,57,5,62
Southwark,Cavendish School,39,0,39,39
Cambridgeshire,St Anne's CofE Primary School,207,28,5,33
Coventry,Mount Nod Primary School,314,54,5,59
Coventry,Spon Gate Primary School,270,46,1,47
Greenwich,James Wolfe Primary School and Centre for the Deaf,780,97,25,122
Lambeth,Bonneville Primary School,363,29,7,36
Gloucestershire,Gardners Lane Primary School,261,89,8,97
Gloucestershire,Hesters Way Primary School,190,63,9,72
Stockton-on-Tees,Holy Trinity Rosehill CofE Voluntary Aided Primary School,336,41,3,44
Lancashire,West Lancashire Community High School,126,0,126,126
Lancashire,Kingsbury Primary Special School,98,0,98,98
Barnet,Barnet Hill Academy,164,1,0,1
Westminster,Westminster Academy,1134,162,27,189
Hammersmith and Fulham,St James Preparatory School,180,56,2,58
Bolton,Leverhulme Community Primary School,436,107,6,113
Southampton,Mansel Park Primary & Nursery School,346,74,7,81
Lincolnshire,Athena School,108,0,108,108
Wirral,Bidston Village CofE (Controlled) Primary School,452,78,21,99
Tameside,"Our Lady of Mount Carmel RC Primary School, Ashton-under-Lyne",230,41,7,48
Norfolk,Drayton CofE Junior School,333,40,8,48
Barnet,WENTWORTH COLLEGE,25,0,1,1
Camden,The Academy School,89,0,0,0
Hartlepool,"The Horizon School, Hartlepool",24,11,5,16
Wigan,Rowan Tree Primary School,117,13,104,117
Redbridge,Mayespark Primary School,657,89,35,124
Stockport,St George's Church of England Primary School,374,59,7,66
Lancashire,Trinity and St Michael's VA CofE/Methodist Primary School,216,26,4,30
Ealing,Elthorne Park High School,1551,274,85,359
Liverpool,Four Oaks Primary School,345,59,6,65
Harrow,Whitchurch Primary School & Nursery,852,57,22,79
Hertfordshire,Haywood Grove School,59,0,59,59
Derbyshire,Holly House Special School,45,0,45,45
Islington,Newington Green Primary School,401,82,6,88
Derbyshire,The Linnet Independent Learning Centre,14,0,13,13
Cambridgeshire,Red Balloon Learner Centre - Cambridge,34,5,29,34
Wigan,Tyldesley St George's Central CofE Primary School and Nursery,337,31,7,38
Knowsley,St Aloysius Catholic Primary School,348,23,3,26
Lambeth,Hill Mead Primary School,340,96,16,112
Doncaster,Kirkby Avenue Primary School,354,76,4,80
Hackney,Beis Trana Girls' School,274,56,9,65
Hackney,The Lyceum,120,21,0,21
Milton Keynes,Loughton Manor First School,222,12,3,15
Warrington,St Margaret's CofE Voluntary Aided Primary School,468,45,5,50
Cheshire West and Chester,Lache Primary School,220,57,17,74
Kingston upon Thames,Educare Small School,40,6,0,6
"Herefordshire, County of",Queenswood School,48,0,48,48
Lancashire,Jamea Al Kauthar,257,1,0,1
Brighton and Hove,The Lioncare School,14,1,13,14
Bradford,Home Farm Primary School,468,47,13,60
Barnet,Menorah Foundation School,370,25,5,30
Islington,St Paul's Steiner School,196,32,1,33
Gloucestershire,Gloucestershire Hospital Education Service,2,2,0,2
Rochdale,Cedar Lodge School,4,3,1,4
East Sussex,The Haven Voluntary Aided CofE/Methodist Primary School,430,66,8,74
Tower Hamlets,Jamiatul Ummah School,168,0,0,0
Blackburn with Darwen,Jamiatul-Ilm Wal-Huda UK School,452,0,0,0
Bromley,Browns School,92,1,91,92
Milton Keynes,Wavendon Gate School,416,36,5,41
Derby,Roe Farm Primary School,404,53,8,61
Barnet,Tiferes High School,136,1,1,2
Enfield,Oakthorpe Primary School,494,42,22,64
South Gloucestershire,St Mary's Catholic Primary School,205,18,5,23
Kent,The Worthgate School,304,14,0,14
Blackpool,Kincraig Primary School,226,35,2,37
East Riding of Yorkshire,Hedon Nursery School,83,7,3,10
Brent,St Mary's RC Primary School,197,27,9,36
Hampshire,Whiteley Primary School,618,39,10,49
Cheshire West and Chester,Highfield Community Primary School,234,35,5,40
Kent,The Old Priory School,25,6,19,25
Middlesbrough,Priory Woods School,195,0,195,195
Havering,The Mawney Foundation  School,648,46,19,65
Walsall,Leighswood School,543,96,11,107
Salford,Talmud Torah Yetev Lev,476,2,1,3
Coventry,Southfields Primary School,442,46,3,49
Cumbria,Orgill Primary School,269,39,7,46
St. Helens,Rainhill Community Nursery,61,3,0,3
Hampshire,St Mark's Church of England Primary School,613,72,31,103
Somerset,Cambian Somerset School,31,0,31,31
Hertfordshire,Clore Shalom School,203,17,2,19
Redcar and Cleveland,Highcliffe Primary School,321,58,10,68
Barnsley,Summer Lane Primary,311,32,3,35
Buckinghamshire,The Pace Centre,37,1,36,37
Birmingham,Al-Furqan Primary School,628,40,8,48
Gateshead,Parkhead Community Primary School,324,51,3,54
Haringey,Earlham Primary School,290,51,12,63
Lancashire,Hillside Specialist School and College,106,0,106,106
Liverpool,Mab Lane Junior Mixed and Infant School,312,92,6,98
Lincolnshire,"St George's Church of England Community Primary School, Gainsborough",195,36,13,49
West Sussex,The Amicus School,19,0,19,19
Hertfordshire,Featherstone Wood Primary School,194,42,11,53
Bury,Bury Secondary PRU Spring Lane School,127,60,38,98
South Gloucestershire,Kings' Forest Primary School,445,57,16,73
Walsall,Hillary Primary School,698,125,17,142
Salford,All Hallows RC High School,706,123,47,170
Leicester,Glebelands Primary School,304,44,13,57
Hampshire,Burnham Copse Primary School,312,66,7,73
West Sussex,Summerlea Community Primary School,438,31,13,44
Middlesbrough,Abingdon Primary School,627,92,4,96
Wandsworth,"Sacred Heart Catholic Primary School, Battersea",358,52,30,82
"Bristol, City of",Hillcrest Primary School,409,34,7,41
Buckinghamshire,Foxes Piece School,191,24,9,33
Wakefield,High Well School,97,0,97,97
Medway,Burnt Oak Primary School,453,101,8,109
Wigan,Oakfield High School and College,327,3,324,327
Hampshire,Tadley Court School,55,0,55,55
Worcestershire,Fort Royal,242,16,226,242
Leicester,Leicester Partnership School,30,5,4,9
Nottinghamshire,Blue Mountain Education,9,1,6,7
North Tyneside,Beacon Hill School,228,0,228,228
County Durham,Tanfield Lea Community Primary School,352,50,1,51
Wolverhampton,The King's Church of England School,635,91,12,103
Stockport,Acorns School,23,0,23,23
Devon,Marland School,108,0,108,108
Stockport,Bradshaw Hall Primary School,464,45,18,63
Southampton,The Serendipity School,18,0,18,18
Hampshire,Henry Tyndale School,143,0,143,143
Kent,St Helens Montessori School,45,1,0,1
Leeds,Shire Oak VC Primary School,209,40,0,40
Coventry,Woodfield,150,0,150,150
Lancashire,Oliver House School,44,0,44,44
Harrow,Pinner Wood School,666,77,14,91
Essex,Grange Primary School,298,39,6,45
Walsall,Beacon Primary School,492,71,11,82
Walsall,St James Primary School,212,38,6,44
Haringey,Haringey Learning Partnership,53,37,13,50
Wirral,Hillside Primary School,182,34,2,36
Havering,The R J Mitchell Primary School,412,55,74,129
Sandwell,Harvills Hawthorn Primary School,464,121,11,132
Haringey,Lordship Lane Primary School,517,79,24,103
Windsor and Maidenhead,RBWM Alternative Learning Provision,25,22,3,25
Liverpool,Smithdown Primary School,474,125,15,140
West Sussex,Brook Infant School,177,20,0,20
West Sussex,Maidenbower Junior School,566,76,23,99
Hackney,The Bridge Academy,1115,118,56,174
Kent,West Heath School,136,0,136,136
Barnet,Wessex Gardens Primary School,347,33,13,46
Walsall,Shepwell  Short Stay School (PRU-Medical),49,3,45,48
Redbridge,Cranbrook Primary School,894,79,44,123
South Gloucestershire,Pathways Learning Centre,71,38,33,71
Darlington,Rise Carr College,36,20,16,36
Hillingdon,Cherry Lane Primary School,659,156,28,184
Nottinghamshire,Arnold View Primary School,310,38,3,41
Redcar and Cleveland,Chaloner Primary School,250,54,0,54
Staffordshire,"Cedars - Newcastle, Moorlands and Darwin Bases",30,26,4,30
Enfield,West Grove Primary,382,28,12,40
Wandsworth,Chelsea Hall School,43,4,39,43
Lancashire,Oakfield House School,30,0,30,30
Milton Keynes,Merebrook Infant School,142,14,2,16
Birmingham,Hollyfield Primary School,415,65,1,66
Sandwell,St James CofE Primary School,460,64,17,81
Hammersmith and Fulham,Burlington House School,176,32,144,176
Redbridge,Clore Tikva School,390,23,17,40
Derby,Ashgate Primary School,315,46,8,54
Birmingham,Hamd House School,326,0,6,6
Wokingham,Highwood Primary School,480,83,23,106
Islington,Arts and Media School Islington,672,111,25,136
Peterborough,Heritage Park Primary School,213,25,4,29
Staffordshire,Chase Grammar School International Study Centre,56,7,0,7
Waltham Forest,Belmont Park School,25,3,22,25
South Gloucestershire,Coniston Primary School,195,22,3,25
South Gloucestershire,Little Stoke Primary School,208,29,7,36
South Gloucestershire,Wheatfield Primary School,409,36,13,49
Hackney,Betty Layward Primary School,433,33,16,49
Devon,On Track Education - Totnes,39,0,39,39
Hampshire,Knightwood Primary School,407,26,4,30
Milton Keynes,Portfields Primary School,626,37,23,60
Lancashire,Cottam Primary School,210,27,3,30
Nottinghamshire,Gateford Park Primary School,246,8,0,8
Croydon,Thornton Heath Nursery School,113,16,0,16
Croydon,Selhurst Nursery School and Children's Centre,50,14,0,14
Rochdale,Holy Family Roman Catholic and Church of England College,750,44,25,69
Cheshire East,Middlewich Primary School,399,24,11,35
Haringey,Bruce Grove Primary School,322,40,13,53
Wakefield,Wakefield Lawefield Primary School,457,70,10,80
Tower Hamlets,Harry Gosling Primary School,449,47,15,62
Islington,Rotherfield Primary School,335,55,8,63
Islington,Pooles Park Primary School,209,64,9,73
Wiltshire,Emmaus School,59,1,1,2
Tower Hamlets,Darul Hadis Latifiah,140,0,0,0
Southwark,Harris Academy Bermondsey,880,80,6,86
Kent,The Wyvern School (Buxford),352,3,349,352
Barnsley,Barnsley Academy,907,88,37,125
Oldham,Elland House School,15,0,15,15
Hammersmith and Fulham,Ark Burlington Danes Academy,1087,138,20,158
Ealing,Ealing Alternative Provision,57,54,3,57
Haringey,Park View School,1192,105,30,135
South Gloucestershire,Emersons Green Primary School,205,17,14,31
Bracknell Forest,College Hall,24,15,6,21
Blackpool,Educational Diversity,76,72,4,76
Islington,Canonbury Primary School,438,48,18,66
Barking and Dagenham,Gascoigne Primary School,1118,139,34,173
Kensington and Chelsea,Tabernacle School,7,0,2,2
Kent,Greenfields School,15,2,13,15
Gloucestershire,Meadowside Primary School,210,14,7,21
Gloucestershire,The John Moore Primary School,270,18,9,27
Gloucestershire,Grangefield Primary School,410,60,8,68
Ealing,Greek Primary School of London,32,0,0,0
Brighton and Hove,Carden Nursery and Primary School,377,74,32,106
Cheshire West and Chester,iMap Centre,17,0,17,17
Derby,Parkview Primary School,237,12,6,18
Liverpool,Kingsley Community School,495,103,11,114
West Northamptonshire,Cambian Northampton School,25,0,25,25
Essex,Oakfield Primary School,414,60,8,68
Kent,Little Acorns School,16,0,16,16
Nottinghamshire,Ravenshead CofE Primary School,405,65,6,71
Buckinghamshire,Millbrook Combined School,685,117,12,129
Liverpool,Fazakerley Primary School,429,121,18,139
Lambeth,Hitherfield Primary School,633,53,15,68
Dorset,The Forum Centre,35,15,20,35
Barnet,Susi Earnshaw Theatre School,39,10,4,14
Knowsley,St Joseph the Worker Catholic Primary School,248,55,5,60
Liverpool,Our Lady and St Philomena's Catholic Primary School,216,24,7,31
Essex,Harlow Fields School and College,153,2,151,153
Southampton,Bassett Green Primary School,503,65,15,80
Greenwich,Alexander McLeod Primary School,595,104,15,119
Islington,Hugh Myddelton Primary School,496,108,19,127
Southwark,Brunswick Park Primary School,382,54,20,74
Barking and Dagenham,Hunters Hall Primary School,635,68,10,78
Barking and Dagenham,Southwood Primary School,618,96,11,107
Redbridge,Christchurch Primary School,1129,42,31,73
Oldham,St Paul's CofE Primary School,244,62,16,78
Kirklees,Dalton School,521,67,18,85
Luton,Waulud Primary School,455,49,8,57
Luton,Leagrave Primary School,458,76,15,91
Buckinghamshire,The Disraeli School,702,126,40,166
Haringey,Muswell Hill Primary School,415,72,11,83
Lambeth,Henry Fawcett Primary School,232,42,11,53
Haringey,Risley Avenue Primary School,558,75,12,87
Manchester,St Peter's RC High School,1046,113,38,151
Manchester,St Anne's RC Primary School,227,33,6,39
Trafford,Egerton High School,55,1,54,55
Stockport,Oakgrove School,39,0,39,39
Stockport,Windlehurst School,47,0,47,47
Sheffield,Sheffield Park Academy,1205,157,18,175
Sheffield,Sheffield Springs Academy,984,146,26,172
Merton,Harris Academy Merton,1368,120,31,151
County Durham,The Meadows School,64,0,64,64
Buckinghamshire,Cedar Park School,229,29,2,31
Buckinghamshire,The Downley School,407,30,6,36
Brent,Avigdor Hirsch Torah Temimah Primary School,202,22,1,23
South Tyneside,Whitburn Village Primary School,235,31,3,34
County Durham,Woodhouse Community Primary School,234,75,3,78
Birmingham,Four Oaks Primary School,421,38,4,42
Redbridge,South Park Primary School,654,66,12,78
Manchester,Ringway Primary School,463,93,11,104
Buckinghamshire,Westfield School,78,0,78,78
Tower Hamlets,St Mary and St Michael Primary School,429,53,15,68
Cambridgeshire,Cambridge Steiner School,100,27,2,29
Manchester,Button Lane Primary School,464,34,13,47
Hillingdon,Hillingdon Manor School,240,0,240,240
Leicester,New College Leicester,973,162,8,170
Cheshire West and Chester,Brookside Primary School,209,25,4,29
Calderdale,Broadwood School,38,0,38,38
Suffolk,Cedarwood Primary School,420,37,10,47
Wiltshire,Abbeyfield School,895,114,34,148
Barnet,The Orion Primary School,965,242,56,298
Somerset,North Hill House,50,0,50,50
Surrey,Jigsaw CABAS School,76,0,76,76
Camden,Maria Montessori School,201,20,2,22
Manchester,Kassim Darwish Grammar School for Boys,126,32,0,32
Oxfordshire,Chandlings Prep,305,52,1,53
Newcastle upon Tyne,Hadrian School,169,8,161,169
Newcastle upon Tyne,Sir Charles Parsons School,205,2,203,205
Cambridgeshire,Monkfield Park Primary School,417,48,10,58
West Berkshire,Priors Court School,54,0,54,54
Birmingham,Whitehouse Common Primary School,452,23,4,27
Oxfordshire,Kitebrook Preparatory School,301,33,1,34
Wakefield,The Castle Nursery School,108,11,5,16
Wolverhampton,Bilston Nursery School,168,12,5,17
Southampton,Valentine Primary School,646,109,23,132
North Yorkshire,Scarborough Pupil Referral Unit,7,2,1,3
Cambridgeshire,Bushmead Primary School,362,83,8,91
St. Helens,Launchpad Centre,44,38,6,44
York,Copmanthorpe Primary School,372,52,12,64
Oxfordshire,Oxford Montessori Schools,124,50,17,67
Blackburn with Darwen,Newfield School,207,0,207,207
Medway,St Mary's Island Church of England (Aided) Primary School,671,77,7,84
Oxfordshire,Bure Park Primary School,415,74,19,93
Newham,Kingsford Community School,1577,111,6,117
Worcestershire,Holywell Primary and Nursery School,443,81,8,89
Swindon,OakTree Nursery and Primary School,378,116,10,126
Greenwich,Greenwich Steiner School,179,19,4,23
West Sussex,Apple Orchard School,16,8,8,16
Walsall,Cooper and Jordan Church of England Primary School,476,29,7,36
Birmingham,Anglesey Primary School,733,119,17,136
Walsall,Chuckery Primary School,459,85,19,104
Wandsworth,Victoria Drive Primary Pupil Referral Unit,0,0,0,0
Lancashire,Moorlands View School,14,0,14,14
Telford and Wrekin,Sir Alexander Fleming Primary School,375,59,10,69
Slough,Claycots School,1650,204,33,237
Hertfordshire,Lodge Farm Primary School,438,55,7,62
Wiltshire,Fynamore Primary School,405,69,14,83
Lancashire,Lancaster Steiner School,18,9,0,9
Medway,"Ripplevale School, Rochester",172,0,172,172
Kirklees,Paradise Primary School,251,0,0,0
Worcestershire,Evesham Nursery School,98,0,0,0
Hertfordshire,Birchwood Avenue Primary School,225,40,13,53
Liverpool,Auckland College,378,65,1,66
Derbyshire,Pegasus School,14,0,14,14
Stockport,Westmorland Primary School,497,40,19,59
Blackburn with Darwen,St Thomas's Centre,79,69,10,79
Northumberland,Northumberland Pupil Referral Unit,21,19,1,20
Staffordshire,Bridge Short Stay School,41,39,2,41
Derby,The Kingsmead School,45,42,0,42
Redbridge,Bancrofts Preparatory School,261,11,0,11
Hackney,St John and St James CofE Primary School,225,39,13,52
Sandwell,Springfield Primary School,459,94,9,103
North Tyneside,Hadrian Park Primary School,422,23,2,25
Essex,Holly Trees Primary School,414,40,17,57
Gateshead,St Aidan's Church of England Primary School,213,30,2,32
Salford,Lark Hill Community Primary School,646,118,16,134
Kent,Oakley School,232,15,217,232
Westminster,Portman Early Childhood Centre,72,30,4,34
Sheffield,Dore Primary School,489,38,6,44
Salford,Springwood Primary School,307,1,306,307
Wigan,Willow Grove Primary School,64,0,64,64
Essex,Brightside Primary School,563,69,16,85
Merton,Malmesbury Primary School,434,92,6,98
Cumbria,Montreal CofE Primary School,127,23,11,34
County Durham,North Park Primary School,244,64,7,71
Liverpool,Kirkdale St Lawrence CofE VA Primary School,292,50,8,58
Lincolnshire,The Meadows Primary School,372,77,11,88
Bradford,Knowleswood Primary School,440,96,11,107
Bradford,Newhall Park Primary School,421,43,8,51
St. Helens,Holy Spirit Catholic Primary School,211,42,0,42
Nottingham,Fig Tree Primary School,79,0,0,0
Nottinghamshire,Pierrepont Gamston Primary School,316,16,1,17
Halton,Brookvale Primary School,253,28,7,35
"Bristol, City of",Shirehampton Primary School,521,127,21,148
Wolverhampton,Bantock Primary School,412,52,1,53
Sefton,Our Lady of Walsingham Primary School,205,29,1,30
South Gloucestershire,Abbotswood Primary School,362,32,6,38
Birmingham,Wattville Primary School,449,99,1,100
Enfield,Highfield Primary School,688,72,32,104
Sefton,All Saints Catholic Primary School,355,130,1,131
East Riding of Yorkshire,Swinemoor Primary School,238,46,10,56
Milton Keynes,Brooksward School,312,23,8,31
Leicester,Caldecote Community Primary School,615,98,11,109
Hampshire,Great Binfields Primary School,414,38,13,51
Plymouth,Whitleigh Community Primary School,389,97,8,105
Bradford,Parkside School,1167,128,47,175
Bradford,Burley Oaks Primary School,404,33,8,41
Derbyshire,Brampton Primary School,311,69,26,95
Leicestershire,Greenfield Primary School,608,78,7,85
Somerset,Stoberry Park School,326,27,4,31
York,Yearsley Grove Primary School,401,29,7,36
Swindon,Eldene Nursery and Primary School,343,44,27,71
Sandwell,The Meadows School,214,0,214,214
Sandwell,The Orchard School,147,0,147,147
Sandwell,The Westminster School,231,0,231,231
Central Bedfordshire,Maple Tree Primary School,247,15,9,24
Wandsworth,Thames Christian School,172,24,3,27
Stoke-on-Trent,Priory CofE Primary School,420,63,4,67
Manchester,Benchill Primary School,550,136,13,149
Nottinghamshire,Berry Hill Primary School,452,40,6,46
Nottinghamshire,Crescent Primary School,430,92,3,95
Camden,Kingsgate Primary School,637,72,22,94
Luton,Bushmead Primary School,748,119,14,133
Warrington,Latchford St James CofE Primary School,167,24,4,28
Nottinghamshire,Asquith Primary School,326,92,4,96
Lincolnshire,St Botolph's C of E Primary School,404,59,21,80
Haringey,Seven Sisters Primary School,260,40,19,59
Enfield,Highlands School,1547,142,75,217
Staffordshire,Forsbrook CofE Controlled Primary School,240,24,8,32
Birmingham,Harborne Primary School,772,74,8,82
Hounslow,Crane Park Primary School,464,99,29,128
Hounslow,Fairholme Primary School,467,103,8,111
Hounslow,Green Dragon Primary School,429,62,20,82
Surrey,Kings International College,783,172,30,202
East Riding of Yorkshire,Anlaby Primary School,420,47,10,57
Southwark,Harris Girls' Academy East Dulwich,863,69,11,80
Waltham Forest,Walthamstow Academy,1092,150,36,186
Staffordshire,Chasetown Community School,81,1,80,81
Kirklees,Brian Jackson College,60,21,38,59
Staffordshire,Rugeley School,55,0,55,55
Hackney,"Tawhid Boys School, Tawhid Educational Trust",124,0,0,0
Lancashire,Imam Muhammad Zakariya School,93,0,0,0
Salford,The New Broadwalk PRU,31,28,3,31
Birmingham,Values Academy,16,0,16,16
Blackburn with Darwen,Islamiyah School,201,0,0,0
Walsall,Abu Bakr Girls School,407,18,3,21
Lincolnshire,Stamford Junior School,358,53,2,55
Peterborough,Hampton Hargate Primary School,634,82,14,96
Kent,The Craylands School,417,50,10,60
Havering,Engayne Primary School,621,78,8,86
Warrington,Grappenhall Heys Community Primary School,265,19,4,23
Nottinghamshire,Northfield Primary and Nursery School,426,40,5,45
Northumberland,Emily Wilding Davison School,98,0,98,98
Shropshire,Access School,22,0,22,22
Croydon,CACFO UK Education Centre,12,0,4,4
Devon,Willowbrook School,430,97,20,117
Milton Keynes,Howe Park School,179,28,1,29
Milton Keynes,Long Meadow School,412,61,6,67
Kensington and Chelsea,The Lloyd Williamson School Foundation,79,8,4,12
Newham,Sir John Heron Primary School,468,77,18,95
Hackney,Rosemary Works School,64,8,0,8
Liverpool,St Matthew's Catholic Primary School,411,92,9,101
Leeds,Asquith Primary School,436,45,7,52
Liverpool,St John's Catholic Primary School,531,102,13,115
Tower Hamlets,London Islamic School,138,0,0,0
South Tyneside,The Sue Hedley Nursery School,79,9,6,15
Greenwich,Conway Primary School,443,86,9,95
Hampshire,Elvetham Heath Primary School,645,48,15,63
Hampshire,Cherrywood Community Primary School,176,27,4,31
Wolverhampton,St Andrew's Church of England Primary School,464,55,12,67
Stockton-on-Tees,Myton Park Primary School,254,16,7,23
Newham,Plaistow Primary School,379,64,9,73
Bradford,Canterbury Nursery School and Centre for Children and Families,159,50,20,70
Barking and Dagenham,Mayesbrook Park School,69,14,2,16
Worcestershire,Oak Hill First School,441,91,4,95
Leicester,Leicester City Primary PRU,14,1,13,14
Greenwich,Eglinton Primary School,425,65,13,78
Lancashire,Westmorland School,56,0,56,56
Wiltshire,Nursteed Community Primary School,199,13,8,21
Cumbria,St Patrick's Catholic Primary School,259,57,8,65
Waltham Forest,Lantern of Knowledge Secondary School,101,5,0,5
Northumberland,Howard House School,24,0,24,24
Manchester,North Ridge High School,199,3,196,199
South Gloucestershire,St Peter's Anglican / Methodist VC Primary,151,25,0,25
Lancashire,Reedley Hallows Nursery School,172,18,0,18
Thurrock,The Gateway Academy,1074,152,26,178
Nottingham,Hospital and Home Education PRU,74,9,20,29
Kent,Castle Hill Community Primary School,406,72,32,104
Wiltshire,Five Lanes CofE VC Primary School,56,8,2,10
Essex,Hare Street Community Primary School and Nursery,460,146,12,158
Sandwell,Tividale Community Primary School,467,52,11,63
Liverpool,Lakeside School,37,0,37,37
Cumbria,Distington Community School,117,11,2,13
Nottinghamshire,Wynndale Primary School,227,26,0,26
Telford and Wrekin,Old Park Primary School,653,156,10,166
Nottinghamshire,Farmilo Primary School and Nursery,326,67,0,67
Nottinghamshire,Intake Farm Primary School,220,39,2,41
Nottinghamshire,King Edward Primary School & Nursery,420,53,4,57
Nottinghamshire,Sutton Road Primary School,624,126,5,131
Nottinghamshire,High Oakham Primary School,452,33,2,35
Trafford,St Ann's RC Primary School,430,49,4,53
Bolton,Madrasatul Imam Muhammad Zakariya,121,2,0,2
Oldham,Crompton Primary School,223,35,0,35
Tower Hamlets,St Elizabeth Catholic Primary School,362,22,6,28
Tower Hamlets,Bishop Challoner Boys' School,510,51,26,77
Blackpool,Boundary Primary School,419,94,7,101
Hampshire,Micheldever CofE Primary School,99,13,3,16
Kent,The Davenport School,14,4,10,14
Telford and Wrekin,Newdale Primary School & Nursery,499,102,0,102
Hampshire,Sharps Copse Primary and Nursery School,311,75,11,86
Tower Hamlets,Mazahirul Uloom London School,124,0,0,0
Liverpool,Liverpool Progressive School,21,0,21,21
Cambridgeshire,Ridgefield Primary School,243,16,13,29
Essex,Abacus Primary School,415,43,14,57
Lambeth,Kings Avenue School,167,28,6,34
Harrow,Woodlands School,133,0,133,133
Harrow,Kingsley High School,121,0,121,121
Wakefield,Newlands Primary School,312,67,40,107
Halton,Our Lady of Perpetual Succour Catholic Primary School,207,12,6,18
West Sussex,"All Saints CofE Primary School, Horsham",210,22,0,22
Halton,Oakfield Community Primary School,327,52,17,69
Hertfordshire,Oughton Primary and Nursery School,239,52,6,58
Stockport,Cheadle Heath Primary School,336,50,6,56
Liverpool,Wellesbourne Community Primary School,391,68,7,75
Liverpool,St Michael-in-the-Hamlet Community Primary School,421,53,14,67
Liverpool,Monksdown Primary School,645,119,19,138
Liverpool,Greenbank Primary School,427,65,10,75
Liverpool,Leamington Community Primary School,483,130,16,146
Liverpool,Longmoor Community Primary School,462,46,4,50
Liverpool,Broad Square Community Primary School,420,152,4,156
Liverpool,Florence Melly Community Primary School,438,106,15,121
Liverpool,Our Lady of the Assumption Catholic Primary School,230,37,3,40
Liverpool,Stockton Wood Community Primary School,383,88,3,91
Richmond upon Thames,Kew Riverside Primary School,107,20,8,28
Cumbria,Fell House School,7,0,7,7
Brighton and Hove,Brighton & Hove Montessori School,20,4,1,5
Leicester,Jameah Academy,228,2,0,2
Cheshire East,Gainsborough Primary and Nursery School,390,61,10,71
Barnet,Pardes House Primary School,355,22,7,29
Barnet,Beis Yaakov Primary School,471,45,3,48
Kent,The Churchill School,366,22,5,27
Lancashire,Taywood Nursery,91,13,0,13
York,Westfield Primary Community School,519,136,12,148
Wokingham,South Lake Primary School,454,76,12,88
North Tyneside,Western Community Primary School,451,60,0,60
Brent,The School of the Islamic Republic of Iran,115,0,0,0
Haringey,Greig City Academy,1144,151,17,168
Cumbria,Westfield Nursery and Primary School,157,18,13,31
Devon,Blackford Education (Schools) Ltd t/a the Libra School,45,0,45,45
Gloucestershire,Hope Brook CofE Primary School,112,15,3,18
Gateshead,Eslington Primary School,62,2,60,62
Lancashire,Chadwick High School,74,63,11,74
Greenwich,Waterside School,27,2,25,27
Redbridge,Oaks Park High School,1841,112,21,133
Rochdale,Rochdale Pupil Referral Service,123,114,3,117
Bradford,Park Aspire,53,29,24,53
Liverpool,Hope School,59,0,59,59
Kirklees,Dale House School,74,16,1,17
East Riding of Yorkshire,Cambian Beverley School,13,0,13,13
Oxfordshire,"St Clare's, Oxford",230,27,0,27
North Tyneside,Silverdale School,122,4,118,122
Lancashire,Rosewood Primary School,440,52,8,60
Croydon,Cressey College,197,0,189,189
Hackney,Side By Side School,92,29,63,92
Lambeth,The Livity School,110,0,110,110
Liverpool,Bank View High School,276,0,276,276
Lambeth,The Michael Tippett School,78,0,78,78
Richmond upon Thames,Hampton Court House,295,71,0,71
Ealing,Ealing Independent College,112,15,12,27
Rochdale,Bowlee Park Community Primary School,903,110,40,150
Lewisham,Kings Kids Christian School,10,0,0,0
Hackney,Al-Falah Primary School,101,16,0,16
Bradford,Islamic Tarbiyyah Preparatory School,184,2,0,2
Coventry,Moat House Primary School,446,86,4,90
Coventry,Limbrick Wood Primary School,170,35,4,39
Coventry,Henley Green Primary,484,94,5,99
Surrey,Cornfield School,14,0,14,14
Shropshire,Hillcrest Shifnal School,56,4,52,56
East Riding of Yorkshire,Bay Primary School,403,101,21,122
East Riding of Yorkshire,Keldmarsh Primary School,215,23,3,26
Halton,Halton School,14,0,14,14
Hounslow,The William Hogarth Primary School,161,29,3,32
Hertfordshire,Swallow Dell Primary and Nursery School,422,111,12,123
Derbyshire,Gorseybrigg Primary School and Nursery,236,26,2,28
Waltham Forest,Noor Ul Islam Primary School,183,8,2,10
East Riding of Yorkshire,Hornsea Burton Primary School,68,12,9,21
Somerset,Wessex Lodge School,46,0,46,46
Somerset,Somerset Progressive School,35,1,34,35
Croydon,Cambridge Tutors College,70,5,0,5
Oxfordshire,St John the Evangelist CofE VA Primary School,455,66,2,68
Barnet,Nancy Reuben Primary School,209,23,2,25
Derbyshire,Chapel-en-le-Frith CofE VC Primary School,477,87,28,115
Kent,Great Oaks Small School,37,0,37,37
Lancashire,Pontville School,141,0,141,141
Blackburn with Darwen,Markazul Uloom,42,0,0,0
Hammersmith and Fulham,William Morris Sixth Form,703,34,43,77
Lancashire,Burnley Springfield Community Primary School,211,48,2,50
North Northamptonshire,Henry Chichele Primary School,407,32,5,37
Barnet,Torah Vodaas,372,16,3,19
Leeds,Otley All Saints CofE Primary School,254,39,2,41
Coventry,St Mary and St Benedict Catholic Primary School,348,27,6,33
Somerset,Cotford St Luke Primary School,255,36,6,42
Barking and Dagenham,Jo Richardson Community School,1682,145,44,189
Cambridgeshire,On Track Education Centre,16,0,16,16
Tower Hamlets,Lansbury Lawrence Primary School,452,62,20,82
Windsor and Maidenhead,Churchmead Church of England (VA) School,535,126,20,146
Hampshire,Prospect School,84,0,84,84
Staffordshire,Kettlebrook Short Stay School,45,45,0,45
Lambeth,Loughborough Primary School,320,66,3,69
Central Bedfordshire,Orchard School & Nursery,96,0,0,0
Hackney,Yesodey Hatorah Senior Girls School,358,28,7,35
North Northamptonshire,Croyland Primary School,417,55,23,78
Birmingham,Greenfields Primary School,155,5,0,5
Suffolk,Beaumont Community Primary School,120,22,1,23
Liverpool,St Christopher's Catholic Primary School,391,48,4,52
Wakefield,"Smawthorne Henry Moore Primary School, Castleford",490,125,22,147
Lancashire,Cherry Fold Community Primary School,393,50,8,58
Kent,The John Wesley Church of England Methodist Voluntary Aided Primary School,462,81,25,106
Essex,Woodlands School Hutton Manor,190,15,0,15
Wakefield,Wakefield Grammar Pre-Preparatory School,224,24,0,24
Doncaster,Long Toft Primary School,322,51,0,51
Lancashire,"Cuerden Church School, Bamber Bridge",194,31,2,33
Tower Hamlets,Al-Mizan School,113,3,0,3
Cambridgeshire,The Old School House,8,0,8,8
East Sussex,St Mary's School and 6th Form College,111,0,111,111
Brent,Brent River College,37,36,1,37
Essex,"Chancellor Park Primary School, Chelmsford",208,10,8,18
Lambeth,Jubilee Primary School,355,80,37,117
Harrow,Hillview Nursery School,84,0,4,4
Hackney,St. Dominic's Catholic Primary School,274,47,6,53
Southampton,Compass School,43,23,20,43
Warrington,Sankey Valley St James Church of England Primary School,242,36,5,41
Salford,Alder Brook,45,11,32,43
South Tyneside,Jarrow Cross CofE Primary School,310,77,4,81
Lancashire,Royal Cross Primary School,24,0,24,24
"Bristol, City of",Bristol Hospital Education Service,50,4,13,17
Liverpool,Blueberry Park,386,78,15,93
Walsall,Walsall Academy,1368,145,31,176
North Lincolnshire,Lincoln Gardens Primary School,414,43,9,52
County Durham,Seascape Primary School,264,43,13,56
Liverpool,Phoenix Primary School,250,41,42,83
Southampton,Newlands Primary School,399,83,21,104
Haringey,The Mulberry Primary School,578,101,47,148
Oldham,Yew Tree Community School,643,93,11,104
Wakefield,Kingsland Primary School,199,0,199,199
Wakefield,Oakfield Park School,163,0,163,163
Solihull,Dickens Heath Community Primary School,464,74,21,95
Surrey,Southfield Park Primary School,421,52,6,58
Brent,JFS,1887,272,49,321
South Tyneside,Jarrow School,832,183,73,256
Cumbria,The Bishop Harvey Goodwin School (Church of England Voluntary Aided),183,25,12,37
Richmond upon Thames,Marshgate Primary School,415,17,5,22
Surrey,Guildford Nursery School and Family Centre,169,37,7,44
West Northamptonshire,Kingsthorpe Village Primary School,207,18,3,21
"Bournemouth, Christchurch and Poole",Langside School,27,0,27,27
Windsor and Maidenhead,Heathermount School,77,0,77,77
Isle of Wight,Island Learning Centre,39,23,13,36
Sefton,Peterhouse School,72,2,70,72
Barnet,Northgate School,13,6,0,6
Merton,Canterbury Campus,66,39,0,39
Buckinghamshire,Kings Wood School and Nursery,461,123,31,154
Wakefield,Wakefield Snapethorpe Primary School,677,140,26,166
Birmingham,Forestdale Primary School,210,49,5,54
Middlesbrough,Unity City Academy,918,137,28,165
Manchester,Ashbury Meadow Primary School,488,45,37,82
Hertfordshire,St Catherine's Hoddesdon CofE Primary School,359,30,11,41
Merton,St Thomas of Canterbury Catholic Primary School,452,79,9,88
Hampshire,The Key Education Centre,24,23,1,24
Newcastle upon Tyne,Talbot House Trust,37,0,37,37
Devon,Haytor View Community Primary School,238,86,7,93
Bolton,Queensbridge Primary School,250,32,16,48
Bolton,The Gates Primary School,317,42,9,51
Bury,St John with St Mark CofE Primary School,338,62,18,80
Cambridgeshire,Milton Road Primary School,421,37,6,43
Redbridge,Oakdale Junior School,338,27,9,36
Redbridge,Oakdale Infants' School,313,10,4,14
Redbridge,Gearies Primary School,897,56,32,88
Redbridge,Churchfields Junior School,477,24,21,45
Redbridge,Churchfields Infants' School,444,20,15,35
Redbridge,Parkhill Infants' School,396,63,12,75
Redbridge,Parkhill Junior School,465,56,12,68
Southampton,Sinclair Primary and Nursery School,265,43,3,46
Bury,St Luke's CofE Primary School,482,90,7,97
Manchester,Bridgelea Pupil Referral Unit,91,9,82,91
Gloucestershire,St Edward's Preparatory School,271,18,0,18
Kent,Phoenix Community Primary School,213,28,5,33
Hampshire,Grantham Farm Montessori School,38,1,0,1
West Sussex,Langley Green Primary,462,35,10,45
West Sussex,Northgate Primary School,658,112,37,149
Hertfordshire,Muriel Green Nursery School,73,12,0,12
Bolton,The Valley Community Primary School,524,39,18,57
Blackburn with Darwen,Blackburn the Redeemer CofE Primary,422,77,12,89
Staffordshire,Draycott Moor College,23,0,23,23
Sheffield,Arbourthorne Community Primary School,460,148,24,172
Birmingham,Yardley Primary School,839,118,9,127
Shropshire,Smallbrook School,49,17,30,47
Merton,St Mark's Church of England Academy,823,193,16,209
Hammersmith and Fulham,Larmenier & Sacred Heart Catholic Primary School,430,25,17,42
Hammersmith and Fulham,Parsons Green Prep School,115,0,1,1
Essex,Lincewood Primary School,408,52,18,70
Nottinghamshire,Ordsall Primary School,587,70,9,79
Birmingham,Al-Burhan Grammar School,133,0,0,0
Wandsworth,Gatton (VA) Primary School,628,65,10,75
West Sussex,Oriel High School,1469,203,33,236
Norfolk,Necton VA Primary School,189,35,7,42
Kent,The Discovery School,625,59,7,66
Stockport,Inscape House School,101,0,101,101
Essex,Springfield Primary School,476,65,5,70
Milton Keynes,Broughton Fields Primary School,416,61,10,71
Milton Keynes,Giles Brook Primary School,452,25,7,32
Middlesbrough,Whinney Banks Primary School,475,66,3,69
County Durham,Pelton Community Primary School,340,128,4,132
Dorset,Conifers Primary School,370,96,12,108
Haringey,Islamic Shakhsiyah Foundation,134,0,4,4
Slough,Islamic Shakhsiyah Foundation,97,5,0,5
Hertfordshire,St Albans Independent College,79,7,10,17
Birmingham,The Lambs Christian School,41,7,0,7
Birmingham,Mapledene Primary School,336,76,2,78
Birmingham,Kings Heath Primary School,658,130,9,139
Birmingham,Wheelers Lane Primary School,645,110,10,120
Birmingham,James Watt Primary School,440,88,4,92
Surrey,The Surrey Teaching Centre,4,4,0,4
Surrey,St Peter's Centre,0,0,0,0
Somerset,Springmead Preparatory School,119,19,0,19
Cumbria,Cambridge Primary School,218,72,18,90
Lancashire,Oswaldtwistle School,72,67,5,72
Lancashire,Shaftesbury High School,92,27,6,33
West Northamptonshire,On Track Education Silverstone,30,1,29,30
Bradford,Darul Uloom Dawatul Imaan,175,0,0,0
Southwark,The Villa,192,8,2,10
Wandsworth,Park House School,59,0,56,56
East Sussex,Headstart,39,0,39,39
Swindon,St Francis CofE Primary School,451,41,13,54
Luton,Ramridge Primary School,449,89,13,102
Stoke-on-Trent,Merit Hospital School and Medical Pupil Referral Unit,2,0,2,2
Tower Hamlets,Malmesbury Primary School,481,125,18,143
Devon,Wynstream School,331,50,22,72
Bromley,Wickham Court School,78,0,9,9
Cambridgeshire,Cambian Wisbech School,42,0,42,42
Sunderland,Columbia Grange School,120,0,120,120
Bexley,Orchard Primary School,221,46,10,56
Warrington,Bright Futures,62,0,62,62
South Tyneside,Westoe Crown Primary School,658,105,6,111
Gloucestershire,Heart of the Forest Community Special School,128,0,128,128
Cumbria,Wings School,40,7,33,40
Westminster,L'Ecole Bilingue Elementaire,121,2,0,2
Bury,Manchester Mesivta School,229,42,16,58
Liverpool,Childwall Valley Primary School,225,29,7,36
North Northamptonshire,Mawsley Primary School,291,30,3,33
Cumbria,Valley Primary School and Nursery,273,60,14,74
Ealing,Petts Hill Primary School,255,33,5,38
Rochdale,Broadfield Community Primary School,409,44,21,65
Southwark,City of London Academy (Southwark),1577,225,43,268
Middlesbrough,The King's Academy,1347,228,80,308
Manchester,Manchester Academy,1090,122,37,159
Southwark,Harris Academy Peckham,589,101,9,110
Brent,Capital City Academy,1156,127,19,146
Lincolnshire,Fortuna School,80,0,80,80
South Tyneside,Sea View Primary School,430,120,11,131
Doncaster,Mallard Primary School,361,53,9,62
Bolton,SS Osmund and Andrew's R.C. Primary School,423,47,8,55
"Bristol, City of",Knowle West Early Years Centre,134,39,0,39
Hounslow,Suffah Primary School,145,20,0,20
Redbridge,Al-Noor Primary School,28,0,0,0
Liverpool,St. Margaret's Anfield Church of England Primary School,456,64,9,73
Cheshire West and Chester,Hoole Church of England Primary School,401,67,9,76
Cheshire West and Chester,The Oaks Community Primary School,171,48,5,53
Liverpool,All Saints' Catholic Voluntary Aided Primary School,565,115,61,176
Nottingham,Djanogly City Academy,1106,87,5,92
Wolverhampton,Midpoint Centre (Key Stage 4 PRU),57,55,2,57
Wolverhampton,The Braybrook Centre (Key Stage 3 PRU),14,12,2,14
Essex,The St Aubyn Centre Education Department,2,2,0,2
Coventry,Coventry Extended Learning Centre,79,28,4,32
Hammersmith and Fulham,Normand Croft Community School for Early Years and Primary Education,226,37,13,50
Islington,New River College Medical,29,18,11,29
Birmingham,West Heath Primary School,404,74,12,86
Birmingham,Paganel Primary School,406,61,5,66
Tameside,Alder Community High School,936,151,26,177
Luton,Mehria Primary School,110,2,0,2
Derby,Normanton House School,118,0,0,0
Wigan,"Landgate School, Bryn",116,8,108,116
Sheffield,"Sharrow Nursery, Infant and Junior School",518,92,18,110
Leicester,Rolleston Primary School,430,59,10,69
Enfield,Starks Field Primary School,228,57,16,73
Enfield,Oasis Academy Enfield,815,60,19,79
Islington,St Mary Magdalene Academy,1536,202,34,236
North Lincolnshire,Options Barton,32,1,31,32
Leeds,Rufford Park Primary School,326,30,3,33
Milton Keynes,St Bernadette's Catholic Primary School,428,55,7,62
Halton,The Bridge School,37,32,5,37
Cheshire West and Chester,Kingsmead Primary School,318,43,5,48
Sefton,Springwell Park Community Primary School,462,111,6,117
Staffordshire,St Lukes CofE Primary School,417,44,3,47
Redbridge,Redbridge Alternative Provision,19,2,0,2
Lancashire,McKee College House,55,52,1,53
Ealing,Alec Reed Academy,1677,160,39,199
Sefton,Rimrose Hope CofE Primary School,333,65,6,71
Dorset,The Compass,42,15,27,42
"Bournemouth, Christchurch and Poole",Christchurch Learning Centre,19,19,0,19
Wakefield,Ossett South Parade Primary,434,75,21,96
Barking and Dagenham,Hopewell School,47,0,47,47
Shropshire,"Tuition, Medical and Behaviour Support Service",57,29,7,36
Derbyshire,New Direction,19,1,18,19
Essex,The Yellow House School,18,0,18,18
Greenwich,Right Choice Independent Special School,15,3,12,15
Leeds,Strawberry Fields Primary School,340,40,0,40
Leeds,Drighlington Primary School,424,58,1,59
Newham,Azhar Academy Girls School,519,17,2,19
Milton Keynes,Bow Brickhill CofE VA Primary School,83,14,4,18
Wokingham,The Vine Christian School,28,1,0,1
Coventry,Howes Community Primary School,152,38,11,49
Bradford,Al Mumin Primary and Secondary School,203,10,0,10
Leicestershire,Lewis Charlton Learning Centre,33,0,33,33
Norfolk,Include School Norfolk,83,40,20,60
Kent,OneSchool Global UK - Maidstone Campus,163,10,2,12
Norfolk,OneSchool Global UK - Swaffham Campus,103,8,1,9
Wiltshire,Oneschool Global Uk Salisbury Campus,205,34,3,37
Gloucestershire,OneSchool Global UK - Gloucester,148,29,0,29
Warwickshire,OneSchool Global UK,124,4,0,4
Reading,OneSchool Global Reading Senior Campus,64,8,1,9
Trafford,Afifah School,286,15,0,15
Liverpool,Pinehurst Primary School Anfield,435,57,11,68
Northumberland,Cragside CofE Controlled Primary School,357,56,7,63
Birmingham,St Peters CofE Primary School,446,86,5,91
Manchester,Sacred Heart RC Primary School,316,41,4,45
Suffolk,OneSchool Global UK Colchester Campus,133,11,0,11
Cheshire West and Chester,OneSchool Global Northwich,99,9,3,12
Central Bedfordshire,Oneschool Global Dunstable,160,33,2,35
Lambeth,The Orchard School,210,41,3,44
Leeds,Hollybush Primary,408,119,3,122
Kent,Downsview Community Primary School,174,27,5,32
Walsall,New Leaf Centre,71,33,0,33
Luton,Avenue Centre for Education,60,58,2,60
Sunderland,Wessington Primary School,243,36,7,43
Surrey,OneSchool Global UK - Hindhead Campus,177,68,3,71
Birmingham,Jamia Islamia Birmingham,111,14,0,14
Rochdale,Rochdale Islamic Academy,88,1,0,1
Newham,Zakariya Primary School,111,0,0,0
Waltham Forest,Walthamstow Montessori School,108,1,0,1
Enfield,Phoenix Academy,15,1,0,1
Kent,Kent College International Study Centre,18,0,0,0
Croydon,Al-Khair School,98,2,0,2
Bradford,The Fountain School,42,0,0,0
North Lincolnshire,OneSchool Global UK Ridgeway Campus,189,23,3,26
Newham,Madaniyah Foundation,27,0,0,0
Merton,Lavender Lodge School,65,0,65,65
Leicester,Emmanuel Christian School,51,0,1,1
Ealing,Ealing Primary Centre,3,0,3,3
Lancashire,St Francis of Assisi Catholic Primary School,164,16,6,22
Lancashire,Woodlands Community Primary School,385,69,9,78
Lancashire,Brookfield Park Primary School,169,49,2,51
Kent,The Quest School,24,0,24,24
Stockton-on-Tees,Fairfield Primary School,467,29,8,37
Stockport,Highfields College,99,66,33,99
Lancashire,The Rose School,66,0,66,66
Newham,Quwwat Ul Islam Girls' School,194,1,0,1
East Sussex,Step by Step School Limited,32,0,32,32
Hackney,New Regent's College,41,28,5,33
Leicestershire,Birch Wood (Melton Area Special School),224,0,224,224
Devon,Clyst Heath Nursery and Community Primary School,343,42,8,50
Bolton,Ladybridge High School,1068,93,11,104
Hampshire,Chiltern Primary School,200,43,8,51
County Durham,Seaham Trinity Primary School,424,87,5,92
Liverpool,Childwall Abbey School,179,0,179,179
Calderdale,Moorside Community Primary School,235,29,16,45
North Yorkshire,Cambian Scarborough School,20,0,20,20
St. Helens,Carr Mill Primary School,311,59,7,66
County Durham,The Oaks Secondary School,348,0,348,348
County Durham,Evergreen Primary School,195,0,195,195
Kensington and Chelsea,Notting Hill Prep School,443,118,0,118
Staffordshire,Chase View Community Primary School,185,48,7,55
Hounslow,Heathfield House School,162,15,2,17
Devon,West Exe Nursery School,140,11,0,11
Barnet,Woodcroft Primary School,440,50,6,56
Haringey,Chestnuts Primary School,422,52,15,67
Haringey,North Harringay Primary School,424,67,20,87
Barnsley,Kings Oak Primary Learning Centre,448,45,6,51
Hackney,Mossbourne Community Academy,1447,179,75,254
Somerset,Tor School,29,9,20,29
Somerset,South Somerset Partnership School,34,12,22,34
Somerset,Taunton Deane Partnership College,35,10,24,34
Luton,Beechwood Primary School,884,126,30,156
Redcar and Cleveland,South Bank Community Primary School,291,54,32,86
Stockton-on-Tees,Barley Fields Primary,703,120,11,131
Darlington,Whinfield Primary School,503,68,4,72
York,Applefields School,197,0,197,197
Surrey,Manorfield Primary and Nursery School,262,45,8,53
Hampshire,Cadland Primary School,387,39,15,54
Cumbria,Beckstone Primary School,374,51,4,55
Bracknell Forest,The Pines School,317,57,16,73
Wigan,Westfield Community School,470,77,19,96
Coventry,Willenhall Community Primary School,454,63,5,68
Sheffield,Pipworth Community Primary School,414,104,9,113
Somerset,The Bridge School Sedgemoor,34,9,25,34
Oldham,Kingsland School,42,38,4,42
Barnet,North London Grammar School,251,7,0,7
Cambridgeshire,Pilgrim Pathways School,1,0,0,0
Cheshire West and Chester,Ancora House School,8,4,4,8
Dudley,Sycamore Short Stay School,18,14,0,14
Hampshire,Sherfield School,603,129,3,132
Lancashire,Oneschool Global Uk Lancaster Campus,41,5,2,7
Derbyshire,St Joseph's Catholic and CofE (VA) Primary School,173,24,3,27
Birmingham,New Oscott Primary School,663,104,5,109
West Sussex,Kingslea Primary School,423,40,7,47
Stockport,Woodley Primary School,444,80,3,83
Bexley,Bishop Ridley Church of England VA Primary School,412,36,4,40
Cumbria,Cambian Whinfell School,12,0,12,12
Islington,The Gower School,283,37,0,37
Kent,Meadowfield School,410,20,390,410
Oldham,Higher Failsworth Primary School,426,64,10,74
Sefton,Thomas Gray Primary School,255,100,14,114
Cumbria,St Herbert's CofE (VA) Primary and Nursery School,286,21,9,30
West Sussex,Buckingham Park Primary School,548,81,10,91
Barnet,London Academy,1736,182,44,226
Haringey,The Avenue Pre-Preparatory School and Nursery,88,3,0,3
Luton,Jamiatul Uloom Al - Islamia,98,0,0,0
Luton,Bury Park Educational Institute  (Al - Hikmah Secondary School),165,0,0,0
Leicester,Al-Aqsa Schools Trust,296,5,2,7
Tower Hamlets,London East Academy,159,1,0,1
South Tyneside,Park View School,46,0,46,46
West Northamptonshire,Northampton Academy,1721,237,30,267
Lambeth,The Elms Academy,754,98,30,128
Westminster,Wetherby Preparatory School,384,55,0,55
Surrey,Undershaw Education Trust,102,0,102,102
Birmingham,Clifton Primary School,848,244,12,256
Nottingham,Dovecote Primary and Nursery School,372,27,3,30
Nottingham,Greenfields Community School,235,47,1,48
Hampshire,Lanterns Nursery School and Extended Services,100,38,0,38
Tameside,Ravensfield Primary School,442,147,8,155
Brent,Ashley College,0,0,0,0
Telford and Wrekin,Millbrook Primary School,465,59,6,65
Stockton-on-Tees,Harewood Primary School,447,87,7,94
County Durham,Prince Bishops Community Primary School,231,29,2,31
Kent,Greenfields Community Primary School,420,33,8,41
Devon,Devon Hospitals' Short Stay School,2,1,0,1
Southend-on-Sea,Eastwood Primary School & Nursery,465,49,8,57
St. Helens,Lansbury Bridge School,223,0,223,223
North Lincolnshire,Oakfield Primary School,307,46,9,55
Surrey,The Hope Service,0,0,0,0
Lancashire,The Acorns School,57,43,9,52
Staffordshire,Burton PRU,21,6,2,8
Stockport,Moorfield Primary School,409,40,28,68
Leeds,West Specialist Inclusive Learning Centre,245,1,244,245
Croydon,OneSchool Global Kenley Campus,108,25,2,27
St. Helens,Wargrave House School,64,0,64,64
Nottingham,Sutherland House School,54,0,54,54
Harrow,Regent Independent College,0,0,0,0
Peterborough,Park House,23,0,23,23
Cambridgeshire,The Vine Inter-Church Primary School,417,54,7,61
West Sussex,Sompting Village Primary School,460,122,19,141
Cheshire West and Chester,The Arches Community Primary School,203,63,8,71
Surrey,The Children's Trust School,41,5,36,41
Southwark,Rye Oak Primary School,275,74,29,103
Medway,Fairview Community Primary School,668,51,9,60
Birmingham,Elmhurst Ballet School,188,77,0,77
Somerset,3 Dimensions,33,0,33,33
Westminster,Abingdon House School,118,12,106,118
Leeds,Great Preston VC CofE Primary School,224,46,3,49
Bath and North East Somerset,St Keyna Primary School,265,56,15,71
Newham,New Directions,17,16,1,17
Warwickshire,Kingsbury Primary School,256,35,5,40
Gloucestershire,St Peter's Catholic Primary School,418,65,9,74
Harrow,St John's CofE School,338,42,3,45
Richmond upon Thames,Kew Green Preparatory School,268,65,0,65
Cambridgeshire,Granta School,179,0,179,179
Rutland,Wilds Lodge School,101,0,101,101
Southend-on-Sea,Estuary High School,8,2,2,4
Hampshire,Romsey Primary School,331,41,5,46
Norfolk,Mile Cross Primary School,460,89,14,103
Norfolk,Catton Grove Primary School,688,109,22,131
Norfolk,Recreation Road Infant School,350,55,4,59
Norfolk,Lakenham Primary School,439,105,8,113
Rochdale,Sandbrook Community Primary School,626,118,17,135
Blackpool,Moor Park Primary School,391,69,12,81
Coventry,Hospital Education Service,3,0,1,1
Kent,Laleham Gap School,219,0,219,219
Cambridgeshire,"Castle School, Cambridge",219,0,219,219
Leeds,Fountain Primary School,426,58,1,59
Wiltshire,Wylye Valley Church of England Voluntary Aided Primary School,121,15,1,16
Norfolk,Avocet House,7,0,7,7
Cambridgeshire,Orchard Park Community Primary School,172,48,11,59
Birmingham,Spring Hill High School,30,0,30,30
"Bournemouth, Christchurch and Poole",Highcliffe St Mark Primary School,652,54,17,71
Sefton,Trinity St Peter's CofE Primary School,239,24,6,30
Lancashire,Pendle Vale College,1064,116,30,146
Lancashire,Appletree Nursery School,58,12,0,12
Sandwell,Sandwell Academy,1325,112,21,133
Lancashire,Shuttleworth College,1103,232,33,265
Lancashire,Sir John Thursby Community College,1125,210,19,229
Telford and Wrekin,Meadows Primary School and Nursery,450,45,9,54
North Tyneside,Parkside House School,47,0,47,47
Lancashire,Unity College,1380,276,23,299
Hillingdon,The Harefield Academy,306,72,11,83
Doncaster,Trinity Academy,1254,156,12,168
Surrey,Leatherhead Trinity School and Nursery,385,77,18,95
Sutton,Sutton Tuition and Reintegration Service,5,4,1,5
Lancashire,Pendle View Primary School,126,0,126,126
Lancashire,Ridgewood Community High School,182,1,181,182
Lancashire,Holly Grove School,113,0,113,113
Lancashire,Pendle Community High School & College,162,0,162,162
Walsall,Moorcroft Wood Primary School,256,38,7,45
Rochdale,Woodland Community Primary School,530,87,17,104
Kent,Small Haven School,34,0,34,34
Cheshire West and Chester,Woodfall Primary School,486,62,21,83
Central Bedfordshire,Fairfield Park Lower School,489,37,6,43
Manchester,Manchester Jewish School for Special Education,20,0,20,20
Sandwell,Sacred Heart Primary School,448,33,7,40
Kirklees,Moorlands Primary School,628,59,16,75
Telford and Wrekin,Woodlands Primary School,439,120,5,125
Worcestershire,The Bewdley School,973,177,29,206
Worcestershire,St Anne's CofE VC Primary School,246,33,6,39
Worcestershire,Chaddesley Corbett Endowed Primary School,253,39,9,48
Worcestershire,Comberton Primary School,427,90,5,95
Worcestershire,Cookley Sebright Primary School,221,50,1,51
Worcestershire,Franche Primary School,866,146,8,154
Worcestershire,St Catherine's CofE (VC) Primary School,417,44,5,49
Worcestershire,Offmore Primary School,327,52,6,58
Worcestershire,St Mary's CofE (VA) Primary School,208,41,12,53
Worcestershire,Wolverley CofE Secondary School,920,111,32,143
West Northamptonshire,Hackleton CofE Primary School,204,10,1,11
Northumberland,Norham St Ceolwulfs CofE Controlled First School,29,6,0,6
North Lincolnshire,South Park Enterprise College (11-19),30,6,24,30
Norfolk,Acorn Park School,111,0,111,111
Worcestershire,Grove Primary School,151,42,6,48
Lewisham,Haberdashers' Knights Academy,1254,243,19,262
Salford,Salford City Academy,892,131,17,148
Barnet,Ellern Mede School Limited,40,24,16,40
Lewisham,Haberdashers' Hatcham College,1376,165,36,201
Derbyshire,OneSchool Global Uk Nottingham Campus,85,7,1,8
Worcestershire,Bewdley Primary School,473,85,3,88
East Riding of Yorkshire,Thorngumbald Primary School,202,18,4,22
East Riding of Yorkshire,Hallgate Primary School Cottingham,328,37,6,43
West Berkshire,The Winchcombe School,468,37,25,62
West Berkshire,Thatcham Park CofE Primary,411,44,10,54
Walsall,Barcroft Primary School,459,71,12,83
Hertfordshire,Longmeadow Primary School,227,41,7,48
Hertfordshire,Shephalbury Park Primary School,226,23,2,25
Sefton,St Benedict's Catholic Primary School,236,51,3,54
Barnet,Akiva School,421,20,10,30
Darlington,Harrowgate Hill Primary School,543,67,5,72
Hounslow,Oak Heights Independent School,80,2,2,4
Lancashire,Roselyn House School,74,0,74,74
Gloucestershire,Al Ashraf Primary School,153,8,2,10
Slough,Iqra Slough Islamic Primary School,617,84,24,108
Hampshire,Jubilee School,39,0,39,39
Kent,Palace Wood Primary School,417,41,9,50
Milton Keynes,Tickford Park Primary School,387,37,7,44
Nottingham,The Nottingham Nursery School and Training Centre,100,16,0,16
West Sussex,My Choice School Arundel,19,0,19,19
Darlington,Pear Tree School,16,6,10,16
East Riding of Yorkshire,Willerby Carr Lane Primary School,416,50,2,52
Kent,Hextable Primary School,609,126,18,144
Derby,Landau Forte College,1198,98,50,148
Tameside,Denton Community College,1380,105,19,124
Kent,Ashford Oaks Community Primary School,460,84,22,106
Stockton-on-Tees,Roseberry Primary School,367,86,7,93
Kent,Joy Lane Primary Foundation School,619,72,52,124
Cambridgeshire,Brampton Village Primary School,600,77,17,94
Cambridgeshire,The Bellbird Primary School,420,52,12,64
Cheshire West and Chester,Woodlands Primary School,513,31,16,47
Solihull,Kingshurst Primary School,485,109,9,118
Camden,North Bridge House Preparatory,394,87,0,87
Norfolk,Queen's Hill Primary School,590,86,18,104
Telford and Wrekin,Madeley Academy,1219,153,18,171
Ealing,Ayesha Siddiqa Girls School,87,0,0,0
Kent,Rusthall St Paul's CofE VA Primary School,138,24,4,28
Camden,"Gloucester House, The Tavistock Children's Day Unit",12,0,12,12
Salford,Beis Hatalmud School,121,0,0,0
Sandwell,Shireland Collegiate Academy,1557,134,18,152
Liverpool,The Belvedere Academy,1054,189,10,199
Hammersmith and Fulham,Parayhouse School,53,0,53,53
North East Lincolnshire,Oasis Academy Immingham,618,133,13,146
Wiltshire,Lyneham Primary School,301,73,13,86
West Sussex,Springboard Education,16,0,16,16
Leicestershire,Brooke House Day School,44,7,6,13
Derbyshire,Arnfield Independent School,10,7,3,10
Waltham Forest,Our Lady and St George's Catholic Primary School,365,42,19,61
Kent,Green Park Community Primary School,390,66,12,78
Kent,The Annex School House,6,1,5,6
Wigan,Newbridge Learning Community,87,0,87,87
Rochdale,Springside,120,2,118,120
Rochdale,Newlands School,121,1,120,121
Rochdale,Redwood,326,2,324,326
"Bristol, City of",Knowle Park Primary School,603,109,5,114
Swindon,Covingham Park Primary School,360,37,6,43
Birmingham,St Paul's School,45,0,45,45
North East Lincolnshire,Oasis Academy Wintringham,895,129,28,157
Leeds,Allerton CofE Primary School,703,104,3,107
Harrow,Cedars Manor School,432,47,20,67
Kent,Garlinge Primary School and Nursery,769,100,52,152
West Berkshire,The Willows Primary School,403,86,9,95
Kent,Newington Community Primary School,703,164,27,191
Sandwell,Pennyhill Primary School,633,80,7,87
Wakefield,Meadowcroft School,101,0,101,101
Leicestershire,Sketchley School,73,0,73,73
Lancashire,Rawdhatul Uloom,108,0,0,0
Hertfordshire,Maple Grove Primary School,220,64,3,67
Hertfordshire,Yewtree Primary School,361,55,9,64
Hertfordshire,Oak View Primary and Nursery School,430,41,14,55
Hertfordshire,Galley Hill Primary School and Nursery,433,96,11,107
Barnet,Martin Primary School,673,88,15,103
Bradford,Chellow Heights Special School,230,0,230,230
Bradford,Beechcliffe Special School,245,0,245,245
Bromley,Riverside School,332,0,332,332
Sandwell,George Salter Academy,1416,149,20,169
Surrey,Buckland Primary School,398,74,27,101
Hampshire,Fair Ways School,35,0,35,35
Derbyshire,The Meadows,4,3,1,4
Westminster,Ark King Solomon Academy,1303,186,35,221
Telford and Wrekin,Lightmoor Village Primary School,212,55,1,56
Cheshire West and Chester,Our Lady Star of the Sea Catholic Primary School,367,61,4,65
North Lincolnshire,Demeter House,91,0,91,91
Croydon,Harris Academy South Norwood,2155,350,20,370
Norfolk,Red Balloon - Norwich,27,0,27,27
Suffolk,Broadlands Hall,24,0,24,24
Sandwell,The Primrose Centre,6,5,1,6
Sandwell,Sandwell Community School,66,58,0,58
Cheshire West and Chester,Willow Wood Community Nursery & Primary School,302,33,21,54
Oldham,Bare Trees Primary School,664,77,12,89
Staffordshire,Stepping Stones School,14,0,14,14
Southwark,Southwark Inclusive Learning Service (Sils),48,44,1,45
Hounslow,The Rosary Catholic Primary School,399,31,7,38
Stockport,Stockport Academy,988,204,29,233
Peterborough,Thomas Deacon Academy,2406,148,42,190
Lewisham,St Matthew Academy,1052,138,19,157
Oxfordshire,Dunmore Primary School,422,61,12,73
Gloucestershire,King's Stanley CofE Primary School,212,28,9,37
Liverpool,Arnot St Mary CofE Primary School,439,127,9,136
Milton Keynes,Newton Leys Primary School,595,58,10,68
Milton Keynes,Brooklands Farm Primary School,1290,136,17,153
Wandsworth,L'Ecole de Battersea,242,9,1,10
Manchester,Park View Community Primary,407,72,9,81
Staffordshire,River View Primary and Nursery School,350,46,10,56
North Northamptonshire,Little Stanion Primary School,241,23,8,31
Newcastle upon Tyne,Brunton First School,450,20,2,22
Sheffield,Seven Hills School,212,0,212,212
Sandwell,Galton Valley Primary School,468,60,19,79
Kent,The Marsh Academy,1064,218,45,263
North Yorkshire,Stonegate School,4,1,1,2
North East Lincolnshire,Havelock Academy,1038,169,18,187
South Gloucestershire,John Cabot Academy,1247,199,16,215
Manchester,William Hulme's Grammar School,1595,187,59,246
Kent,The Leigh Academy,1359,177,38,215
Brent,Maple Walk School,169,10,0,10
"Bristol, City of",Bristol Brunel Academy,1331,222,41,263
Kent,Spires Academy,690,79,39,118
North Northamptonshire,Corby Business Academy,1143,132,109,241
Salford,St Edmund's RC Primary School,356,75,6,81
Croydon,Harris City Academy Crystal Palace,1271,105,11,116
Rochdale,St Anne's Church of England Academy,781,127,20,147
Darlington,St Aidan's Church of England Academy,551,61,13,74
Southwark,Ark Walworth Academy,1026,155,23,178
Wandsworth,Ashcroft Technology Academy,1427,191,47,238
North Northamptonshire,Brooke Weston Academy,1186,137,27,164
Somerset,Taunton Preparatory School,440,159,2,161
Dorset,Lulworth and Winfrith CofE VC Primary School,111,19,3,22
Cheshire East,Vernon Primary School,380,12,8,20
Essex,Epping Primary School,394,45,5,50
Gloucestershire,Gloucester and Forest Alternative Provision School,74,29,17,46
Gloucestershire,Severn Valley School,49,18,7,25
Coventry,Grace Academy Coventry,894,91,5,96
Luton,The Chalk Hills Academy,1575,170,22,192
Luton,The Stockwood Park Academy,1443,156,16,172
Oldham,Royton Hall Primary School,355,41,9,50
Derby,Kingsmead School,115,0,115,115
Lancashire,Sir Tom Finney Community High School,217,3,214,217
Lancashire,Acorns Primary School,88,0,88,88
Plymouth,Riverside Community Primary School,497,92,7,99
Gloucestershire,Kingsway Primary School,409,76,16,92
Swindon,Swindon Academy,1883,300,39,339
Oxfordshire,North Oxfordshire Academy,1001,174,21,195
Nottinghamshire,Colston Bassett School Limited,25,0,2,2
Bradford,Bradford Academy,1746,243,66,309
Kent,Cornwallis Academy,1337,147,26,173
Kent,New Line Learning Academy,719,87,22,109
Brent,Southover Partnership School,36,0,36,36
Bedford,Lakeview School,448,46,7,53
Cambridgeshire,Shelldene House School,6,0,6,6
Peterborough,Nene Gate,59,0,59,59
Lambeth,Ark Evelyn Grace Academy,464,58,9,67
Leicester,Al-Islamia Institute for Education,108,0,1,1
Nottinghamshire,Hope House School,27,0,27,27
Cambridgeshire,Heritage School,187,34,0,34
Cornwall,Taliesin Education Ltd,9,0,9,9
Surrey,Papillon House,43,0,43,43
Southwark,London Christian School,118,9,0,9
Cumbria,Kirby Moor School,54,1,51,52
Warwickshire,Henley-in-Arden Montessori Primary School,27,0,0,0
Surrey,Unsted Park School,81,0,81,81
Birmingham,Future First Independent School,6,0,6,6
Newcastle upon Tyne,Excelsior Academy,1497,314,34,348
Hartlepool,Cambian Hartlepool School,15,0,15,15
Kent,The Rosewood School,0,0,0,0
Nottinghamshire,Greasley Beauvale Primary School,382,59,5,64
Gloucestershire,Isbourne Valley School,82,17,0,17
Kent,Hope View School,97,0,97,97
Shropshire,Options Higford,29,0,29,29
Sandwell,Q3 Academy Great Barr,1177,86,20,106
Solihull,The Island Project School,17,0,17,17
Lancashire,Elm Tree Community Primary School,145,0,145,145
Nottinghamshire,Wadsworth Fields Primary School,295,30,1,31
Walsall,Elmwood School,77,0,77,77
Kent,Birchwood,0,0,0,0
Kent,Maidstone and Malling Alternative Provision,0,0,0,0
Kent,Enterprise Learning Alliance,0,0,0,0
Kent,Two Bridges School,0,0,0,0
Knowsley,All Saints Catholic High School,1127,199,26,225
Ealing,Khalsa Primary School,423,41,3,44
Walsall,Abu Bakr Boys School,103,3,0,3
Wiltshire,Bellefield Primary and Nursery School,331,80,10,90
Wiltshire,Bishopstrow College,54,1,0,1
Ealing,Insights Independent School,48,0,48,48
Telford and Wrekin,Dothill Primary School,348,58,4,62
Wirral,Pensby Primary School,242,53,4,57
Derbyshire,Sharley Park Community Primary School,400,88,6,94
Doncaster,Maple Medical PRU,22,0,22,22
Salford,The Clifton Centre,61,59,1,60
Cheshire West and Chester,St Saviour's Catholic Primary and Nursery School,223,10,10,20
Barnet,Wren Academy Finchley,1626,115,46,161
Tameside,Great Academy Ashton,1292,233,23,256
Kent,Compass Community School Coastal Park,25,1,24,25
Shropshire,The Henslow and Evolution School,26,6,20,26
Stockport,Penarth Group School,15,3,12,15
Hertfordshire,Killigrew Primary and Nursery School,390,32,7,39
Hampshire,Woodcroft Primary,199,35,7,42
Leicestershire,Quorn Hall School,63,0,63,63
Kensington and Chelsea,Chelsea Academy,1182,128,24,152
Haringey,TreeHouse School,100,0,100,100
Luton,Oakwood Primary School,143,1,0,1
Lancashire,Cumberland School,68,0,68,68
Lancashire,Aurora Keyes Barn School,19,0,19,19
Doncaster,Stone Hill School,140,0,140,140
Isle of Wight,Christ The King College,1108,160,30,190
Cumbria,Progress Schools - Carlisle,1,1,0,1
Wigan,Cambian Tyldesley School,27,1,26,27
Waltham Forest,Hawkswood Primary PRU,2,0,2,2
Birmingham,Flexible Learning School,82,0,4,4
Hounslow,Orchard Primary School,669,108,8,116
Lincolnshire,The Priory Witham Academy,1087,304,41,345
Lincolnshire,The Priory City of Lincoln Academy,986,171,28,199
Lincolnshire,The Priory Academy LSST,1756,124,17,141
Surrey,Cranleigh Church of England Primary School,225,64,9,73
Cheshire East,Cledford Primary School,321,37,14,51
Cambridgeshire,Huntingdon Primary School,395,24,24,48
Coventry,Castle Wood Special School,160,1,159,160
Nottingham,Oak Field School,161,8,153,161
"Bristol, City of",Bristol Cathedral Choir School,1176,136,54,190
Medway,Blue Skies School,15,0,15,15
Blackburn with Darwen,Darwen Aldridge Community Academy,1106,114,16,130
"Bristol, City of",Montpelier High School,931,82,22,104
Telford and Wrekin,Haberdashers' Abraham Darby,1106,174,27,201
Nottinghamshire,Samworth Church Academy,1036,87,22,109
Southwark,Ark Globe Academy,1334,262,38,300
Essex,Queen Boudica Primary School,417,43,9,52
Islington,City of London Academy Islington,897,132,37,169
Havering,Branfil Primary School,579,49,5,54
Hertfordshire,Stanborough Primary School,61,2,0,2
"Bristol, City of",Merchants' Academy,1303,244,49,293
"Kingston upon Hull, City of",Archbishop Sentamu Academy,1412,132,29,161
Sandwell,Gospel Oak School,1223,153,18,171
Brent,Ark Academy,1640,99,41,140
Buckinghamshire,Progress Schools - Buckinghamshire,7,0,7,7
West Sussex,Bolnore Village Primary School,412,89,8,97
Birmingham,TLG North Birmingham,7,1,0,1
Somerset,Oaklands Primary School,430,74,32,106
Lambeth,Iqra Primary School,239,13,10,23
Kensington and Chelsea,Snowflake School,42,2,40,42
Northumberland,Bede Academy,1987,209,40,249
Cumbria,Richard Rose Morton Academy,870,104,33,137
Cumbria,Richard Rose Central Academy,1026,62,21,83
Kent,Fairlight Glen Independent Special School,5,0,5,5
Southampton,Oasis Academy Lord's Hill,818,131,7,138
Southampton,Oasis Academy Mayfield,887,125,18,143
Kent,Longfield Academy,1035,149,75,224
Slough,The Langley Academy,1154,94,29,123
Cumbria,West Lakes Academy,1212,124,46,170
Salford,Aim Habonim,88,3,60,63
Northumberland,Grange View Church of England Voluntary Controlled First School,107,18,1,19
Cheshire West and Chester,Wharton CofE Primary School,309,66,5,71
Sunderland,The Link School,98,60,9,69
Manchester,The Divine Mercy Roman Catholic Primary School,469,83,7,90
Lancashire,Accrington Academy,1090,162,13,175
Norfolk,The Open Academy,601,123,25,148
Essex,New Rickstones Academy,1065,139,30,169
Essex,Greensward Academy,1571,159,34,193
Essex,Maltings Academy,891,88,27,115
Croydon,Oasis Academy Coulsdon,927,138,64,202
Liverpool,New Heights High School,93,62,9,71
Salford,Oasis Academy MediaCityUK,960,168,27,195
"Herefordshire, County of",The Hereford Academy,607,62,16,78
"Bristol, City of",Oasis Academy John Williams,867,88,21,109
Milton Keynes,The Milton Keynes Academy,1168,102,10,112
Bromley,The Tutorial Foundation,42,2,36,38
"Bristol, City of",Oasis Academy Brightstowe,754,107,26,133
"Herefordshire, County of",The Steiner Academy Hereford,339,83,14,97
Somerset,Petherton Park School,11,0,11,11
North Lincolnshire,The St Lawrence Academy,789,107,17,124
Westminster,Pimlico Academy,1136,83,48,131
Bexley,Harris Academy Falconwood,1290,120,31,151
Haringey,Kestrel House School,39,0,39,39
Harrow,Red Balloon Learner Centre - Northwest London,42,0,42,42
Birmingham,Green Heath School,2,0,2,2
Suffolk,The Meadows Montessori School,67,14,1,15
West Sussex,Seadown School,30,0,30,30
Wokingham,OneSchool Global UK Reading Primary Campus,34,9,0,9
East Riding of Yorkshire,Hilderthorpe Primary School,388,50,13,63
Oldham,Holy Cross Ceva Primary School,452,116,12,128
Kent,Oasis Academy Isle of Sheppey,1486,475,64,539
Gloucestershire,Finlay Community School,385,137,15,152
Hammersmith and Fulham,Young Dancers Academy,45,17,0,17
Somerset,Inaura School,26,0,26,26
Cheshire West and Chester,Saughall All Saints Church of England Primary School,270,18,2,20
Rotherham,The Rowan Centre,0,0,0,0
West Sussex,The Sir Robert Woodard Academy,1380,279,36,315
West Sussex,The Littlehampton Academy,1402,238,37,275
Stockport,Alexandra Park Primary School,421,59,8,67
Barnet,JCoSS,1347,7,98,105
Halton,Weston Point College,24,0,24,24
Rochdale,Great Howarth School,28,0,28,28
West Northamptonshire,Progress Schools - Northamptonshire,14,9,3,12
West Sussex,Midhurst Rother College,1170,242,23,265
Nottingham,Nottingham University Samworth Academy,835,139,16,155
Wandsworth,Saint John Bosco College,843,122,76,198
Walsall,Ormiston Shelfield Community Academy,1383,265,43,308
Bolton,Essa Academy,1091,193,19,212
Devon,Acorn School,40,0,40,40
Essex,Poplar Adolescent Unit,1,1,0,1
"Bristol, City of",Sea Mills Primary School,255,57,3,60
West Northamptonshire,St Andrew's College,19,13,6,19
Shropshire,Meole Brace Church of England Primary and Nursery,446,49,11,60
Shropshire,Bishop Hooper Church of England Primary School,121,13,5,18
Worcestershire,Wyre Forest School,324,22,302,324
Sandwell,The British Muslim School,83,0,0,0
Ealing,North West London Independent Special School,63,0,63,63
Knowsley,Hope Primary School - A Joint Catholic and Church of England Primary School,456,63,10,73
Swindon,Oakhurst Community Primary School,430,52,8,60
West Northamptonshire,"OneSchool Global Uk, Northampton Primary Campus",22,8,0,8
Sutton,Greenholm School,119,0,119,119
Devon,Cambian Devon School,21,0,21,21
Wiltshire,The Wellington Academy,1120,152,33,185
Buckinghamshire,Benjamin College,12,7,5,12
Knowsley,Northwood Community Primary School (With Designated Special Provision),486,97,48,145
Havering,Crowlands Primary School,659,49,10,59
West Sussex,Billingshurst Primary School,615,72,8,80
West Sussex,Ingfield Manor School,63,0,63,63
Sheffield,Paces High Green School for Conductive Education,46,0,46,46
Southwark,Harris Boys' Academy East Dulwich,878,115,14,129
Sunderland,Castle View Enterprise Academy,1021,145,20,165
Lancashire,Abrar Academy,79,1,0,1
Hampshire,Forest Park School,144,0,144,144
Kent,The Royal Harbour Academy,929,233,47,280
South Gloucestershire,New Horizons Learning Centre,63,0,63,63
Somerset,North Petherton Primary School,403,30,8,38
Hounslow,Bedfont Primary School,607,86,10,96
Somerset,"Oake, Bradford and Nynehead VC Primary",106,12,1,13
County Durham,The Grange Learning Centre,17,3,14,17
Hackney,"The City Academy, Hackney",1138,175,54,229
Essex,Teaseldown School,25,0,25,25
County Durham,Shotton Hall Primary School,351,17,5,22
Enfield,Freshsteps Independent school,42,1,41,42
Wigan,Leigh St Peter's CofE Primary School,355,87,8,95
South Tyneside,Forest View Primary,245,31,2,33
Lewisham,Prendergast Vale School,830,120,7,127
Plymouth,Oneschool Global Uk Plymouth Campus,87,17,2,19
North Yorkshire,Hambleton/Richmondshire Pupil Referral Service,14,9,1,10
North Yorkshire,Craven Pupil Referral Service,2,2,0,2
Gloucestershire,Oakwood Primary School,352,92,13,105
Leicester,Land of Learning Primary School,209,2,0,2
Norfolk,Future Education,38,0,38,38
Lancashire,"Trinity Church of England/Methodist Primary School, Buckshaw Village",611,63,4,67
Calderdale,Walsden St Peter's CE (VC) Primary School,171,22,4,26
Tameside,Droylsden Academy,919,152,39,191
Bradford,Dixons Allerton Academy,1890,251,28,279
"Bristol, City of",Air Balloon Hill Primary School,737,132,9,141
"Bristol, City of",St Peter's Church of England Primary School (VC),472,71,15,86
Manchester,Manchester Enterprise Academy,1274,238,50,288
Hertfordshire,Future Academies Watford,1123,152,20,172
Wirral,Birkenhead High School Academy,1210,158,27,185
Sunderland,Red House Academy,423,103,3,106
Buckinghamshire,The Aylesbury Vale Academy,1814,287,50,337
Hounslow,Chatsworth Primary School,667,83,7,90
Nottingham,Nottingham Academy,2263,206,14,220
Birmingham,The Wisdom Academy,227,0,0,0
Hampshire,Cranford Park Primary,181,18,7,25
Northumberland,NCEA Duke's Secondary School,1018,167,26,193
Hampshire,Endeavour Primary School,777,95,45,140
Kent,Skinners' Kent Academy,1084,217,23,240
Hertfordshire,Rivers Education Support Centre,16,8,2,10
Surrey,North East Surrey Secondary Short Stay School,13,10,0,10
Surrey,North West Surrey Short Stay School,20,15,4,19
Essex,The Basildon Lower Academy,925,123,20,143
Essex,The Basildon Upper Academy,781,66,14,80
Lewisham,Marathon Science School,60,0,0,0
Essex,Riverside Primary School,358,23,8,31
Norfolk,City Academy Norwich,699,132,23,155
Birmingham,Heartlands Academy,799,100,16,116
Birmingham,Shenley Academy,825,158,17,175
Worcestershire,Tudor Grange Academy Worcester,1122,148,27,175
West Sussex,LVS Hassocks,61,0,61,61
Sheffield,Parkwood E-ACT Academy,794,165,15,180
Leeds,Leeds West Academy,1407,263,6,269
Lancashire,Fulwood Academy,759,113,9,122
Cumbria,Furness Academy,1159,126,65,191
Doncaster,De Warenne Academy,746,64,11,75
"Kingston upon Hull, City of",Sirius Academy West,1479,289,36,325
Central Bedfordshire,All Saints Academy Dunstable,664,110,21,131
Bexley,Haberdashers' Crayford Academy,1040,120,20,140
Salford,The Canterbury Centre,5,3,0,3
Croydon,Harris Academy Purley,1097,155,12,167
Walsall,Grace Academy Darlaston,984,214,35,249
Essex,Clacton Coastal Academy,1415,344,31,375
Enfield,Oasis Academy Hadley,1537,287,37,324
"Bristol, City of",Bristol Metropolitan Academy,1083,186,28,214
Thurrock,Ormiston Park Academy,694,84,36,120
Wakefield,Outwood Grange Academy,1995,106,31,137
West Sussex,Shoreham Academy,1734,266,57,323
Doncaster,Outwood Academy Adwick,1080,204,23,227
Medway,Strood Academy,1273,158,12,170
Portsmouth,Ark Charter Academy,853,212,20,232
North Northamptonshire,Kettering Buccleuch Academy,1858,278,26,304
North Northamptonshire,Kettering Science Academy,1404,171,28,199
Croydon,Oasis Academy Shirley Park,1828,155,36,191
Birmingham,Ark St Alban's Academy,901,87,11,98
Solihull,Park Hall Academy,1267,146,21,167
Brent,E-ACT Crest Academy,1230,75,17,92
Tameside,Ashlea House School,7,1,6,7
Sandwell,Ormiston Sandwell Community Academy,1141,138,32,170
Peterborough,Ormiston Bushfield Academy,1113,174,19,193
Gloucestershire,Cirencester Primary School,306,64,11,75
Bedford,Esland Bedford School,23,0,17,17
Haringey,Assunnah Primary School,129,2,1,3
Tower Hamlets,Faraday School,102,6,2,8
Bedford,Cambian Walnut Tree Lodge School,10,7,3,10
Reading,The Deenway Montessori School,44,2,0,2
Bedford,Great Denham Primary School,613,62,20,82
Wigan,Green Meadow Independent Primary School,25,4,0,4
Gateshead,The Gateshead Cheder Primary School,392,50,4,54
Lancashire,Aurora Brambles School,57,0,57,57
Wakefield,Horbury St Peter's and Clifton CofE (VC) Primary School,422,45,14,59
Nottinghamshire,Abbey Hill Primary & Nursery,254,60,0,60
Isle of Wight,Queensgate Foundation Primary,396,88,10,98
Isle of Wight,Medina College,1361,195,63,258
Isle of Wight,Carisbrooke College,597,63,46,109
Isle of Wight,The Bay Church of England School,1272,210,71,281
Barnet,Edgware Jewish Girls - Beis Chinuch,281,37,2,39
Hackney,Bnos Zion of Bobov,276,16,9,25
Gloucestershire,"All Saints' Academy, Cheltenham",1062,181,45,226
Wiltshire,On Track Education Centre Westbury,33,0,33,33
Peterborough,Iqra Academy,64,0,1,1
Oldham,Oasis Academy Oldham,1474,201,25,226
Barking and Dagenham,Dagenham Park CofE School,1441,155,70,225
Birmingham,North Birmingham Academy,1023,142,10,152
Essex,Children's Support Service Langdon Hills Basildon,58,36,22,58
Nottinghamshire,Wings School Notts,35,16,18,34
Wakefield,The Grange School,13,0,13,13
Rotherham,Maltby Academy,1131,219,31,250
Lincolnshire,St George's Academy,2351,255,79,334
Hillingdon,Lady Nafisa School,83,6,1,7
Cambridgeshire,Gretton School,131,0,131,131
Newham,East London Independent School,152,0,152,152
Wirral,Millfields Church of England (Controlled) Primary School,148,36,1,37
Kensington and Chelsea,Chepstow House School,397,97,0,97
North Lincolnshire,St Peter and St Paul CofE Primary School,319,41,4,45
Warwickshire,Outwoods Primary School,420,65,17,82
Liverpool,Holy Family Catholic Primary School,213,56,2,58
South Gloucestershire,Watermore Primary School,417,67,10,77
Swindon,East Wichel Primary School & Nursery,419,37,7,44
Lancashire,Brook View School,5,0,5,5
Derby,Newton's Walk,12,10,2,12
Gloucestershire,Coopers Edge School,418,136,14,150
Salford,River View Community Primary School,509,101,49,150
Hampshire,Barncroft Primary School,407,61,21,82
Salford,Willow Tree Primary School,471,97,5,102
Salford,Holy Family VA RC Primary School,238,24,5,29
Cambridgeshire,Abbey College Cambridge,450,18,0,18
Bedford,Bedford Academy,1309,109,29,138
Salford,Beis Ruchel Girls School,201,14,3,17
Trafford,St Vincent's Catholic Primary School,629,32,11,43
Sefton,Olsen House School,54,0,54,54
Havering,Drapers' Academy,1216,107,33,140
Sandwell,The Phoenix Collegiate,1917,279,28,307
Greenwich,Wize Up,59,20,3,23
Calderdale,Trinity Academy Halifax,1605,230,42,272
Lancashire,Al-Ikhlaas Primary School,159,0,0,0
Greenwich,StreetVibes Media Academy,22,18,2,20
Stoke-on-Trent,Co-op Academy Stoke-On-Trent,1120,202,29,231
Manchester,Manchester Communication Academy,1224,210,31,241
East Sussex,The Eastbourne Academy,856,133,22,155
Medway,Brompton Academy,1403,261,120,381
Medway,The Victory Academy,1188,203,14,217
Kirklees,St Thomas CE (VC) Primary School,409,52,16,68
Wandsworth,Roehampton Gate School,68,0,68,68
"Bristol, City of",Two Mile Hill Primary School,569,54,7,61
Hampshire,New Forest Small School,74,23,6,29
West Sussex,Woodlands Meed,274,0,274,274
Oldham,The Oldham Academy North,1338,83,19,102
Salford,Beis Malka Girls school,294,47,5,52
Liverpool,Kensington Primary School,537,76,10,86
Liverpool,The Academy of St Nicholas,901,196,25,221
"Bournemouth, Christchurch and Poole",The Bishop of Winchester Academy,1161,210,33,243
Bedford,KWS School,18,1,17,18
Birmingham,Hazrat Khadijatul Kubra Girls School,128,0,0,0
Wirral,Holy Spirit Catholic and Church of England Primary School,204,77,13,90
"Bournemouth, Christchurch and Poole",The Bourne Academy,953,156,53,209
Coventry,Sidney Stringer Academy,1467,253,29,282
Derbyshire,Shirebrook Academy,841,157,15,172
Kent,Knole Academy,1373,213,45,258
Bolton,Kearsley Academy,730,95,18,113
Staffordshire,"Landau Forte Academy, Amington",954,121,15,136
Hackney,Skinners' Academy,1064,110,31,141
St. Helens,The Sutton Academy,1414,263,24,287
Plymouth,All Saints Church of England Academy,597,251,18,269
Salford,Tiferes,389,59,4,63
Stoke-on-Trent,Ormiston Sir Stanley Matthews Academy,1154,156,37,193
Stockton-on-Tees,North Shore Academy,734,126,14,140
Enfield,Aylward Academy,1383,550,32,582
Birmingham,King Edward VI Sheldon Heath Academy,1190,197,11,208
Milton Keynes,Broughton Manor Preparatory School,296,27,0,27
Hampshire,Havant Academy,567,153,32,185
Warwickshire,Nuneaton Academy,928,176,12,188
Worcestershire,The Forge Secondary Short Stay School,28,27,1,28
East Sussex,Annan School,104,12,2,14
South Tyneside,Hebburn Lakes Primary School,469,106,10,116
Brighton and Hove,Brighton Aldridge Community Academy,838,176,51,227
Derbyshire,Bradshaw Farm Independent School,3,1,2,3
Derbyshire,Old Sams Farm Independent School,4,1,3,4
Hammersmith and Fulham,Hammersmith Academy,929,95,36,131
Manchester,Co-op Academy Manchester,1620,266,46,312
Kent,Dover Christ Church Academy,808,231,85,316
Kent,Duke of York's Royal Military School,501,56,1,57
South Tyneside,Harton Primary School,687,138,4,142
Wiltshire,Sarum Academy,693,198,46,244
Cheshire West and Chester,The Winsford Academy,1056,192,30,222
Halton,Ormiston Bolingbroke Academy,1011,131,15,146
Norfolk,Ormiston Victory Academy,1330,184,42,226
Norfolk,Ormiston Venture Academy,887,235,44,279
Bradford,Eternal Light,168,0,0,0
Hounslow,Heston Primary School,431,66,5,71
North East Lincolnshire,Cleethorpes Academy,884,92,15,107
Somerset,The Taunton Academy,872,160,31,191
Lincolnshire,The Priory Ruskin Academy,1406,215,55,270
Essex,Colchester Academy,897,218,17,235
Kent,The John Wallis Church of England Academy,1763,312,59,371
Bradford,Carlton Keighley,714,89,25,114
Devon,Dartmouth Academy,403,70,23,93
West Northamptonshire,Malcolm Arnold Academy,1404,163,21,184
Norfolk,King's Lynn Academy,945,123,38,161
Croydon,The Quest Academy,960,149,12,161
Norfolk,The Thetford Academy,1258,117,43,160
Kent,Wilmington Academy,1388,178,45,223
"Bournemouth, Christchurch and Poole",St Aldhelm's Academy,851,223,26,249
Richmond upon Thames,Richmond Park Academy,994,121,35,156
Southampton,Fitrah Sips,0,0,0,0
Kent,Birtley House Independent School,42,2,40,42
Birmingham,Harborne Academy,606,92,9,101
Lincolnshire,Skegness Academy,1029,269,50,319
Stoke-on-Trent,Glebedale School,25,0,25,25
Knowsley,Stockbridge Village Primary School,222,53,11,64
Oldham,Hodge Clough Primary School,452,42,9,51
Croydon,Cumnor House School,124,2,0,2
West Northamptonshire,On Track Education,44,1,43,44
Bromley,TLC The Learning Centre,45,0,45,45
Stockport,Willow House School,7,3,4,7
Brent,Bnos Beis Yaakov Primary School,108,19,0,19
Nottingham,Rufford Primary and Nursery School,413,78,4,82
Cambridgeshire,Begdale House School,12,0,12,12
Lancashire,The Alternative School,89,71,18,89
Trafford,Fairfield House School,8,0,8,8
Cambridgeshire,Queen Emma Primary School,475,38,13,51
Manchester,TLG Manchester,4,1,2,3
Redbridge,Stradbroke,2,1,1,2
Staffordshire,Pace Education,22,0,22,22
Kent,Goat Lees Primary School,212,19,14,33
South Tyneside,Keelman's Way School,166,0,166,166
Rochdale,Meadows School,10,4,6,10
Newcastle upon Tyne,Bahr Academy,30,0,0,0
Middlesbrough,Keys Tees Valley College,51,0,8,8
Worcestershire,Our Place School,12,0,12,12
Oxfordshire,Oxford Spires Academy,1345,162,27,189
Worcestershire,Norton College,80,0,80,80
Barnet,The Holmewood School,76,0,76,76
Manchester,Manchester  Young Lives,0,0,0,0
Bromley,Baston House School,109,0,109,109
Peterborough,Arthur Mellows Village College,1660,139,27,166
Redbridge,Chadwell Heath Academy,1247,107,36,143
North East Lincolnshire,Waltham Toll Bar Academy,1971,131,11,142
Cornwall,St Buryan Primary School,73,13,0,13
Kent,Westlands Primary School,578,92,17,109
Suffolk,Hartismere School,1048,136,18,154
Southend-on-Sea,Westcliff High School for Boys Academy,1267,40,1,41
Tameside,Audenshaw School,1106,38,17,55
Nottinghamshire,Barnby Road Academy Primary and Nursery school,601,85,2,87
Milton Keynes,The Premier Academy,631,184,8,192
Hertfordshire,Watford Grammar School for Boys,1533,99,53,152
North East Lincolnshire,Healing Academy,930,66,11,77
Cheshire East,The Fallibroome Academy,1564,104,44,148
Cheshire East,Brine Leas School,1431,157,32,189
Devon,Broadclyst Community Primary School,513,55,4,59
Bromley,Kemnal Technology College,588,174,13,187
Kirklees,Heckmondwike Grammar School,1520,16,6,22
Cumbria,Seaton Academy,204,3,2,5
Kent,Westlands School,1784,162,105,267
Devon,Uffculme School,1069,62,36,98
Hertfordshire,Watford Grammar School for Girls,1451,65,7,72
Barnet,"Queen Elizabeth's School, Barnet",1297,11,3,14
Nottinghamshire,George Spencer Academy,1628,118,8,126
Gloucestershire,The Cotswold Academy,1414,150,36,186
Swindon,Goddard Park Community Primary School,552,98,19,117
Somerset,Huish Episcopi Academy,1417,168,21,189
Somerset,Holyrood Academy,1319,177,28,205
Wiltshire,Hardenhuish School,1531,177,45,222
Trafford,Urmston Grammar Academy,1100,55,10,65
Southwark,The Charter School North Dulwich,1289,230,61,291
West Northamptonshire,Northampton School for Boys,1607,263,13,276
Rotherham,Brinsworth Academy,1481,93,50,143
Kent,The Canterbury Academy,1844,77,96,173
Walsall,Park Hall Infant Academy,328,30,1,31
Kent,Orchards Academy,585,91,22,113
Kent,Highsted Grammar School,889,62,4,66
Gloucestershire,Sir Thomas Rich's School,1226,48,6,54
Reading,Highdown School and Sixth Form Centre,1575,164,17,181
Barnet,Ashmole Academy,1893,50,40,90
Southwark,Kingsdale Foundation School,2513,460,75,535
Solihull,"Tudor Grange Academy, Solihull",1709,142,40,182
Bath and North East Somerset,Somervale Secondary School,713,153,37,190
Cornwall,Trenance Learning Academy,333,39,1,40
Medway,The Rochester Grammar School,1182,35,0,35
Lincolnshire,Queen Elizabeth's Grammar Alford - A Selective Academy,527,15,6,21
Suffolk,Forest Academy,436,74,13,87
Kent,Sandwich Technology School,1353,199,13,212
Cornwall,Sandy Hill Academy,415,61,19,80
Luton,Denbigh High School,1129,124,44,168
Solihull,St Patricks Church of England Primary Academy,246,32,2,34
Torbay,Torquay Boys' Grammar School,1075,23,4,27
Suffolk,Samuel Ward Academy,1219,110,16,126
Staffordshire,John Taylor High School,1557,135,22,157
Kent,Fulston Manor School,1340,178,50,228
Essex,R A Butler Infant School,272,23,9,32
Leeds,Green Lane Primary Academy,453,57,3,60
Enfield,Kingsmead School,1542,81,28,109
Essex,R A Butler Junior School,365,59,12,71
Hillingdon,Guru Nanak Sikh Academy,1603,124,25,149
Rotherham,Wales High School,1850,261,62,323
Cambridgeshire,Crosshall Infant School Academy Trust,312,53,7,60
Solihull,Arden,1805,217,21,238
Bexley,Beths Grammar School,1736,7,8,15
Bath and North East Somerset,Norton Hill Academy,1857,228,32,260
Devon,Ivybridge Community College,2469,300,39,339
Medway,Fort Pitt Grammar School,895,16,1,17
Surrey,Cleves School,720,62,14,76
Cambridgeshire,Crosshall Junior School,434,85,16,101
Cheshire East,Sandbach High School and Sixth Form College,1398,36,16,52
Hounslow,Lampton Academy,1536,205,40,245
Essex,King Harold Business & Enterprise Academy,760,149,15,164
Leeds,Garforth Academy,1900,196,16,212
Kent,The Canterbury Primary School,408,45,23,68
Central Bedfordshire,Lark Rise Academy,365,24,6,30
Solihull,John Henry Newman Catholic College,1322,202,18,220
Newcastle upon Tyne,Gosforth Junior High Academy,752,82,19,101
Kent,Hayesbrook Academy,477,71,12,83
Lincolnshire,Caistor Grammar School,687,10,6,16
Kent,Meopham Community Academy,467,38,5,43
Newcastle upon Tyne,Gosforth Academy,1932,161,29,190
Gloucestershire,Pate's Grammar School,1243,50,3,53
Lincolnshire,Bourne Abbey Church of England Primary Academy,675,48,20,68
Bromley,Darrick Wood School,1713,244,80,324
Norfolk,Martham Academy and Nursery,370,44,7,51
Cumbria,Queen Elizabeth School,1174,191,20,211
Lincolnshire,Branston Community Academy,1235,193,28,221
Kent,Dartford Grammar School,1516,95,8,103
Nottinghamshire,Redhill Academy,1583,129,11,140
Waltham Forest,Roger Ascham Primary School,442,91,18,109
Waltham Forest,Yardley Primary School,478,27,12,39
Lancashire,Hambleton Primary Academy,252,18,0,18
Devon,Colyton Grammar School,1038,34,5,39
Devon,Kingsbridge Academy,1294,198,33,231
"Bournemouth, Christchurch and Poole",Parkstone Grammar School,1224,175,8,183
Bexley,Bexley Grammar School,1462,22,14,36
Buckinghamshire,Unity College,11,4,7,11
"Herefordshire, County of",Wigmore Primary School,165,11,5,16
Calderdale,The Greetland Academy,413,32,7,39
Trafford,Park Road Academy Primary School,240,20,7,27
Trafford,Wellington School,1498,190,64,254
Trafford,Wellacre Technology Academy,653,78,19,97
Kent,Highworth Grammar School,1542,73,4,77
Plymouth,Oreston Community Academy,440,47,5,52
Lancashire,Lancaster Girls' Grammar School,1006,85,0,85
Kent,Chatham & Clarendon Grammar School,1503,21,4,25
Cornwall,Bodmin College,1564,190,81,271
Cornwall,Newquay Junior Academy,506,67,14,81
South Tyneside,Whitburn Church of England Academy,1225,125,16,141
Torbay,Churston Ferrers Grammar School Academy,1034,46,12,58
Wiltshire,Lavington School,858,52,23,75
Lancashire,Clitheroe Royal Grammar School,1417,83,1,84
Wiltshire,South Wilts Grammar School,1142,53,1,54
Leeds,The Morley Academy,1429,194,10,204
Kent,St Stephen's Junior School,404,48,18,66
Wakefield,Outwood Academy City Fields,799,38,23,61
Bolton,Lever Edge Primary Academy,511,68,4,72
Hertfordshire,The Broxbourne School,1332,99,19,118
Peterborough,The King's (The Cathedral) School,1242,40,33,73
"Herefordshire, County of",John Kyrle High School and Sixth Form Centre Academy,1425,229,13,242
East Sussex,The St Leonards Academy,1432,251,41,292
East Sussex,The Hastings Academy,862,234,19,253
Barnet,Beit Shvidler Primary School,234,41,12,53
"Herefordshire, County of",Wigmore School,442,72,9,81
Birmingham,"Ninestiles, an Academy",1489,237,55,292
Hampshire,Pilgrims' Cross CofE Aided Primary School,394,41,17,58
Wirral,Birkenhead Park School,757,249,9,258
Essex,Chelmsford County High School for Girls,1163,28,2,30
Waltham Forest,Hillyfield Primary Academy,1257,106,71,177
Staffordshire,The de Ferrers Academy,2444,209,34,243
Lincolnshire,William Farr CofE Comprehensive School,1428,137,42,179
Suffolk,Debenham High School,681,66,14,80
Kent,Tonbridge Grammar School,1131,99,2,101
Barnet,The Compton School,1350,176,46,222
Buckinghamshire,Dr Challoner's Grammar School,1368,80,12,92
Slough,Upton Court Grammar School,1151,39,4,43
St. Helens,Hope Academy,1351,238,30,268
Lewisham,Drumbeat School and ASD Service,231,0,231,231
Nottingham,Green Crescent School,156,0,0,0
Stockport,"St. Joseph's Catholic Primary School, Reddish",503,53,8,61
Barking and Dagenham,George Carey Church of England Primary School,666,106,21,127
Oldham,Blessed John Henry Newman Roman Catholic College,1502,175,47,222
Suffolk,West Lodge School,4,0,4,4
Telford and Wrekin,Priorslee Academy,450,17,7,24
Birmingham,Harper Bell Seventh-day Adventist School,179,22,0,22
Essex,The Flitch Green Academy,277,21,6,27
Cambridgeshire,Linton Village College,827,116,22,138
Southend-on-Sea,Southend High School for Boys,1317,29,10,39
Southend-on-Sea,Southend High School for Girls,1245,24,1,25
Ealing,Christ the Saviour Church of England Primary School,897,131,28,159
Hampshire,The Priory Primary School,183,21,5,26
Reading,Kendrick School,865,14,2,16
Reading,Reading School,1119,24,6,30
Lambeth,Platanos College,844,237,29,266
County Durham,The Academy at Shotton Hall,1162,156,4,160
Suffolk,Ipswich Academy,1001,75,33,108
Milton Keynes,Oakgrove School,2418,128,37,165
Kent,Weald of Kent Grammar School,1966,88,1,89
Medway,Rainham School for Girls,1668,187,12,199
Reading,Churchend Primary Academy,453,60,12,72
Trafford,Altrincham Grammar School for Boys,1349,98,3,101
Warwickshire,The Polesworth School,1471,207,23,230
Stoke-on-Trent,St Joseph's College,1156,24,5,29
Wakefield,Ossett Academy and Sixth Form College,1739,108,35,143
Cambridgeshire,Comberton Village College,1935,281,156,437
Bromley,Coopers School,1393,192,31,223
Kent,Herne Bay High School,1586,137,43,180
Bromley,Bishop Justus CofE School,1365,161,16,177
Bromley,Chislehurst School for Girls,1057,98,12,110
Milton Keynes,Denbigh School,1774,113,33,146
Worcestershire,Prince Henry's High School,1285,35,8,43
Bedford,Sharnbrook Academy,1741,51,20,71
Bedford,Lincroft Academy,1007,84,41,125
Gloucestershire,Balcarras School,1383,90,32,122
Lincolnshire,Charles Read Academy,272,84,21,105
West Northamptonshire,Nicholas Hawksmoor Primary School,423,49,3,52
Norfolk,Wymondham College,1424,148,23,171
Hertfordshire,Hockerill Anglo-European College,925,94,41,135
Bath and North East Somerset,Oldfield School,1243,175,48,223
Buckinghamshire,"The Royal Grammar School, High Wycombe",1424,19,10,29
Sunderland,Town End Academy,240,67,9,76
Sunderland,Bexhill Academy,347,83,11,94
West Northamptonshire,Sponne School,1436,159,10,169
West Northamptonshire,Guilsborough Academy,1336,177,16,193
Southend-on-Sea,Westcliff High School for Girls,1333,45,4,49
Lincolnshire,De Aston School,1004,197,31,228
Devon,Bradworthy Primary Academy,219,20,2,22
Devon,"Teignmouth Community School, Mill Lane",244,54,6,60
Devon,Teign School,1021,210,33,243
Devon,"Teignmouth Community School, Exeter Road",957,138,29,167
Plymouth,Devonport High School for Boys,1238,53,6,59
North Yorkshire,Harrogate Grammar School,2115,336,47,383
Trafford,Sale Grammar School,1331,159,13,172
Kent,Amherst School,379,31,11,42
Wiltshire,Bishop Wordsworth's Church of England Grammar School,1178,10,0,10
Kent,Sir Roger Manwood's School,979,107,2,109
Kirklees,North Huddersfield Trust School,920,153,17,170
Salford,Toras Emes,265,40,2,42
Hammersmith and Fulham,TLG West London,6,3,2,5
Derbyshire,The Ecclesbourne School,1607,121,25,146
Torbay,Torquay Girls Grammar School,997,95,3,98
Warwickshire,Northleigh House School,36,0,36,36
Kirklees,Whitechapel Church of England Primary School,405,56,13,69
Reading,Whitley Park Primary and Nursery School,577,146,25,171
Peterborough,Saint Michael CofE Primary School (Voluntary Aided),421,40,21,61
Norfolk,Springwood High School,1880,110,30,140
Telford and Wrekin,Newport Girls' High School Academy,737,36,1,37
Bromley,Ravens Wood School,1612,240,32,272
Cheshire East,Mottram St Andrew Primary Academy,189,4,1,5
Hillingdon,Haydon School,1697,80,13,93
Slough,Langley Grammar School,1265,30,6,36
Hounslow,Cranford Community College,1491,209,45,254
Cornwall,Bodriggy Academy,313,45,4,49
Cornwall,Camborne Science and International Academy,1870,186,36,222
Darlington,Hurworth School,672,57,40,97
Cumbria,The Queen Katherine School,950,98,18,116
Gloucestershire,Cirencester Deer Park School,1013,138,19,157
Gloucestershire,Robinswood Primary Academy,400,93,27,120
Surrey,Sunbury Manor School,1151,223,41,264
Rutland,Catmose College,1069,85,34,119
Surrey,Weydon School,1655,148,34,182
"Herefordshire, County of",Ashperton Primary Academy,205,29,1,30
Cornwall,Newquay Tretherras,1729,163,40,203
Surrey,Glyn School,1711,246,23,269
Norfolk,Holly Meadows School,135,36,4,40
Lincolnshire,Lincoln Castle Academy,729,59,33,92
Bexley,"Trinity Church of England School, Belvedere",1067,140,54,194
Central Bedfordshire,Eaton Bray Academy,192,51,6,57
Bromley,The Ravensbourne School,1433,159,15,174
West Northamptonshire,Hartwell Primary School,178,13,1,14
Cheshire West and Chester,The Bishops' Blue Coat Church of England High School,1144,108,17,125
York,Manor Church of England Academy,1176,97,35,132
Bromley,Charles Darwin School,1298,199,27,226
Calderdale,Whitehill Community Academy,700,118,22,140
Derbyshire,Brookfield Community School,1107,131,11,142
Stoke-on-Trent,Belgrave St Bartholomew's Academy,525,54,52,106
Bromley,Newstead Wood School,1265,119,1,120
Bedford,Goldington Academy,889,56,7,63
Cheshire West and Chester,Delamere CofE Primary Academy,166,11,1,12
Hertfordshire,Dame Alice Owen's School,1449,138,29,167
Essex,Debden Park High School,1053,194,29,223
Plymouth,Plympton Academy,1152,125,22,147
Plymouth,Hele's School,1341,170,28,198
Plymouth,Coombe Dean School,1026,150,22,172
Central Bedfordshire,Redborne Upper School and Community College,1615,114,40,154
Central Bedfordshire,Woodland Middle School Academy,708,98,41,139
Devon,Ashburton Primary School,201,24,14,38
Devon,Buckfastleigh Primary School,145,30,7,37
Devon,Widecombe-in-the-Moor Primary,80,6,2,8
Croydon,Whitehorse Manor Infant School,375,46,10,56
Croydon,Whitehorse Manor Junior School,447,62,10,72
Croydon,Ecclesbourne Primary School,448,80,6,86
Cornwall,Penair School,1148,151,24,175
Plymouth,Plymstock School,1682,211,44,255
Devon,South Dartmoor Community College,821,117,42,159
Kent,Queen Elizabeth's Grammar School,1020,27,6,33
Kent,Hartsdown Academy,773,275,10,285
Cornwall,The Roseland Academy,656,101,12,113
Cornwall,Penrice Academy,1428,170,31,201
"Bournemouth, Christchurch and Poole",Corfe Hills School,909,112,22,134
Cornwall,Saltash Community School,1208,190,40,230
Havering,The Brittons Academy,636,71,23,94
Essex,The King John School,2052,171,20,191
Gloucestershire,The Crypt School,1101,62,9,71
Essex,The Appleton School,1607,200,27,227
Cambridgeshire,Swavesey Village College,1245,42,31,73
Kent,Valley Park School,1655,153,31,184
Kent,Invicta Grammar School,1647,11,0,11
Kent,Towers School and Sixth Form Centre,1460,133,23,156
Kent,King Ethelbert School,757,168,36,204
Kent,Dane Court Grammar School,1236,33,9,42
Bromley,Langley Park School for Boys,1745,287,76,363
Warwickshire,Ashlawn School,1742,214,34,248
Plymouth,Devonport High School for Girls,823,41,4,45
Birmingham,Bartley Green School,932,210,20,230
Birmingham,Kings Norton Girls' School,1057,136,10,146
Birmingham,King Edward VI Lordswood School for Girls,986,52,11,63
Tameside,Fairfield High School for Girls,983,82,11,93
Medway,Holcombe Grammar School,1067,23,5,28
Warwickshire,Rugby High School,889,46,0,46
Cornwall,Mount Hawke Academy,296,25,8,33
Cornwall,Trevithick Learning Academy,514,132,53,185
Bexley,East Wickham Primary Academy,580,72,11,83
Havering,The Coopers' Company and Coborn School,1543,29,27,56
Somerset,Weare Academy First School,176,8,5,13
Torbay,St Margaret's Academy,397,31,21,52
Kent,Bennett Memorial Diocesan School,1865,113,19,132
Calderdale,Brighouse High School,1299,102,36,138
Essex,William de Ferrers School,1246,170,19,189
Hertfordshire,Rickmansworth School,1511,80,10,90
Hertfordshire,The John Warner School,1203,93,18,111
Hertfordshire,The Knights Templar School,1429,189,14,203
Hertfordshire,Sandringham School,1712,392,22,414
Cambridgeshire,Soham Village College,1407,148,50,198
Wiltshire,The Corsham School,1243,201,43,244
Devon,Exmouth Community College,2205,383,97,480
Wakefield,Airedale Academy,988,138,29,167
Cornwall,Pool Academy,562,91,18,109
Kingston upon Thames,The Tiffin Girls' School,1232,35,2,37
Sandwell,Wood Green Academy,1533,140,21,161
York,"Archbishop Holgate's School, A Church of England Academy",1851,174,36,210
Dudley,Windsor High School and Sixth Form,1726,136,17,153
Walsall,Ryders Hayes School,465,80,22,102
Walsall,Shire Oak Academy,1471,171,35,206
Sutton,Wilson's School,1298,16,4,20
Warwickshire,Alcester Grammar School,1323,178,6,184
Gloucestershire,Chosen Hill School,1328,80,34,114
Lincolnshire,Walton Academy,942,160,25,185
Essex,Davenant Foundation School,1233,111,43,154
Plymouth,Stoke Damerel Community College,1295,197,39,236
Nottinghamshire,Carlton le Willows Academy,1824,132,15,147
Nottinghamshire,The West Bridgford School,1755,52,6,58
Rutland,Uppingham Community College,910,47,36,83
Wiltshire,Corsham Primary School,676,113,11,124
Hillingdon,Swakeleys School for Girls,1375,102,23,125
Wiltshire,Sheldon School,1640,121,41,162
Wakefield,Castleford Academy,1503,168,67,235
Derby,West Park School,1475,178,39,217
Devon,Yealmpton Primary School,175,10,7,17
Cambridgeshire,Parkside Community College,710,124,16,140
Wokingham,Maiden Erlegh School,1863,241,84,325
Devon,Clyst Vale Community College,974,149,43,192
Somerset,Kingsmead Academy,945,100,21,121
Hampshire,The Mountbatten School,1465,152,23,175
Southampton,Freemantle Church of England Community Academy,405,93,12,105
Essex,"King Edward VI Grammar School, Chelmsford",1131,19,8,27
Hampshire,Bohunt School,1869,84,26,110
Bromley,Hayes School,1728,136,74,210
Cheshire West and Chester,Christleton High School,1393,56,25,81
Devon,Queen Elizabeth's,1279,136,38,174
West Berkshire,Kennet School,1877,203,69,272
Torbay,Hayes School,406,83,9,92
"Bournemouth, Christchurch and Poole",Twynham School,1802,225,34,259
Cambridgeshire,Coleridge Community College,561,72,18,90
Luton,Challney High School for Boys,1180,107,25,132
Hampshire,The Arnewood School,1000,160,31,191
Cambridgeshire,Alderman Jacobs School,680,84,18,102
Hampshire,Wildern School,1921,205,39,244
Cheshire East,Congleton High School,1275,44,33,77
Brent,Claremont High School,1604,71,33,104
Hampshire,Ringwood School Academy,1573,169,42,211
Barnet,East Barnet School,1452,161,50,211
Torbay,Shiphay Learning Academy,460,54,10,64
Bedford,Queen's Park Academy,413,36,12,48
Bury,Yesoiday Hatorah Boys Academy,447,106,8,114
Medway,Sir Joseph Williamson's Mathematical School,1479,113,6,119
Havering,Abbs Cross Academy and Arts College,878,308,20,328
North Yorkshire,Skipton Girls' High School,889,55,1,56
Southwark,Dulwich Hamlet Junior School,358,51,15,66
Gloucestershire,Denmark Road High School,988,113,4,117
East Riding of Yorkshire,South Hunsley School and Sixth Form College,2115,133,38,171
Plymouth,Lipson Co-operative Academy,1132,224,30,254
Newham,Brampton Manor Academy,2774,206,50,256
Cambridgeshire,Leverington Primary Academy,204,12,8,20
Cumbria,Kirkbie Kendal School,1082,140,19,159
Doncaster,The Hayfield School,1076,106,29,135
Devon,The King's School,1115,105,57,162
Kirklees,The Mirfield Free Grammar,1508,105,27,132
Doncaster,Rossington All Saints Academy,825,82,9,91
Cambridgeshire,Bottisham Village College,1400,138,44,182
Merton,RISE Education,22,0,22,22
Stoke-on-Trent,Ormiston Horizon Academy,1052,155,20,175
Stoke-on-Trent,Discovery Academy,1387,248,48,296
Buckinghamshire,The Buckinghamshire Primary Pupil Referral Unit,3,0,3,3
Liverpool,St Teresa of Lisieux Catholic Primary School,485,106,12,118
West Berkshire,TLG Reading,8,0,8,8
North Somerset,Hans Price Academy,1022,212,35,247
Bromley,Bullers Wood School,1578,168,23,191
Hillingdon,Queensmead School,1472,163,19,182
Windsor and Maidenhead,Lowbrook Academy,330,31,2,33
Central Bedfordshire,Robert Bloomfield Academy,992,143,41,184
Croydon,Gonville Academy,461,47,7,54
Hampshire,Thornden School,1466,72,25,97
Derbyshire,The Long Eaton School,1067,186,31,217
Lancashire,Hodgson Academy,1115,150,16,166
Rotherham,Aston Academy,1590,197,21,218
Hampshire,The Burgate School and Sixth Form,1116,76,25,101
Bexley,Welling School,1345,147,37,184
Peterborough,Bishop Creighton Academy,205,22,7,29
North Somerset,Backwell School,1687,202,19,221
Buckinghamshire,Wycombe High School,1321,44,8,52
Nottingham,Fernwood School,1326,119,11,130
Gloucestershire,Cheltenham Bournside School and Sixth Form Centre,1772,164,27,191
Buckinghamshire,Chalfont St Peter CofE Academy,322,22,8,30
Kent,Oakwood Park Grammar School,1096,33,2,35
North Yorkshire,Norton College,790,81,17,98
Essex,The Honywood Community Science School,789,146,46,192
Milton Keynes,Shenley Brook End School,1863,161,33,194
Lancashire,Ripley St Thomas Church of England Academy,1696,182,15,197
Cumbria,Queen Elizabeth Grammar School Penrith,1038,41,9,50
Essex,Buttsbury Junior School,506,59,13,72
Liverpool,St Edward's College,1172,126,48,174
North Yorkshire,South Craven School,1873,155,37,192
Ealing,Wood End Primary School,416,44,10,54
Kensington and Chelsea,Catch22 Pupil Parent Partnership,23,3,8,11
Lancashire,Lancaster Royal Grammar School,1261,151,13,164
Manchester,Manchester Secondary PRU,143,134,9,143
County Durham,North Durham Academy,1007,179,19,198
Barking and Dagenham,Lady Aisha Academy,83,0,1,1
Kensington and Chelsea,SIAL,77,1,1,2
County Durham,Highcroft School,6,3,3,6
Hammersmith and Fulham,West London Free School,911,26,20,46
Knowsley,Lawrence House School,12,2,7,9
Isle of Wight,Ryde Academy,1457,293,65,358
Leicestershire,Oakfield School,3,2,1,3
Surrey,Pewley Down Infant School,180,10,4,14
Sutton,Overton Grange School,1239,98,17,115
Suffolk,Stour Valley Community School,586,60,18,78
Essex,West Hatch High School,1439,146,38,184
"Herefordshire, County of",King's Caple Primary Academy,26,3,2,5
Cornwall,Charlestown Primary School,418,41,10,51
"Herefordshire, County of",Lord Scudamore Primary Academy,587,80,5,85
Staffordshire,The Violet Way Academy,266,30,1,31
"Bournemouth, Christchurch and Poole",Highcliffe School,1513,135,24,159
Gloucestershire,Winchcombe School,476,97,23,120
"Herefordshire, County of",Sutton Primary Academy,192,25,5,30
Central Bedfordshire,Linslade School,573,38,14,52
Gloucestershire,Ribston Hall High School,878,36,2,38
Hillingdon,Uxbridge High School,1360,72,26,98
County Durham,King James I Academy Bishop Auckland,973,249,15,264
Buckinghamshire,John Hampden Grammar School,1223,5,8,13
Gloucestershire,Cleeve School,1663,246,36,282
Walsall,Queen Mary's Grammar School,1312,41,3,44
Somerset,Minehead Middle School,582,43,14,57
Cambridgeshire,Sawston Village College,1171,158,28,186
Essex,Saffron Walden County High School,2147,315,61,376
Walsall,Queen Mary's High School,908,46,1,47
Birmingham,Sutton Coldfield Grammar School for Girls,1220,57,1,58
Halton,The Heath School,1198,188,20,208
Wirral,St Anselm's College,995,30,5,35
Buckinghamshire,Sir William Borlase's Grammar School,1165,133,2,135
Suffolk,Thomas Mills High School,1092,104,17,121
Somerset,The Kings of Wessex Academy,1033,71,6,77
Cumbria,Eaglesfield Paddle CofE Primary Academy,203,26,6,32
Sutton,Cheam High School,2135,175,46,221
Warwickshire,Studley High School,849,84,19,103
Sutton,Sutton Grammar School,1031,46,9,55
Calderdale,The North Halifax Grammar School,1245,78,5,83
Sutton,Wallington High School for Girls,1530,53,2,55
Lincolnshire,Fosse Way Academy,524,35,8,43
Somerset,West Somerset College,775,85,9,94
Milton Keynes,Olney Infant Academy,233,17,2,19
Lincolnshire,Tower Road Academy,585,85,20,105
Kent,Regis Manor Primary School,580,91,14,105
Sutton,Nonsuch High School for Girls,1521,53,1,54
Sutton,Westbourne Primary School,683,87,16,103
Sutton,Carshalton High School for Girls,1406,136,16,152
Sutton,Wallington County Grammar School,1102,21,1,22
Sutton,Carshalton Boys Sports College,1479,134,22,156
Sutton,Greenshaw High School,1881,146,51,197
Lancashire,Preston Muslim Girls High School,578,26,5,31
Cambridgeshire,Trumpington Meadows Primary School,287,66,9,75
"Herefordshire, County of",John Masefield High School,893,147,13,160
Bath and North East Somerset,Trinity Church School,193,33,8,41
Cheshire West and Chester,Chester Blue Coat Church of England Primary School,415,29,11,40
Camden,St Luke's Church of England School,98,11,1,12
Haringey,Eden Primary,203,23,5,28
Hounslow,Cranford Primary School,676,72,16,88
Liverpool,Mosspits Lane Primary School,416,55,6,61
Liverpool,Woolton Primary School,674,35,10,45
Cambridgeshire,Thorndown Primary School,516,22,18,40
Hackney,Beis Yaakov Girls School,89,16,4,20
Norfolk,The Free School Norwich,187,23,9,32
"Bristol, City of",Bristol Free School,1217,174,20,194
Stoke-on-Trent,St Peter's CofE Academy,1103,200,26,226
Oldham,St. Theresa's RC Primary School,213,36,1,37
Leeds,Leeds East Academy,1033,198,10,208
Suffolk,Copleston High School,1887,144,56,200
Surrey,Collingwood College,1686,240,38,278
Central Bedfordshire,Arnold Academy,686,91,21,112
"Bristol, City of",Elmlea Junior School,365,39,5,44
Cornwall,Trewirgie Junior School,371,51,6,57
Surrey,Thomas Knyvett College,729,64,17,81
Surrey,Howard of Effingham School,1521,100,24,124
Suffolk,Farlingaye High School,1923,212,46,258
Darlington,Reid Street Primary School,391,65,4,69
Darlington,Hummersknott Academy,1259,186,19,205
Somerset,Ansford Academy,567,82,21,103
Somerset,Wedmore First School Academy,182,9,2,11
Milton Keynes,Walton High,2990,199,32,231
Milton Keynes,The Hazeley Academy,1587,169,33,202
Buckinghamshire,Sir Henry Floyd Grammar School,1362,38,12,50
Buckinghamshire,Aylesbury High School,1305,60,2,62
Kent,Mascalls Academy,1356,216,21,237
Somerset,Brookside Community Primary School,533,35,60,95
Wiltshire,Pewsey Vale School,364,60,30,90
"Bournemouth, Christchurch and Poole",Poole Grammar School,1199,143,6,149
Somerset,Bishop Fox's School,1047,180,47,227
Cornwall,Penryn College,1147,190,59,249
Milton Keynes,Oxley Park Academy,719,56,11,67
Thurrock,Ortu Gable Hall School,1318,178,18,196
Essex,Moulsham Infant School,317,21,2,23
North Somerset,Gordano School,2157,208,24,232
Hertfordshire,Bovingdon Primary Academy,414,32,4,36
Buckinghamshire,The Highcrest Academy,1059,106,41,147
Medway,Cliffe Woods Primary School,415,24,4,28
Swindon,Highworth Warneford School,695,137,11,148
Essex,The Billericay School,1693,149,23,172
Cornwall,St Columb Major Academy,365,37,10,47
Essex,Moulsham High School,1623,73,45,118
Medway,Rainham Mark Grammar School,1567,55,2,57
West Sussex,Southwater Junior Academy,421,56,4,60
West Sussex,Southwater Infant Academy,301,31,5,36
Devon,Pilton Community College,1135,194,57,251
Essex,The King Edmund School,1516,209,46,255
Cornwall,St Columb Minor Academy,472,67,3,70
Lincolnshire,North Kesteven Academy,710,112,9,121
Cornwall,Mounts Bay Academy,1066,176,14,190
Gloucestershire,Stroud High School,1067,71,1,72
Essex,St Martin's School Brentwood,1867,135,19,154
Reading,King's Academy Prospect,1037,163,25,188
Hertfordshire,Queens' School,1690,171,18,189
Nottinghamshire,Toot Hill School,1898,128,6,134
Cornwall,St Hilary School,241,39,5,44
Wokingham,The Holt School,1408,78,8,86
Cornwall,Trewirgie Infants' School,294,26,9,35
Birmingham,Aston Manor Academy,978,137,7,144
Wandsworth,Chestnut Grove School,1279,166,52,218
Buckinghamshire,Aylesbury Grammar School,1332,26,5,31
Walsall,Barr Beacon School,1582,195,17,212
Staffordshire,Erasmus Darwin Academy,1141,111,30,141
Cambridgeshire,Chesterton Community College,1041,167,26,193
Surrey,South Farnham School,845,90,13,103
Bolton,St Bede Academy,647,57,13,70
Worcestershire,Christopher Whitehead Language College,1496,220,14,234
Wokingham,The Piggott School,1829,213,33,246
Torbay,Eden Park Primary & Nursery School,466,84,14,98
Lancashire,St Michael's Church of England High School,1137,108,12,120
Somerset,Preston School Academy,959,85,40,125
Wirral,The Oldershaw School,934,222,61,283
North Yorkshire,Rossett School,1072,92,17,109
Worcestershire,The Chantry School,884,103,12,115
Worcestershire,Haybridge High School and Sixth Form,1147,155,17,172
Hertfordshire,Parmiter's School,1430,116,36,152
Blackburn with Darwen,St Wilfrid's Church of England Academy,1500,102,21,123
Hertfordshire,St Clement Danes School,1586,204,21,225
Cumbria,Keswick School,1255,94,24,118
Hampshire,The Petersfield School,1400,145,35,180
Essex,Great Baddow High School,1535,109,42,151
Bradford,Ilkley Grammar School,2083,255,46,301
Surrey,George Abbot School,1932,280,43,323
Warwickshire,Myton School,1777,247,43,290
Birmingham,Fairfax,1570,188,25,213
Solihull,Heart of England School,1245,239,17,256
Kingston upon Thames,Tiffin School,1419,54,9,63
Wiltshire,Royal Wootton Bassett Academy,1725,261,41,302
Devon,Honiton Community College,731,109,22,131
Somerset,Crispin School Academy,1050,137,10,147
Sutton,Glenthorne High School,1718,150,61,211
Bromley,Warren Road Primary School,836,52,14,66
Somerset,The Castle School,1199,91,27,118
Somerset,Haygrove School,1083,100,22,122
Suffolk,Hadleigh High School,763,88,18,106
Devon,Ilsington Church of England Primary School,81,12,2,14
Bromley,Hayes Primary School,642,74,17,91
East Riding of Yorkshire,Cottingham High School and Sixth Form College,987,155,24,179
Hertfordshire,Yavneh College,1071,81,34,115
Kent,St Augustine Academy,765,139,25,164
Worcestershire,Woodrush High School,1006,75,12,87
Worcestershire,Pershore High School,1188,153,38,191
Somerset,The Redstart Primary School,449,44,5,49
Worcestershire,Droitwich Spa High School and Sixth Form Centre,1260,152,15,167
Leicester,Krishna Avanti Primary School,429,31,4,35
Cambridgeshire,King's Hedges Nursery School,62,9,1,10
Bexley,Willow Bank Primary School,287,60,12,72
Redbridge,Aldborough Primary School,340,21,10,31
Sheffield,Brantwood Specialist School,50,0,50,50
Barnet,Etz Chaim Jewish Primary School,159,12,1,13
Barnsley,Penistone St John's Voluntary Aided Primary School,565,55,17,72
Hartlepool,Ward Jackson Church of England VA Primary School,106,35,0,35
Birmingham,Birmingham Ormiston Academy,984,119,9,128
Brighton and Hove,The Montessori Place,162,14,2,16
West Northamptonshire,Weston Favell Academy,1429,129,16,145
Leicestershire,Meadow View Farm School,35,0,35,35
Slough,Langley Hall Primary Academy,760,132,3,135
Enfield,Woodpecker Hall Primary Academy,813,87,29,116
Derbyshire,High Grange School,74,0,74,74
Slough,Al-Madani Girls School,71,0,0,0
Cornwall,Brunel Primary & Nursery Academy,261,41,7,48
Lincolnshire,Caistor Yarborough Academy,475,62,27,89
Staffordshire,The Cheadle Academy,470,71,13,84
Gloucestershire,Chipping Campden School,1477,172,29,201
Staffordshire,Christ Church Academy,546,54,11,65
Bradford,Feversham Girls' Academy,796,66,5,71
Coventry,Finham Park School,1648,262,14,276
Buckinghamshire,Great Marlow School,1434,135,63,198
Trafford,Flixton Girls School,927,103,14,117
Bath and North East Somerset,Hayesfield Girls School,1461,115,29,144
Essex,"Holy Cross Catholic Primary School, Harlow",422,28,18,46
Lincolnshire,John Spendluffe Foundation Technology College,626,90,29,119
Suffolk,Kesgrave High School,1875,317,40,357
Somerset,Oakfield Academy,608,90,30,120
County Durham,Park View School,1608,141,29,170
Derbyshire,Queen Elizabeth's Grammar School,1342,160,17,177
Hertfordshire,Roundwood Park School,1358,32,22,54
Cambridgeshire,Sawtry Village Academy,916,46,23,69
North East Lincolnshire,Signhills Academy,358,35,8,43
North Northamptonshire,Southfield School for Girls,1169,106,7,113
Essex,St Helen's Catholic Junior School,354,28,4,32
Newham,Stratford School Academy,1495,92,64,156
Shropshire,The Marches School,1459,170,18,188
Swindon,St Joseph's Catholic College,1409,201,48,249
Swindon,Holy Cross Catholic Primary School,388,19,6,25
Gloucestershire,St Peter's Catholic High School and Sixth Form Centre,1509,73,43,116
Worcestershire,Suckley Primary School,86,10,2,12
Worcestershire,Great Malvern Primary School,361,65,4,69
Gloucestershire,Sir William Romney's School,527,85,24,109
Warwickshire,The Coleshill School,1235,116,17,133
Salford,Co-op Academy Swinton,1007,202,6,208
Darlington,Abbey Infants' School,265,14,5,19
Darlington,Abbey Junior School,352,29,8,37
Suffolk,Bury St Edmunds County High School,659,27,8,35
Warwickshire,Henley In Arden School,690,93,22,115
Cambridgeshire,Longsands Academy,1688,185,35,220
Solihull,Alderbrook School,1594,297,70,367
East Riding of Yorkshire,Beverley Grammar School,861,128,41,169
"Bournemouth, Christchurch and Poole",Bournemouth School for Girls,1179,101,6,107
Lancashire,Bowland High,557,80,12,92
Suffolk,Bungay High School,946,123,19,142
Gloucestershire,Charlton Kings Infants' School,269,24,4,28
North Somerset,Churchill Academy & Sixth Form,1640,113,18,131
Wakefield,Crofton Academy,1038,153,33,186
Hertfordshire,Freman College,991,168,18,186
Surrey,Fullbrook School,1379,236,16,252
North Lincolnshire,Outwood Academy Foxhills,706,147,19,166
Wandsworth,Graveney School,2181,143,63,206
Bromley,Langley Park School for Girls,1711,160,26,186
Solihull,Langley School,1030,143,75,218
Solihull,Lode Heath School,1161,167,13,180
Hounslow,Rivers Academy West London,977,119,10,129
Slough,Lynch Hill School Primary Academy,919,95,14,109
Wakefield,Minsthorpe Community College,1589,454,52,506
Devon,Newport Community School Primary Academy,489,47,15,62
Essex,Notley High School and Braintree Sixth Form,1343,81,31,112
Surrey,The Raleigh School,436,24,4,28
Tower Hamlets,"Canary Wharf College, East Ferry",317,50,7,57
Richmond upon Thames,Radnor House,453,51,2,53
Surrey,Rodborough,902,80,29,109
Tameside,West Hill School,834,121,15,136
Darlington,Bishopton Redmarshall CofE Primary School,88,11,3,14
Darlington,Heighington Church of England Primary School,243,13,3,16
Devon,Chulmleigh Primary School,182,17,3,20
Devon,Chulmleigh Community College,748,47,26,73
Devon,East Worlington Primary School,49,8,3,11
Essex,Hadleigh Infant and Nursery School,325,19,3,22
Harrow,Nower Hill High School,2028,209,51,260
Essex,South Benfleet Primary School,409,37,4,41
Essex,Westwood Academy,243,16,3,19
Gloucestershire,St Mary's Catholic Primary School,215,14,3,17
Bromley,Darrick Wood Infant & Nursery School,326,30,11,41
Gloucestershire,Katharine Lady Berkeley's School,1528,141,36,177
Birmingham,Holyhead School,1295,250,10,260
Bromley,Stewart Fleming Primary School,496,57,18,75
Calderdale,Lightcliffe Academy,977,122,15,137
Southampton,Upper Shirley High School,1031,119,22,141
Hertfordshire,Verulam School,1066,155,14,169
Oldham,The Hathershaw College,1057,172,42,214
Havering,The Campion School,1178,30,23,53
Darlington,West Park Academy,460,58,12,70
Birmingham,King Edward VI Aston School,1001,76,4,80
Birmingham,King Edward VI Camp Hill School for Girls,1098,21,3,24
Birmingham,King Edward VI Camp Hill School for Boys,982,31,8,39
Birmingham,King Edward VI Five Ways School,1305,75,5,80
Birmingham,King Edward VI Handsworth School,1274,47,2,49
Essex,Mayflower High School,1672,155,44,199
North Northamptonshire,Montsaye Academy,1086,163,9,172
Worcestershire,Nunnery Wood High School,1483,202,44,246
Milton Keynes,Ousedale School,2215,341,34,375
Birmingham,Plantsbrook School,1532,188,32,220
Essex,Runwell Community Primary School,404,36,7,43
Suffolk,Sir John Leman High School,1391,253,29,282
Essex,St Alban's Catholic Academy,213,24,6,30
Wiltshire,St Laurence School,1398,286,27,313
Essex,St Mark's West Essex Catholic School,1044,73,18,91
Gloucestershire,Thomas Keble School,672,82,28,110
Kingston upon Thames,Tolworth Girls' School and Sixth Form,1431,60,33,93
Milton Keynes,Two Mile Ash School,675,102,14,116
"Bristol, City of",Westbury-On-Trym Church of England Academy,407,50,4,54
Brighton and Hove,Portslade Aldridge Community Academy,953,148,19,167
Cheshire East,The Macclesfield Academy,582,52,39,91
Leeds,Co-op Academy Leeds,861,133,5,138
Doncaster,Ash Hill Academy,784,122,9,131
"Bristol, City of",St Ursula's E-ACT Academy,565,55,6,61
Bromley,Pickhurst Infant Academy,353,23,2,25
Bromley,Pickhurst Academy,496,55,26,81
Kent,St Johns Church of England Primary School,419,80,22,102
Essex,Hylands School,698,85,17,102
"Herefordshire, County of",Kingstone High School,636,104,18,122
Swindon,Holy Rood Catholic Primary School,391,40,4,44
Harrow,Park High School,1543,130,36,166
Cornwall,Treverbyn Academy,204,34,8,42
Hillingdon,Rosedale College,922,76,16,92
Hillingdon,Hewens College,452,44,4,48
Warwickshire,George Eliot Academy,803,140,23,163
Somerset,Stanchester Academy,787,126,17,143
Essex,"St Thomas More Catholic Primary School, Saffron Walden",217,37,1,38
Peterborough,Nene Park Academy,1375,57,24,81
Leeds,Abbey Grange Church of England Academy,1659,136,10,146
Nottinghamshire,Carlton Academy,1308,123,10,133
North Northamptonshire,Bishop Stopford School,1488,73,16,89
West Northamptonshire,Campion School,1269,177,12,189
Redbridge,The Palmer Catholic Academy,1163,96,12,108
West Northamptonshire,Caroline Chisholm School,2138,167,31,198
Hertfordshire,The Chauncy School,1365,210,41,251
Buckinghamshire,Chesham Grammar School,1313,28,8,36
Norfolk,Diss High School,948,80,8,88
Lambeth,Dunraven School,1803,240,81,321
Enfield,Enfield Grammar School,1061,73,27,100
West Sussex,"The Academy, Selsey",477,66,16,82
Gloucestershire,Farmor's School,1036,100,27,127
Staffordshire,Longdon Hall School,68,0,68,68
Kent,Gravesend Grammar School,1424,44,5,49
Staffordshire,The Hart School,1265,175,26,201
Worcestershire,Hanley Castle High School,1103,78,35,113
Gloucestershire,Highnam CofE Primary Academy,213,32,6,38
Kent,Hillview School for Girls,1496,161,12,173
South Gloucestershire,King's Oak Academy,1004,158,21,179
Cumbria,Kirkby Stephen Grammar School,352,65,3,68
Essex,Lee Chapel Primary School,1103,31,26,57
Derbyshire,Ormiston Ilkeston Enterprise Academy,958,131,20,151
Hertfordshire,Longdean School,1405,334,50,384
Lancashire,Lostock Hall Academy,721,54,7,61
Nottinghamshire,South Nottinghamshire Academy,829,59,9,68
Croydon,Ark Oval Primary Academy,592,97,14,111
Leicestershire,Lutterworth High School,846,134,32,166
Surrey,The Magna Carta School,1106,184,17,201
Nottinghamshire,Retford Oaks Academy,1138,157,13,170
Somerset,Maiden Beech Academy,110,16,4,20
Medway,The Hundred of Hoo Academy,1702,267,58,325
Leicestershire,Manor High School,931,120,30,150
Bromley,Harris Academy Beckenham,1163,117,23,140
Gloucestershire,Marling School,1230,37,6,43
Devon,Newton Abbot College,1327,150,62,212
Hampshire,Noadswood School,944,91,40,131
Somerset,North Town Academy,487,48,18,66
Lancashire,Parbold Douglas Church of England Academy,182,14,2,16
Hampshire,Perins School,1179,57,24,81
Hampshire,Priestlands School,1240,216,38,254
Wirral,Prenton High School for Girls,780,128,8,136
Barnet,Queen Elizabeth's Girls' School,1132,109,7,116
Gloucestershire,Redmarley Church of England Primary School,109,11,5,16
Oldham,The Blue Coat CofE School,1680,80,38,118
Suffolk,East Point Academy,866,96,26,122
Lincolnshire,Sir Robert Pattinson Academy,1297,186,13,199
Kent,Horizon Primary Academy,202,24,6,30
Bexley,Bexleyheath Academy,1328,227,19,246
North Yorkshire,St Aidan's Church of England High School,2003,28,70,98
Oxfordshire,King Alfred's,1705,290,28,318
Nottinghamshire,Serlby Park Academy,913,88,8,96
Cornwall,St Breock Primary School,217,19,6,25
Staffordshire,"Landau Forte Academy, QEMS",874,96,5,101
Swindon,St Mary's Catholic Primary School,406,19,5,24
Wakefield,Jerry Clay Academy,209,7,3,10
Gloucestershire,Staunton and Corse Church of England Primary School,108,12,6,18
East Riding of Yorkshire,Swanland Primary School,429,23,17,40
Essex,Ormiston Rivers Academy,1156,171,18,189
Kent,The Abbey School,1136,146,67,213
Birmingham,The Deanery Church of England Primary School,442,29,0,29
Hertfordshire,Leventhorpe,1478,147,21,168
Hammersmith and Fulham,The London Oratory School,1374,97,39,136
Nottinghamshire,The Manor Academy,1266,162,9,171
Nottinghamshire,The National CofE Academy,1214,92,7,99
Swindon,The Ridgeway School & Sixth Form College,1600,129,60,189
Leicestershire,The Robert Smyth Academy,1169,145,18,163
Worcestershire,The Stourport High School and Sixth Form College,1127,208,20,228
Dorset,The Thomas Hardye School,2093,270,56,326
Staffordshire,Staffordshire University Academy,629,99,19,118
Lincolnshire,"The King's School, Grantham",1188,81,2,83
Worcestershire,Trinity High School and Sixth Form Centre,947,130,10,140
Birmingham,Rookery School,463,68,18,86
Central Bedfordshire,Vandyke Upper School,1503,72,35,107
Leicestershire,Welland Park Academy,971,68,20,88
Wirral,Wirral Grammar School for Girls,1193,46,1,47
Warwickshire,Alcester Academy,645,102,15,117
Gloucestershire,Churchdown Village Infant School,159,18,3,21
Somerset,Avishayes Community Primary School,219,27,11,38
Somerset,Tatworth Primary School,197,25,4,29
Devon,Coombeshead Academy,887,156,18,174
Harrow,Harrow High School,998,119,8,127
Harrow,Bentley Wood High School,1390,120,22,142
Suffolk,Horringer Court Middle School,205,17,4,21
Suffolk,Westley Middle School,295,38,4,42
Camden,The UCL Academy,1171,120,38,158
Nottingham,Djanogly Northgate Academy,393,61,2,63
Cornwall,Padstow School,176,18,3,21
Nottingham,Nottingham Girls' Academy,876,98,5,103
Worcestershire,Dyson Perrins CofE Academy,655,151,32,183
Essex,Tendring Technology College,1706,231,53,284
Swindon,The Commonweal School,1392,196,34,230
Swindon,Lethbridge Primary School,488,65,13,78
Somerset,Whitstone,555,83,16,99
Gloucestershire,Springbank Primary Academy,446,78,7,85
Croydon,David Livingstone Academy,200,16,6,22
North East Lincolnshire,Ormiston Maritime Academy,638,135,28,163
Havering,Hall Mead School,1059,97,81,178
Harrow,Rooks Heath School,1177,146,32,178
Harrow,Canons High School,1302,146,17,163
North East Lincolnshire,Humberston Academy,909,66,27,93
Lincolnshire,Heighington Millfield Primary Academy,258,34,7,41
Somerset,St Dunstan's School,441,76,36,112
Somerset,Westfield Academy,1053,173,35,208
Harrow,Hatch End High School,1215,183,28,211
Cumbria,Dallam School,1048,114,19,133
Plymouth,Tor Bridge High,1170,197,57,254
Gloucestershire,Gotherington Primary School,209,32,5,37
Suffolk,Holbrook Academy,586,71,20,91
Coventry,West Coventry Academy,1216,206,10,216
West Sussex,Warden Park Primary Academy,460,49,8,57
"Bristol, City of",Waycroft Academy,457,75,5,80
Lincolnshire,Carre's Grammar School,806,91,5,96
Thurrock,William Edwards School,1225,149,41,190
Buckinghamshire,The Chalfonts Community College,1336,81,35,116
Bromley,Balgowan Primary School,622,83,10,93
Gloucestershire,Cirencester Kingshill School,869,137,38,175
Suffolk,East Bergholt High School,900,147,14,161
Buckinghamshire,Dr Challoner's High School,1285,38,1,39
Essex,Kingston Primary School,209,14,9,23
Ealing,Drayton Manor High School,1510,283,35,318
Cornwall,Falmouth School,945,132,22,154
Hertfordshire,Mount Grace School,507,96,17,113
Coventry,The Westwood Academy,881,212,19,231
Essex,Great Berry Primary School,430,42,8,50
Kent,Wilmington Grammar School for Boys,1079,65,10,75
Devon,Great Torrington School,839,192,49,241
Hampshire,Hounsdown School,1296,117,27,144
Wiltshire,Kingdown School,1504,138,77,215
Solihull,Light Hall School,1098,124,18,142
Havering,Sacred Heart of Mary Girls' School,834,36,11,47
Warwickshire,Stratford Girls' Grammar School,823,7,1,8
Warwickshire,Stratford Upon Avon School,1744,194,31,225
Surrey,Thamesmead School,1007,135,29,164
Hertfordshire,Hammond Academy,384,104,9,113
Hampshire,The Romsey School,1151,92,62,154
Essex,The Sandon School,1280,158,25,183
Essex,Thurstable School Sports College and Sixth Form Centre,1201,137,36,173
Bromley,Valley Primary School,440,33,9,42
Wirral,West Kirby Grammar School,1270,85,1,86
Bromley,Biggin Hill Primary School,438,85,14,99
Essex,The Robert Drake Primary School,315,31,5,36
Essex,Jotmans Hall Primary School,313,49,10,59
Cambridgeshire,St Peter's School,1334,130,63,193
Central Bedfordshire,Alameda Middle School,728,113,20,133
Kent,Wilmington Grammar School for Girls,1068,16,0,16
Cumbria,Appleby Grammar School,370,55,12,67
Cumbria,William Howard School,1333,259,33,292
Cumbria,Caldew School,961,93,42,135
Gloucestershire,Rowanfield Junior School,329,104,9,113
Buckinghamshire,Sir William Ramsay School,1037,134,43,177
Cornwall,Sir Robert Geffery's Voluntary Aided Church of England Primary School,217,34,2,36
Cornwall,Archbishop Benson CofE Primary School,428,60,7,67
Slough,Baylis Court School,921,96,10,106
Essex,Chelmer Valley High School,1145,96,25,121
Buckinghamshire,John Colet School,1114,127,36,163
Sunderland,Kepier,1116,149,9,158
West Sussex,Hazelwick School,1879,235,30,265
Swindon,Lydiard Park Academy,1275,139,44,183
Gloucestershire,Charlton Kings Junior School,380,58,6,64
Bracknell Forest,Ranelagh School,1074,122,24,146
Cumbria,Settlebeck School,211,42,37,79
Hertfordshire,Sir John Lawes School,1342,170,19,189
Gloucestershire,Bishops Cleeve Primary Academy,637,108,10,118
Coventry,Blue Coat Church of England School and Music College,1692,252,17,269
Hounslow,Tarbiyyah Primary School,170,8,0,8
Walsall,Bloxwich Academy,1564,170,22,192
Salford,Edstart,58,21,37,58
Bradford,Dixons Kings Academy,847,127,20,147
Hampshire,New Forest School,82,1,81,82
Buckinghamshire,Chiltern Hills Academy,1107,155,52,207
Reading,All Saints Junior School,98,17,0,17
Lincolnshire,University Academy Holbeach,1391,328,43,371
Southend-on-Sea,The Eastwood Academy,1119,111,32,143
Somerset,The Blue School,1464,222,34,256
"Bournemouth, Christchurch and Poole",Montacute School,90,0,90,90
Slough,Slough and Eton Church of England Business and Enterprise College,1158,142,44,186
Hertfordshire,Hitchin Girls' School,1368,140,14,154
Trafford,Altrincham Grammar School for Girls,1389,43,1,44
Central Bedfordshire,Greenfield CofE VC Lower School,127,9,0,9
Central Bedfordshire,Pulloxhill Lower School,43,3,4,7
Worcestershire,Somers Park Primary School,594,71,6,77
Southampton,Springhill Catholic Primary School,652,93,15,108
Oldham,The Crompton House Church of England Academy,1835,54,50,104
Lambeth,Corpus Christi Catholic Primary School,408,55,12,67
Lancashire,Bishop Rawstorne Church of England Academy,962,70,12,82
Sefton,Birkdale High School,890,130,20,150
Gloucestershire,Severn Vale School,1354,103,27,130
Kingston upon Thames,Richard Challoner School,1083,110,67,177
North Somerset,Priory Community School,1513,116,43,159
Warwickshire,King Edward VI School,791,81,2,83
Barnet,Independent Jewish Day School,230,21,8,29
Torbay,Ilsham Church of England Academy,174,13,1,14
Cambridgeshire,St Ivo Academy,1672,246,19,265
East Riding of Yorkshire,Hessle High School and Penshurst Primary School,1896,201,51,252
Wiltshire,Malmesbury School,1438,177,44,221
Manchester,The King David High School,784,165,17,182
Southend-on-Sea,St Thomas More High School,1242,73,38,111
Norfolk,St Mary's Church of England Junior Academy,208,41,2,43
Southend-on-Sea,St Bernard's High School,967,29,8,37
Somerset,Sexey's School,651,56,8,64
Surrey,Woolmer Hill School,858,129,30,159
Hampshire,Testwood School,834,80,22,102
Leicestershire,Stephenson Studio School,79,25,9,34
Hackney,Bnei Zion Community School,170,7,1,8
Nottinghamshire,Tuxford Academy,1493,173,20,193
Bradford,Rainbow Primary Leadership Academy,325,25,6,31
Suffolk,Felixstowe School,1228,136,27,163
Tameside,Tameside Pupil Referral Service,143,94,45,139
Westminster,Ark Atwood Primary Academy,422,42,19,61
Luton,The Linden Academy,407,23,1,24
Lincolnshire,St George's Preparatory School & Little Dragons Preschool,88,9,0,9
Waltham Forest,Burnside Secondary PRU,18,16,2,18
Hammersmith and Fulham,Ark Conway Primary Academy,206,20,7,27
Camden,Guildhouse School,181,0,2,2
Oxfordshire,Chilworth House Upper School,75,0,75,75
Doncaster,Auckley School,245,30,4,34
Shropshire,The Corbet School,733,134,18,152
Calderdale,Beech Hill School,530,76,17,93
Cumbria,Cartmel Priory CofE School,340,30,22,52
Hertfordshire,St Albans Girls' School,1419,195,11,206
Rutland,Casterton College Rutland,967,141,14,155
Calderdale,Scout Road Academy,98,7,2,9
Lancashire,Garstang Community Academy,828,139,15,154
Buckinghamshire,Amersham School,1024,127,40,167
Buckinghamshire,Royal Latin School,1311,61,5,66
Hampshire,Oaklands Catholic School,1402,125,28,153
Birmingham,Hillcrest School and Sixth Form Centre,650,66,3,69
Calderdale,Salterlee Primary School,101,9,4,13
North Yorkshire,Great Smeaton Academy Primary School,30,13,0,13
"Bournemouth, Christchurch and Poole",St Peter's Catholic Comprehensive School,1952,232,53,285
Hertfordshire,Summercroft Primary School,443,22,9,31
Kirklees,"Shelley College, A Share Academy",1314,118,19,137
Westminster,The St Marylebone CofE School,1168,133,27,160
West Northamptonshire,Northgate School Arts College,260,1,259,260
Buckinghamshire,Waddesdon Church of England School,1002,133,67,200
Staffordshire,Biddulph High School,775,36,20,56
Oxfordshire,Wallingford School,1348,205,40,245
Rutland,Brooke Hill Academy,341,32,1,33
Blackpool,Westcliff Primary Academy,220,17,1,18
Gateshead,Whickham School,1676,206,33,239
Barnet,Whitefield School,758,79,22,101
Nottinghamshire,Norbridge Academy,492,21,2,23
North East Lincolnshire,Cambridge Park Academy,218,0,218,218
Swindon,Eastrop Infant School,157,6,3,9
Cornwall,Wadebridge Primary Academy,444,61,2,63
Leicestershire,Limehurst Academy,637,83,22,105
Bexley,Hurstmere School,1030,212,17,229
Cumbria,Trinity School,1698,255,55,310
West Sussex,Medmerry Primary School,212,27,4,31
Wiltshire,"St Joseph's Catholic Primary School, Devizes",168,38,5,43
Wiltshire,St Augustine's Catholic College,946,129,40,169
Medway,The Thomas Aveling School,1205,195,34,229
Cambridgeshire,"Abbey College, Ramsey",1055,45,30,75
Essex,Ashingdon Primary Academy,211,22,6,28
Bromley,Harris Girls Academy Bromley,1068,92,7,99
Bexley,Northumberland Heath Primary School,554,81,21,102
Essex,Plumberow Primary Academy,629,47,9,56
Gloucestershire,Wyedean School and Sixth Form Centre,1070,89,22,111
Leeds,Woodkirk Academy,1847,128,10,138
Staffordshire,Cannock Chase High School,1066,116,15,131
Northumberland,Gust Independent School,36,3,33,36
Barnet,Mill Hill County High School,1713,36,74,110
Gloucestershire,Dene Magna School,1030,162,30,192
Barnet,Christ's College Finchley,914,140,16,156
Medway,Chatham Grammar,945,41,1,42
Dudley,Pegasus Academy,612,116,14,130
Calderdale,Burnley Road Academy,195,29,11,40
Calderdale,Bolton Brow Primary Academy,240,18,6,24
Islington,The New North Academy,246,32,14,46
North East Lincolnshire,Humberston Park School,139,0,139,139
Essex,Kents Hill Infant Academy,268,27,12,39
Havering,Redden Court School,1019,133,63,196
Kent,Sheldwich Primary School,267,12,2,14
Calderdale,Old Earth Primary School,457,37,9,46
Leicestershire,Woodbrook Vale School,837,124,25,149
Cornwall,St Mewan Community Primary School,454,31,10,41
Hampshire,St Anthony's Catholic Primary School,217,20,10,30
Essex,Westerings Primary Academy,403,40,9,49
Hillingdon,Bishop Ramsey Church of England School,1260,154,19,173
Nottinghamshire,The Becket School,1159,55,4,59
Gloucestershire,The Rosary Catholic Primary School,184,34,5,39
Wiltshire,The Holy Trinity Church of England Primary Academy,149,8,0,8
North Yorkshire,Outwood Academy Ripon,714,88,23,111
Southwark,Harris Primary Academy Peckham Park,247,22,6,28
Havering,Emerson Park Academy,1043,43,23,66
"Herefordshire, County of",Kingstone and Thruxton Primary School,195,32,5,37
West Sussex,Warden Park Secondary Academy,1523,225,45,270
Bexley,Peareswood Primary School,429,108,16,124
Redbridge,The Ursuline Academy Ilford,760,28,6,34
Suffolk,St Mary's Church of England Academy,412,104,11,115
Lancashire,Accrington St Christopher's Church of England High School,1272,119,25,144
Hampshire,St Joseph's Catholic Primary School,485,156,4,160
Bexley,Chislehurst and Sidcup Grammar School,1445,11,2,13
Kirklees,Batley Girls High School,1375,115,15,130
Nottingham,Blessed Robert Widmerpool Catholic Primary and Nursery School,259,30,2,32
Wiltshire,Saint Edmund's Roman Catholic Primary School,168,42,2,44
Cambridgeshire,Bassingbourn Village College,674,40,16,56
Nottinghamshire,St Edmund Campion Catholic Primary School,393,20,2,22
Lambeth,Oasis Academy Johanna,200,26,9,35
Norfolk,Cromer Academy,692,56,21,77
Gloucestershire,Field Court Junior School,362,37,7,44
Suffolk,Priory School,215,1,214,215
Cambridgeshire,Cottenham Village College,879,53,46,99
Reading,The Avenue Special School,204,0,204,204
Sefton,Formby High School,1123,111,44,155
Somerset,Enmore Church of England Primary School,145,14,1,15
Wakefield,Rooks Nest Academy,367,32,11,43
Nottingham,Our Lady & St Edward Primary & Nursery Catholic Voluntary Academy,247,12,4,16
"Bristol, City of",Cotham School,1650,375,11,386
Lewisham,Tidemill Academy,440,72,21,93
Hackney,Clapton Girls' Academy,1167,158,31,189
Nottingham,Warren Primary Academy,195,30,0,30
Calderdale,Rastrick High School,1734,151,39,190
Essex,Passmores Academy,1202,149,59,208
Telford and Wrekin,Haberdashers' Adams,1055,80,1,81
Lincolnshire,Lincoln Christ's Hospital School,1295,207,26,233
Wigan,Fred Longworth High School,1278,221,20,241
Cheshire East,Holmes Chapel Comprehensive School,1317,52,48,100
Cheshire East,Lacey Green Primary Academy,424,50,2,52
Lincolnshire,Westgate Academy,437,75,11,86
"Bournemouth, Christchurch and Poole",Bournemouth School,1163,39,7,46
North Lincolnshire,The Vale Academy,726,47,14,61
Devon,Stockland Church of England Primary Academy,80,10,0,10
Doncaster,Pheasant Bank Academy,344,60,7,67
Thurrock,St Clere's School,1347,102,71,173
Northumberland,Cramlington Learning Village,1995,207,31,238
Kent,Brockhill Park Performing Arts College,1351,134,15,149
Suffolk,The Ashley School,158,0,158,158
Swindon,Southfield Junior School,206,9,5,14
Norfolk,Wymondham High Academy,1641,108,24,132
Central Bedfordshire,Cedars Upper School,1007,110,26,136
Sunderland,Redby Academy,315,27,4,31
North East Lincolnshire,John Whitgift Academy,925,77,24,101
West Berkshire,St Bartholomew's School,1951,329,28,357
Cornwall,Ludgvan School,211,13,3,16
Kent,Lynsted and Norton Primary School,73,11,6,17
Cornwall,St Ives Infant School,164,14,5,19
Bedford,St John's School,179,1,178,179
Rochdale,Bamford Academy,343,24,11,35
Doncaster,Don Valley Academy,1079,90,16,106
Kent,Barton Court Grammar School,985,82,3,85
Cambridgeshire,Hinchingbrooke School,1998,211,75,286
Wirral,Wirral Grammar School for Boys,1053,73,5,78
Gloucestershire,Field Court Church of England Infant Academy,367,29,1,30
Cornwall,Pencalenick School,177,0,177,177
Oldham,Oasis Academy Limeside,451,145,17,162
Nottingham,Southwark Primary School,665,67,5,72
Kent,Selling Church of England Primary School,128,24,6,30
Doncaster,Grange Lane Infant Academy,244,28,8,36
Kent,Milstead and Frinsted Church of England Primary School,85,30,4,34
Kent,Homewood School and Sixth Form Centre,2103,195,62,257
Kirklees,Batley Grammar School,1008,112,21,133
Warwickshire,The Priors School,75,5,0,5
Cheshire East,Sandbach School,1504,149,52,201
Birmingham,Nishkam Primary School Birmingham,421,41,1,42
Bath and North East Somerset,Fosse Way School,220,0,220,220
Lancashire,Maharishi Free School,225,44,5,49
Kirklees,Moor End Academy,1041,140,33,173
Barnet,Peninim,113,6,0,6
Hackney,Beis Ruchel D'Satmar London,917,104,7,111
Sutton,Wandle Valley Academy,83,2,81,83
Darlington,Hurworth House School  Aspris Children's services,62,2,60,62
Lancashire,Belthorn Academy Primary School,227,17,2,19
Cumbria,Broughton Primary School,151,9,2,11
Sefton,Chesterfield High School,1438,157,25,182
Essex,Colchester County High School for Girls,1149,18,2,20
Essex,Great Chesterford Church of England Primary Academy,203,11,5,16
Cornwall,Harrowbarrow School,104,13,1,14
"Bristol, City of",Henleaze Junior School,367,56,7,63
Kirklees,Lindley Junior School,496,39,23,62
Sefton,Maghull High School,1091,97,29,126
Bedford,Wootton Upper School,897,109,10,119
Bath and North East Somerset,Wellsway School,1326,95,26,121
Nottingham,Edna G. Olds Academy,235,28,1,29
Nottingham,St Ann's Well Academy,234,50,2,52
Cambridgeshire,Melbourn Village College,633,46,41,87
Devon,Rydon Primary School,414,59,9,68
Kent,Smarden Primary School,174,13,4,17
Haringey,Alexandra Park School,1810,335,61,396
Hertfordshire,Goffs Academy,1543,80,22,102
Sefton,Deyes High School,1390,157,9,166
Hampshire,Amery Hill School,983,187,41,228
Cumbria,Burton Morewood CofE Primary School,163,32,4,36
Hampshire,Cams Hill School,1239,96,17,113
Barnet,Hasmonean High School for Boys,726,27,23,50
Leicestershire,Kibworth Mead Academy,825,129,16,145
Norfolk,Lynn Grove Academy,1190,166,18,184
Stockport,Mellor Primary School,230,21,6,27
Derbyshire,Pennine Way Junior Academy,372,28,7,35
Essex,Stisted Church of England Primary Academy,102,11,4,15
Calderdale,"St John's (CofE) Primary Academy, Clifton",205,51,6,57
Ealing,Twyford Church of England High School,1633,32,64,96
Cambridgeshire,Witchford Village College,682,114,32,146
Bath and North East Somerset,Writhlington School,940,118,29,147
Thurrock,Harris Academy Chafford Hundred,1491,99,64,163
Nottingham,Huntingdon Academy,448,79,4,83
Lincolnshire,Mount Street Academy,304,41,11,52
Essex,"Stewards Academy - Science Specialist, Harlow",1049,33,24,57
Staffordshire,The Weston Road Academy,1002,129,17,146
Essex,Thriftwood School,260,0,260,260
Central Bedfordshire,Eversholt Lower School,81,7,3,10
Salford,Broadoak Primary School,473,36,9,45
Waltham Forest,Highams Park School,1537,286,27,313
Birmingham,Redstone Academy for Boys,85,0,0,0
Leicester,The Imam Muhammad Adam Institute School,215,0,0,0
Wandsworth,Belleville Primary School,953,95,24,119
Buckinghamshire,Burnham Grammar School,1264,68,5,73
Lincolnshire,William Alvey School,633,70,16,86
Islington,William Tyndale Primary School,447,54,21,75
Croydon,Croydon Metropolitan College,18,0,0,0
Ealing,Holy Family Catholic Primary School,447,40,11,51
Buckinghamshire,Buckingham Park Church of England Primary School,445,65,14,79
Lincolnshire,Bourne Academy,1475,244,39,283
Kingston upon Thames,Lime Tree Primary School,305,75,23,98
Leeds,The Farnley Academy,1490,177,11,188
Birmingham,Ark Kings Academy,827,211,15,226
Kent,The Ebbsfleet Academy,766,53,15,68
Cheshire West and Chester,The Rudheath Senior Academy,560,104,13,117
"Bristol, City of",LPW Independent School,45,21,6,27
Cambridgeshire,The Centre School,126,0,126,126
Surrey,Epsom and Ewell High School,963,146,27,173
Sheffield,Sheffield Inclusion Centre,199,106,40,146
Warwickshire,Values Academy,22,0,22,22
Northumberland,Berwick Academy,545,72,13,85
Lincolnshire,Bourne Westfield Primary Academy,685,95,15,110
Lincolnshire,Stamford Welland Academy,558,59,21,80
Manchester,Cheetham CofE Community Academy,658,82,24,106
Cumbria,Dearham Primary School,240,14,13,27
Doncaster,Ridgewood School,1393,182,16,198
Sefton,Greenbank High School,1037,134,11,145
Hampshire,Dove House School,236,0,236,236
Derbyshire,Heanor Gate Spencer Academy,1341,163,27,190
Essex,The Tyrrells School,409,32,13,45
"Herefordshire, County of",Lady Hawkins' School,263,19,6,25
Kent,Saint George's Church of England School,1381,171,29,200
North East Lincolnshire,Lisle Marsden Church of England Primary Academy,622,74,19,93
Sefton,Range High School,1118,166,8,174
North Northamptonshire,Manor School,1027,174,11,185
West Northamptonshire,Moulton School and Science College,1389,103,19,122
Kent,"Maidstone, St John's Church of England Primary School",441,32,15,47
Cornwall,Nansloe Academy,237,46,6,52
Leicestershire,John Ferneley College,1178,116,34,150
Hounslow,Springwest Academy,892,172,55,227
Swindon,Colebrook Infant Academy,146,27,4,31
Norfolk,Sheringham High School,737,101,10,111
Darlington,Carmel College,1359,139,18,157
Cornwall,St Merryn School,146,15,1,16
"Herefordshire, County of",Brockhampton Primary School,202,24,3,27
Worcestershire,The Chase,1370,169,25,194
Cambridgeshire,Bourn CofE Primary Academy,204,27,4,31
"Bristol, City of",St Bede's Catholic College,1268,106,16,122
Nottinghamshire,The Joseph Whitaker School,1380,170,16,186
Doncaster,Rowena Academy,295,24,3,27
Medway,Walderslade Girls' School,888,137,7,144
Essex,Kents Hill Junior School,348,52,8,60
Central Bedfordshire,Etonbury Academy,991,137,18,155
Hillingdon,Bishopshalt School,1268,157,36,193
Gloucestershire,Churchdown School,1449,178,35,213
Hillingdon,Vyners School,1419,169,62,231
Central Bedfordshire,Brooklands Middle School,595,113,36,149
Hertfordshire,Birchwood High School,1418,112,32,144
County Durham,Consett Academy,1624,206,21,227
Cambridgeshire,Buckden CofE Primary School,327,59,15,74
Leicestershire,Rawlins Academy,1571,244,110,354
Lancashire,Clayton-le-Moors All Saints' Church of England Primary School,271,19,2,21
Devon,Lady Seaward's Church of England Primary School,83,9,4,13
Wakefield,Gawthorpe Community Academy,232,18,3,21
Devon,Orchard Vale Community School,347,68,8,76
Barnet,Hendon School,1245,198,59,257
Devon,South Brent Primary School,188,30,7,37
Southwark,Redriff Primary School,538,85,29,114
Devon,Sidbury Church of England Primary School,172,26,10,36
Wiltshire,Kingsbury Green Academy,954,215,43,258
Devon,Sampford Peverell Church of England Primary School,126,17,6,23
Hillingdon,The Willows School,52,1,51,52
Cumbria,Castle Carrock School,47,5,1,6
Devon,Hemyock Primary School,241,24,6,30
Hertfordshire,King James Academy Royston,1004,200,10,210
Devon,Wilcombe Primary School,182,22,20,42
Kent,Joydens Wood Infant School,238,31,1,32
Kent,Joydens Wood Junior School,294,35,9,44
Devon,Salcombe Church of England Primary School,91,5,0,5
Kent,Wilmington Primary School,210,9,3,12
Devon,Newton Ferrers Church of England Primary School,126,15,2,17
Devon,Blackpool Church of England Primary School,295,42,6,48
Devon,Chudleigh Knighton Church of England Primary School,100,15,2,17
Lincolnshire,Kesteven and Sleaford High School Selective Academy,763,95,3,98
Sandwell,Ormiston Forge Academy,1640,242,49,291
Suffolk,Ormiston Endeavour Academy,557,49,9,58
Liverpool,"King's Leadership Academy, Liverpool",781,184,9,193
Waltham Forest,Hawkswood  (Therapeutic),2,0,2,2
Kingston upon Thames,The Hollyfield School and Sixth Form Centre,1209,172,55,227
Luton,Icknield High School,1461,167,32,199
Lincolnshire,Malcolm Sargent Primary School,656,86,27,113
Bexley,St Catherine's Catholic School,1026,36,14,50
Tower Hamlets,Sir William Burrough Primary School,341,22,8,30
Bromley,Crofton Junior School,712,67,16,83
Swindon,The Dorcan Academy,797,152,11,163
Brent,Kingsbury High School,1993,151,36,187
Cumbria,Arnside National CofE School,127,16,1,17
Kent,The Sittingbourne School,1589,111,111,222
Manchester,E-ACT Blackley Academy,435,71,21,92
Redbridge,Forest Academy,758,90,42,132
Hampshire,Bransgore Church of England Primary School,349,24,9,33
Essex,Burnt Mill Academy,1086,117,20,137
Windsor and Maidenhead,Cox Green School,1162,132,17,149
County Durham,Framwellgate School Durham,1318,159,32,191
Worcestershire,Coppice Primary School,689,87,4,91
Essex,Hutton All Saints' Church of England Primary School,225,22,5,27
Calderdale,Luddendenfoot Academy,189,26,3,29
"Bristol, City of",Ilminster Avenue E-ACT Academy,305,78,15,93
Sandwell,Oldbury Academy,1362,198,17,215
County Durham,St John's Catholic School & Sixth Form College,1326,118,10,128
"Herefordshire, County of",Queen Elizabeth High School,378,80,6,86
Leeds,Otley Prince Henry's Grammar School Specialist Language College,1642,174,18,192
Dudley,Beacon Hill Academy,1024,114,42,156
Walsall,Willenhall E-ACT Academy,909,185,23,208
Walsall,The Streetly Academy,1523,126,44,170
Newcastle upon Tyne,Sacred Heart Catholic High School,1393,192,12,204
Slough,Herschel Grammar School,1068,7,4,11
Essex,Anglo European School,1495,121,13,134
Kent,Chiddingstone Church of England School,209,15,4,19
Ealing,Featherstone High School,1780,140,30,170
Wolverhampton,Heath Park,1173,190,23,213
"Herefordshire, County of",Holmer CofE Academy,418,41,6,47
Devon,Littletown Primary Academy,434,49,7,56
Southend-on-Sea,Shoeburyness High School,1812,259,67,326
North Tyneside,St Thomas More Catholic High School,1609,113,29,142
Surrey,The Beacon School,1226,219,36,255
Surrey,Rosebery School,1417,96,19,115
Wakefield,South Ossett Infant Academy,91,8,0,8
Kent,Cranbrook School,884,15,9,24
Windsor and Maidenhead,Furze Platt Senior School,1512,184,54,238
Somerset,Selwood Academy,607,97,24,121
North Lincolnshire,South Axholme Academy,953,82,10,92
Essex,The Wickford Church of England School,135,12,1,13
Haringey,Woodside High School,1193,130,39,169
Northumberland,The King Edward VI Academy,1426,136,20,156
Northumberland,Morpeth Chantry Middle School,553,88,16,104
Northumberland,Morpeth Newminster Middle School,554,70,7,77
North Yorkshire,The Rubicon Centre,8,7,1,8
Gloucestershire,Tewkesbury School,1268,157,26,183
South Gloucestershire,Bradley Stoke Community School,1334,163,48,211
Croydon,Norbury High School for Girls,1245,147,7,154
Torbay,Brixham College,1091,142,55,197
Central Bedfordshire,The Firs Lower School,340,24,6,30
Hertfordshire,Bishop's Hatfield Girls' School,943,79,12,91
Cornwall,Biscovey Academy,254,28,6,34
North Lincolnshire,The Axholme Academy,546,99,23,122
North East Lincolnshire,Waltham Leas Primary Academy,432,42,11,53
North East Lincolnshire,New Waltham Academy,374,33,5,38
"Bristol, City of",West Town Lane Academy,647,61,4,65
Nottinghamshire,The Brunts Academy,1473,124,11,135
Doncaster,Conisbrough Ivanhoe Primary Academy,386,83,7,90
Warwickshire,Campion School,1082,169,30,199
Warwickshire,Higham Lane School,1418,88,27,115
Lancashire,Tarleton Academy,704,41,9,50
Bexley,Townley Grammar School,1574,69,3,72
Warwickshire,Aylesford School Warwick,1300,194,28,222
Warwickshire,Etone College,1017,93,20,113
Croydon,Shirley High School Performing Arts College,838,237,14,251
Dudley,Kingswinford Academy,909,117,25,142
Buckinghamshire,The Gerrards Cross CofE School,421,43,22,65
Leeds,Horsforth School,1563,191,12,203
Devon,Bickleigh on Exe Church of England Primary School,161,21,7,28
West Berkshire,Denefield School,1112,181,26,207
Central Bedfordshire,Hadrian Academy,370,64,12,76
Devon,Lapford Community Primary School,78,12,3,15
Warwickshire,Ash Green School,1048,174,28,202
West Sussex,The Regis School,1613,219,23,242
Wigan,Lowton Church of England High School,779,111,13,124
Westminster,Unity Girls High School,0,0,0,0
Bradford,Prism Independent School,34,0,34,34
Nottingham,Sycamore Academy,476,70,3,73
North East Lincolnshire,Scartho Junior Academy,244,26,9,35
Windsor and Maidenhead,Datchet St Mary's CofE Primary School,228,26,2,28
Tower Hamlets,Mulberry Academy Shoreditch,1345,161,47,208
Essex,Plume School,1706,219,46,265
Hampshire,Bay House School,2142,263,54,317
Lincolnshire,Bourne Grammar School,1708,132,9,141
Lincolnshire,Bracebridge Heath St John's Primary Academy,378,41,10,51
Kent,The Sallygate School,52,0,52,52
Birmingham,Selly Oak Nursery School,70,3,0,3
Walsall,Park Hall Junior Academy,415,29,9,38
Nottingham,Bluecoat Aspley Academy,1378,174,24,198
Leicestershire,Humphrey Perkins School,818,133,14,147
Kent,Borden Grammar School,889,28,6,34
Manchester,Trinity CofE High School,1506,139,54,193
Ealing,La Chouette School,25,0,0,0
Kent,Repton Manor Primary School,471,56,12,68
Hackney,Leaways School,61,0,61,61
Hackney,Wiznitz Cheder School,103,10,5,15
North East Lincolnshire,East Ravendale CofE Primary School Academy,101,9,2,11
Dudley,The Earls High School,1226,85,26,111
Essex,Colchester Royal Grammar School,994,57,2,59
Wirral,Weatherhead High School,1568,136,12,148
Birmingham,City United Academy (CUA),3,0,2,2
Wigan,The Parks School,20,0,20,20
Oldham,Westwood High,347,0,1,1
Rotherham,Rotherham Aspire,91,74,17,91
Worcestershire,Lickhill Primary School,222,43,2,45
Cambridgeshire,Impington Village College,1418,81,98,179
Leicestershire,The Martin High School Anstey,867,158,10,168
Hillingdon,Northwood School,999,56,37,93
Walsall,Joseph Leckie Academy,1458,197,30,227
Sunderland,Benedict Biscop Church of England Academy,289,50,4,54
North Lincolnshire,Huntcliff School,531,106,31,137
Kent,The Maplesden Noakes School,1359,90,13,103
Kent,"Mayfield Grammar School, Gravesend",1349,49,2,51
Kent,Wentworth Primary School,651,66,18,84
Kent,The Folkestone School for Girls,1217,46,5,51
Suffolk,Thomas Wolsey Ormiston Academy,106,15,91,106
Cornwall,Looe Community Academy,513,75,10,85
Doncaster,Hall Cross Academy,1910,152,32,184
Stockport,Cheadle Hulme High School,1665,191,42,233
Hillingdon,Barnhill Community High School,1522,114,14,128
Hertfordshire,Stanborough School,1123,167,29,196
Kingston upon Thames,Coombe Girls' School,1582,74,35,109
Suffolk,St Alban's Catholic High School,1023,101,11,112
Surrey,Goldsworth Primary School,629,72,21,93
Gateshead,St Thomas More Catholic School,1467,105,29,134
Gateshead,Cardinal Hume Catholic School,1509,167,24,191
Central Bedfordshire,Cranfield Church of England Academy,527,47,10,57
Gloucestershire,Gretton Primary School,92,19,0,19
Surrey,Hinchley Wood School,1381,109,52,161
Kingston upon Thames,St Agatha's Catholic Primary School,397,36,3,39
Nottinghamshire,Quarrydale Academy,1292,140,9,149
Birmingham,Hall Green School,915,85,29,114
Kingston upon Thames,Coombe Boys' School,964,110,25,135
Cumbria,Great Corby Primary School,103,12,2,14
Hertfordshire,Little Reddings Primary School,305,68,9,77
Manchester,St Barnabas CofE Primary Academy,228,50,6,56
Cambridgeshire,Thomas Clarkson Academy,1384,195,55,250
Kirklees,Salendine Nook High School Academy,1403,113,24,137
Barnsley,"St Mary's Church of England Primary School, Barnsley",217,21,4,25
Kent,Graveney Primary School,100,7,2,9
Hertfordshire,Bushey Meads School,1226,197,105,302
Lincolnshire,The Deepings School,1344,135,14,149
Essex,The Boswells School,1491,84,28,112
North Northamptonshire,Kingsley Special Academy,162,0,162,162
Plymouth,Old Priory Junior Academy,206,26,5,31
Essex,Shenfield High School,1535,261,40,301
West Northamptonshire,Chenderit School,1053,153,9,162
Peterborough,Stanground Academy,1314,165,17,182
Kent,Oaks Primary Academy,216,21,3,24
Kent,Tree Tops Primary Academy,314,20,1,21
Kent,Milestone Academy,370,0,370,370
North Somerset,Clevedon School,1366,118,24,142
Central Bedfordshire,Stratton Upper School,832,118,24,142
Manchester,Music Stuff,102,64,38,102
Liverpool,Rudston Primary School,456,34,11,45
Stoke-on-Trent,Phoenix U16 Independent School,20,3,3,6
Hertfordshire,The Saint John Henry Newman Catholic School,1615,139,40,179
Central Bedfordshire,Weatherfield Academy,165,0,165,165
Derbyshire,Redhill Primary School,218,32,2,34
Doncaster,Hungerhill School,1170,130,18,148
Newcastle upon Tyne,St Cuthbert's High School,1238,189,18,207
Suffolk,Stradbroke High School,355,66,10,76
Derbyshire,Netherthorpe School,1169,150,30,180
County Durham,Parkside Academy,965,81,9,90
Central Bedfordshire,Fulbrook,451,61,17,78
Leicestershire,Forest Way School,271,0,271,271
Surrey,Blenheim High School,1329,116,43,159
Hounslow,Chiswick School,1486,187,22,209
Derbyshire,Saint John Houghton Catholic Voluntary Academy,657,86,29,115
Nottinghamshire,The Priory Catholic Voluntary Academy,204,31,3,34
Oxfordshire,Hanwell Fields Community School,451,67,8,75
Derby,Allestree Woodlands School,1374,125,57,182
North Northamptonshire,Sir Christopher Hatton Academy,1423,90,23,113
Norfolk,"Notre Dame High School, Norwich",1582,124,28,152
Hertfordshire,Saint Joan of Arc Catholic School,1229,146,15,161
Nottingham,Nethergate Academy,166,1,165,166
Liverpool,The Blue Coat School,1246,104,2,106
Kingston upon Thames,Southborough High School,864,157,22,179
West Northamptonshire,Woodland View Primary School,401,59,6,65
Oxfordshire,Bartholomew School,1363,151,24,175
Oxfordshire,Rush Common School,378,47,7,54
Oxfordshire,Gillotts School,954,169,32,201
Hertfordshire,Saint Michael's Catholic High School,1127,114,17,131
Stockport,Hazel Grove High School,1360,172,49,221
Cambridgeshire,St Bede's Inter-Church School,912,47,56,103
Hillingdon,The Douay Martyrs Catholic School,1563,131,9,140
Essex,The Gilberd School,1556,162,40,202
Essex,The Stanway School,1401,143,28,171
Hounslow,"Gumley House RC Convent School, FCJ",1140,190,16,206
Wirral,Upton Hall School FCJ,1016,74,3,77
Bromley,Tubbenden Primary School,710,112,52,164
Leicestershire,South Wigston High School,831,110,14,124
Leicestershire,Glen Hills Primary School,505,70,9,79
Leicestershire,Fairfield Community Primary School,210,22,5,27
Buckinghamshire,Alfriston School,155,0,155,155
Hammersmith and Fulham,Sacred Heart High School,1129,72,18,90
Oxfordshire,Chipping Norton School,983,103,15,118
Essex,The Thomas Lord Audley School,876,122,32,154
Hertfordshire,Nicholas Breakspear Catholic School,1037,113,29,142
Buckinghamshire,Bourton Meadow Academy,656,57,15,72
Hounslow,Isleworth and Syon School for Boys,1099,134,15,149
Central Bedfordshire,Harlington Upper School,1209,96,20,116
Gateshead,Lord Lawson of Beamish Academy,1338,181,16,197
Hertfordshire,Applecroft School,454,40,14,54
Essex,St Helena School,994,93,19,112
Essex,Manningtree High School,893,50,19,69
Central Bedfordshire,Biggleswade Academy,1198,134,48,182
Central Bedfordshire,Samuel Whitbread Academy,1674,119,58,177
Norfolk,Wayland Academy,576,55,17,72
Tameside,Silver Springs Primary Academy,387,78,7,85
Lambeth,City Heights E-ACT Academy,581,75,21,96
Staffordshire,Peak Education,8,0,8,8
Bromley,St James' Roman Catholic Primary School,218,14,3,17
Croydon,St James the Great RC Primary and Nursery School,436,45,9,54
Worcestershire,The Vaynor First School,438,35,9,44
Kent,Hampton Primary School,675,79,19,98
Cumbria,Stramongate Primary School,286,46,12,58
Devon,Stowford School,447,51,7,58
Buckinghamshire,Hamilton Academy,664,57,9,66
Bexley,Blackfen School for Girls,1464,93,41,134
Lambeth,St Martin in the Fields High School for Girls,398,43,12,55
Wakefield,Horbury Bridge Church of England Junior and Infant Academy,127,12,4,16
Leicestershire,Redmoor Academy,920,145,27,172
Leicestershire,Bosworth Academy,1634,127,29,156
Oxfordshire,The Cherwell School,2007,241,71,312
Essex,Moulsham Junior School,685,79,22,101
Sandwell,Mesty Croft Primary,437,41,7,48
Blackpool,Montgomery Academy,1168,228,9,237
Walsall,Aldridge School - A Science College,1604,170,53,223
Essex,Helena Romanes School,1264,217,16,233
Oxfordshire,Langtree School,623,94,17,111
Lincolnshire,Washingborough Academy,288,29,6,35
Lincolnshire,Witham St Hughs Academy,415,16,9,25
Buckinghamshire,Chepping View Primary Academy,428,50,11,61
West Sussex,Edward Bryant School,618,105,18,123
Nottinghamshire,Ashfield Comprehensive School,2681,366,19,385
East Sussex,Beacon Academy,1592,147,28,175
Leicestershire,Wreake Valley Academy,952,162,32,194
Leicestershire,Wigston Academy,1311,178,39,217
Hertfordshire,Presdales School,1162,42,10,52
Nottinghamshire,Leverton Church of England Academy,88,6,1,7
Calderdale,Bradshaw Primary School,341,23,8,31
Birmingham,Bishop Vesey's Grammar School,1347,80,2,82
Warwickshire,Henry Hinde Infant School,150,13,6,19
Medway,High Halstow Primary Academy,211,14,4,18
Bolton,Harwood Meadows Primary School,223,32,3,35
Oxfordshire,Folly View Primary,217,30,8,38
Oxfordshire,Faringdon Community College,1422,249,36,285
Brent,Saint Claudine's Catholic School for Girls,941,70,9,79
Hounslow,St Mark's Catholic School,1206,81,24,105
North East Lincolnshire,Middlethorpe Primary Academy,235,26,5,31
Hertfordshire,"Woolgrove School, Special Needs Academy",125,0,125,125
"Bournemouth, Christchurch and Poole",Tregonwell Academy,137,25,112,137
Reading,Red Balloon Learner Centre Reading,22,0,22,22
Darlington,St. George's Church of England Academy,408,53,12,65
Kent,Pluckley Church of England Primary School,96,8,1,9
Cheshire East,Knutsford Academy,1267,120,36,156
Central Bedfordshire,Gilbert Inglefield Academy,646,67,23,90
Swindon,Seven Fields Primary School,285,69,11,80
Wakefield,De Lacy Academy,816,70,16,86
Doncaster,Hatfield Woodhouse Primary School,228,19,5,24
Doncaster,Crookesbroom Primary Academy,221,17,7,24
Oxfordshire,The Elms Primary School,428,78,17,95
Bolton,Eagley Infant School,188,11,1,12
Slough,The Westgate School,1338,154,45,199
Slough,Cippenham School,1039,131,21,152
North East Lincolnshire,Saint Joseph's Catholic Primary Voluntary Academy,139,29,10,39
North Lincolnshire,St Mary's Catholic Primary Voluntary Academy (Brigg),182,22,0,22
North Lincolnshire,St. Bernadette's Catholic Primary Voluntary Academy,324,41,6,47
North Lincolnshire,Saint Augustine Webster Catholic Voluntary Academy,377,42,2,44
North Lincolnshire,St Bede's Catholic Voluntary Academy,673,92,11,103
Kent,The Norton Knatchbull School,1252,36,7,43
Wiltshire,The John of Gaunt School,1254,182,40,222
Central Bedfordshire,St Christophers Academy,389,20,8,28
Central Bedfordshire,St Mary's CofE Academy Stotfold,284,15,7,22
Coventry,Coundon Court,1880,300,18,318
Cornwall,Wadebridge School,1070,166,13,179
South Tyneside,Monkton Academy,176,28,1,29
Worcestershire,Webheath Academy Primary School,448,43,1,44
Central Bedfordshire,Henlow Church of England Academy,569,83,49,132
Essex,Lyons Hall School,563,71,15,86
Cambridgeshire,Godmanchester Community Academy,397,30,12,42
Worcestershire,King Charles I School,1094,141,40,181
Sandwell,Victoria Park Primary,665,47,15,62
Kent,Luddenham School,201,18,6,24
"Herefordshire, County of",Lugwardine Primary Academy,192,19,2,21
Wigan,Tyldesley Primary School,448,27,7,34
"Herefordshire, County of",St Paul's CofE Primary School,425,56,7,63
Hampshire,The Cowplain School,946,95,31,126
Norfolk,Hellesdon High School,1577,85,52,137
"Bournemouth, Christchurch and Poole",The Epiphany School,423,55,10,65
Devon,Braunton Academy,779,117,30,147
Hertfordshire,The Marlborough Science Academy,1290,184,26,210
Staffordshire,Bursley Academy,343,62,4,66
Southend-on-Sea,The St Christopher School,241,0,241,241
Medway,Greenacre Academy,981,235,14,249
Torbay,Ellacombe Church of England  Academy,400,48,14,62
Thurrock,Lansdowne Primary Academy,687,80,26,106
West Sussex,Tangmere Primary Academy,207,52,6,58
West Sussex,The Bewbush Academy,568,80,8,88
Barnet,The Henrietta Barnett School,795,23,1,24
Cambridgeshire,Sir Harry Smith Community College,1111,139,27,166
Sunderland,St Anthony's Girls' Catholic Academy,1330,102,4,106
"Herefordshire, County of",Stretton Sugwas CofE Academy,201,17,4,21
West Northamptonshire,Waynflete Infants' School,140,12,1,13
Lincolnshire,Long Bennington Church of England Academy,266,54,8,62
Buckinghamshire,Holmer Green Senior School,1154,131,61,192
Birmingham,Rockwood Academy,1039,153,7,160
North East Lincolnshire,Signhills Infant Academy,233,5,2,7
Lincolnshire,Benjamin Adlard Primary School,233,63,17,80
Thurrock,East Tilbury Primary School,698,86,24,110
Bedford,Daubeney Academy,481,62,25,87
Sheffield,Tapton School,1818,166,31,197
Nottinghamshire,Chetwynd Spencer Academy,423,33,0,33
West Sussex,Seal Primary Academy,315,36,5,41
Essex,Hamford Primary Academy,378,56,8,64
West Northamptonshire,DSLV E-ACT Academy,1039,154,10,164
Kent,St James the Great Academy,197,30,6,36
County Durham,Easington Academy,795,102,9,111
Nottinghamshire,The Elizabethan Academy,1137,119,13,132
Northumberland,Meadowdale Academy,224,37,0,37
Leicestershire,The Roundhill Academy,824,142,13,155
Leicestershire,St Joseph's Catholic Voluntary Academy,203,27,3,30
Leicester,Sacred Heart Catholic Voluntary Academy,396,52,6,58
"Kingston upon Hull, City of",Hull Trinity House Academy,699,52,15,67
Doncaster,Highfields Primary Academy,114,20,3,23
Essex,Clacton County High School,1744,261,35,296
North Lincolnshire,Hibaldstow Academy,110,13,3,16
North Lincolnshire,Scawby Academy,209,16,4,20
Bradford,Belle Vue Girls' Academy,1075,46,10,56
Darlington,Springfield Academy,232,43,3,46
Darlington,Haughton Academy,854,158,29,187
Leicestershire,"Saint John Fisher Catholic Voluntary Academy, Wigston, Leicestershire",209,23,4,27
Darlington,Beaumont Hill Academy,291,0,291,291
Leicester,Ash Field Academy,165,3,162,165
Manchester,Cedar Mount Academy,880,171,21,192
Wolverhampton,Moseley Park,1095,217,25,242
Bradford,Oastlers School,132,0,132,132
Hackney,TTD Gur School,222,29,16,45
Buckinghamshire,Kite Ridge School,9,0,9,9
Sunderland,Southmoor Academy,1464,139,10,149
Birmingham,Timberley Academy,658,166,28,194
Essex,Our Lady Immaculate Catholic Primary School,217,29,5,34
Hertfordshire,Loreto College,962,99,6,105
Worcestershire,Bishop Perowne CofE College,1026,171,9,180
Leicestershire,The Market Bosworth School,818,145,14,159
Wiltshire,Holy Trinity Church of England Academy,209,38,1,39
Wigan,Hawkley Hall High School,1180,115,49,164
Kirklees,BBG Academy,1022,162,23,185
Wiltshire,By Brook Valley CofE Primary School,188,23,3,26
Rutland,Catmose Primary,207,26,3,29
Leicester,St Josephs Catholic Academy,245,35,2,37
Doncaster,Campsmount Academy,791,98,21,119
Suffolk,Langer Primary Academy,120,32,3,35
Gateshead,Ateres Girls High School,287,24,1,25
Newcastle upon Tyne,Kenton School,1820,172,42,214
Buckinghamshire,St Nicolas' Church of England Combined School,219,21,7,28
Essex,Columbus School and College,275,4,271,275
Trafford,Ashton-on-Mersey School,1421,198,62,260
Trafford,Broadoak School,596,120,16,136
Darlington,St John's Church of England Academy,246,36,3,39
Darlington,Firthmoor Primary School,310,45,6,51
Salford,Oakwood Academy,326,6,320,326
Wiltshire,The Mead Community Primary School,532,75,21,96
Trafford,Saint Ambrose College,1082,75,6,81
Hampshire,Robert May's School,1317,180,49,229
Birmingham,The Arthur Terry School,1750,195,41,236
Birmingham,Stockland Green School,753,110,30,140
Norfolk,Westfield House School,42,0,42,42
Hampshire,Wellington Community Primary School,414,39,12,51
Bath and North East Somerset,Bath Academy,119,15,9,24
Cheshire West and Chester,Hartford Church of England High School,1076,104,12,116
Lincolnshire,The Lincoln Manor Leas Infants School,161,18,5,23
Leicestershire,Lutterworth College,1580,122,30,152
Kent,Grove Park Primary School,412,85,10,95
Bolton,Eagley Junior School,238,15,1,16
North Northamptonshire,Woodnewton- A Learning Community,864,151,14,165
Leicestershire,Stafford Leys Community Primary School,559,44,8,52
Leicestershire,Gartree High School,862,16,31,47
Leicestershire,Dorothy Goodman School Hinckley,387,0,387,387
Hillingdon,Grangewood School,131,0,131,131
Hillingdon,Moorcroft School,130,0,130,130
Cumbria,Gilsland CofE Primary School,24,3,0,3
West Northamptonshire,Cedar Road Primary School,416,39,9,48
Suffolk,Place Farm Primary Academy,408,41,7,48
Suffolk,Castle Manor Academy,732,99,42,141
Doncaster,Barnby Dun Primary Academy,279,16,3,19
Essex,"St Thomas More's Catholic Primary School, Colchester",207,11,4,15
Slough,Marish Primary School,793,80,81,161
Kent,Astor Secondary School,803,190,12,202
Kent,White Cliffs Primary and Nursery School,315,44,13,57
Kent,Barton Junior School,215,29,3,32
Kent,Shatterlocks Infant and Nursery School,202,28,5,33
County Durham,"St Bede's Catholic Comprehensive School and Sixth Form College, Lanchester",1375,51,20,71
Leicestershire,The Meadow Community Primary School,385,52,12,64
Southend-on-Sea,Belfairs Academy,1631,121,24,145
Darlington,Mowden Infant School,208,9,3,12
Darlington,Mowden Junior School,337,21,9,30
Cambridgeshire,Cromwell Community College,1411,82,46,128
Croydon,Riddlesdown Collegiate,2060,215,48,263
Darlington,Heathfield Primary School,425,51,11,62
Darlington,Hurworth Primary School,222,19,2,21
Central Bedfordshire,Priory Academy,770,76,23,99
Medway,All Faiths Children's Academy,226,42,17,59
Liverpool,Bellerive FCJ Catholic College,905,126,8,134
Hampshire,Wyvern College,1358,169,54,223
Leicester,St Thomas More Catholic Voluntary Academy,280,41,3,44
Dorset,Dorchester Middle School,590,93,23,116
Croydon,Woodcote High School,1276,222,34,256
Wiltshire,Woodford Valley Church of England Aided School,202,16,5,21
Dorset,"St Mary's Church of England Middle School, Puddletown",479,93,29,122
North Yorkshire,Harrogate High School,724,65,27,92
Nottinghamshire,The South Wolds Academy & Sixth Form,976,29,7,36
Slough,Ryvers School,679,97,10,107
"Bournemouth, Christchurch and Poole",Avonbourne Girls Academy,989,131,3,134
Birmingham,Erdington Hall Primary School,342,38,5,43
Kent,Molehill Primary Academy,303,31,5,36
Newham,School 21,1197,62,21,83
Hertfordshire,Hatfield Community Free School,416,41,10,51
Tower Hamlets,Wapping High School,336,39,8,47
Enfield,Kingfisher Hall Primary Academy,446,47,10,57
"Bristol, City of",Bedminster Down School,1047,145,17,162
Hertfordshire,Fleetville Junior School,358,41,5,46
Hertfordshire,Fleetville Infant and Nursery School,314,23,3,26
Tameside,Denton West End Primary School,454,16,3,19
Worcestershire,Woodfield Academy,563,131,9,140
Central Bedfordshire,Ardley Hill Academy,454,37,19,56
Oxfordshire,The Henry Box School,1060,176,14,190
Gateshead,Kibblesworth Academy,148,25,1,26
Newcastle upon Tyne,Atkinson Road Primary Academy,394,85,13,98
Sunderland,Eppleton Academy Primary School,199,29,0,29
West Northamptonshire,The Duston School,1951,264,13,277
Hertfordshire,The Wroxham School,232,27,10,37
Shropshire,The Priory School,849,83,26,109
Birmingham,Dorrington Academy,648,114,1,115
Essex,The Pioneer School,165,0,165,165
Blackburn with Darwen,Tauheedul Islam Boys' High School,679,84,20,104
Croydon,St Joseph's College,1008,92,31,123
Birmingham,Aston University Engineering Academy,743,71,1,72
Surrey,Cobham Free School,928,90,40,130
Harrow,Avanti House School,1231,27,28,55
Bedford,Bedford Free School,508,24,20,44
Hertfordshire,Alban City School,394,31,5,36
Kent,Tiger Primary School,427,58,6,64
Wigan,Atherton High School,509,68,22,90
Barnsley,All Saints Academy Darfield,218,35,4,39
West Northamptonshire,The Parker E-ACT Academy,1166,151,45,196
North East Lincolnshire,Oasis Academy Nunsthorpe,417,95,11,106
Essex,Becket Keys Church of England Free School,1053,91,22,113
Hampshire,Manor Church of England Infant School,73,11,2,13
Staffordshire,Hopedale School,57,1,56,57
Greenwich,Ark Greenwich Free School,595,94,10,104
"Kingston upon Hull, City of",Sirius Academy North,1252,225,18,243
Nottinghamshire,Outwood Academy Valley,1741,159,17,176
Nottinghamshire,Outwood Academy Portland,1662,219,9,228
"Bournemouth, Christchurch and Poole",Bournemouth Christian School,21,0,15,15
Suffolk,Breckland School,566,50,20,70
Bradford,Dixons Trinity Academy,638,98,24,122
Bradford,Dixons Music Primary,421,55,14,69
Milton Keynes,Stephenson Academy,92,0,92,92
North Northamptonshire,Corby Technical School,999,97,21,118
Northumberland,Cramlington Village Primary School,196,55,8,63
Waltham Forest,Emmanuel Community School,181,20,7,27
Sefton,King's Leadership Academy Hawthornes,553,148,12,160
Brighton and Hove,Bilingual Primary School - Brighton & Hove,613,46,5,51
Tower Hamlets,South Quay College,41,29,10,39
Nottingham,Stone Soup Academy,0,0,0,0
Hounslow,Reach Academy Feltham,921,131,28,159
Wandsworth,Ark Bolingbroke Academy,773,103,36,139
Shropshire,Barrow 1618 CofE Free School,97,9,1,10
Oxfordshire,Europa School UK,1039,113,2,115
Southwark,Harris Primary Free School Peckham,221,17,5,22
Peterborough,Medeshamstede Academy,104,0,104,104
Barnet,Rimon Jewish Primary School,200,17,8,25
Suffolk,Set Saxmundham School,222,49,41,90
Suffolk,Set Beccles School,288,55,28,83
Tower Hamlets,Solebay Primary - A Paradigm Academy,218,10,6,16
Derby,Derby Pride Academy,4,4,0,4
"Bristol, City of",Oasis Academy Connaught,374,52,10,62
North East Lincolnshire,Weelsby Academy,346,74,4,78
Cambridgeshire,Winhills Primary Academy,269,64,8,72
Birmingham,Wilson Stuart School,263,2,261,263
Lincolnshire,"The National Church of England Junior School, Grantham",275,37,9,46
Lincolnshire,"The Harrowby Church of England Infant School, Grantham",50,5,3,8
Lincolnshire,Rauceby Church of England Primary School,167,14,5,19
Gateshead,Riverside Primary Academy,327,77,6,83
Hertfordshire,Beaumont School,1543,296,33,329
Hampshire,The Costello School,1186,143,24,167
Hertfordshire,St Catherine of Siena Catholic Primary School,269,37,5,42
Oxfordshire,Burford School,1495,177,25,202
Leicestershire,Saint Martin's Catholic Voluntary Academy,775,115,19,134
Lincolnshire,Boston West Academy,421,38,15,53
Hertfordshire,St Mary Roman Catholic Primary School,231,30,8,38
Wakefield,Crigglestone St James CofE Primary Academy,315,41,10,51
Leicestershire,Sacred Heart Catholic Voluntary Academy,193,19,1,20
Leicestershire,"Saint Mary's Catholic Primary School, Loughborough",195,36,3,39
Leicestershire,"Saint Clare's Primary School A Catholic Voluntary Academy, Coalville, Leicestershire",200,21,4,25
Leicestershire,Holy Cross School A Catholic Voluntary Academy,138,22,4,26
Leicestershire,De Lisle College Loughborough Leicestershire,1291,99,18,117
Leicestershire,"Saint Winefride's Catholic Voluntary Academy, Shepshed, Leicestershire",146,28,4,32
Blackpool,Waterloo Primary Academy,592,133,5,138
Leicestershire,The Newbridge School,798,99,21,120
Calderdale,"Holy Trinity Primary School, A Church of England Academy",410,42,11,53
Birmingham,Warren Farm Primary School,323,63,1,64
Leeds,Crawshaw Academy,1118,167,14,181
Swindon,Tregoze Primary School,209,51,6,57
Swindon,Rodbourne Cheney Primary School,252,24,7,31
Swindon,Nyland School,59,5,54,59
Swindon,Mountford Manor Primary School,228,54,10,64
Swindon,Drove Primary School,723,69,15,84
Plymouth,Elburton Primary School,465,53,7,60
Essex,"St Teresa's Catholic Primary School, Colchester",214,19,2,21
Westminster,Westminster City School,772,113,4,117
Westminster,The Grey Coat Hospital,1139,127,22,149
Doncaster,Armthorpe Academy,641,85,15,100
Devon,Pilton Bluecoat Church of England Academy,259,30,5,35
Hertfordshire,St John Roman Catholic Primary School,166,20,4,24
"Bristol, City of",Christ Church Church of England Primary School,320,28,7,35
Cheshire West and Chester,Neston High School,1757,185,47,232
Leicestershire,Huncote Primary School,184,22,4,26
Hertfordshire,Our Lady Catholic Primary School,160,18,1,19
Leicestershire,Brookvale Groby Learning Campus,1426,56,26,82
Lincolnshire,Ruskington Chestnut Street Church of England Academy,197,23,6,29
Havering,The Frances Bardsley Academy for Girls,1432,30,18,48
Leicestershire,Heath Lane Academy,643,127,11,138
Medway,Chattenden Primary School,209,26,3,29
Rotherham,St Bernard's Catholic High School,791,115,20,135
Lincolnshire,The Gainsborough Hillcrest Early Years Academy,251,40,8,48
Sunderland,East Herrington Primary Academy,464,71,3,74
Wakefield,The Vale Primary Academy,239,26,4,30
"Bournemouth, Christchurch and Poole",Kings Bournemouth,108,16,2,18
Thurrock,The Gateway Primary Free School,435,56,8,64
Croydon,St Cyprian's Greek Orthodox Primary Academy,359,81,3,84
Leeds,Rodillian Academy,1647,390,29,419
Sheffield,All Saints' Catholic High School,1372,93,28,121
Nottingham,Our Lady of Perpetual Succour Catholic Primary School,237,34,1,35
Nottingham,St Mary's Catholic Primary School,238,30,0,30
Nottingham,St Teresa's Catholic Primary School,420,40,0,40
Nottingham,The Trinity Catholic School A Voluntary Academy,1172,98,4,102
Windsor and Maidenhead,Altwood CofE Secondary School,654,71,36,107
Walsall,Woodlands Academy of Learning,459,48,11,59
Leicestershire,Farndon Fields Primary School,332,26,7,33
Leicestershire,Meadowdale Primary School,361,31,10,41
Leicestershire,Ridgeway Primary Academy,276,45,12,57
Leicestershire,Parkland Primary School South Wigston,572,52,14,66
Thurrock,Harris Primary Academy Chafford Hundred,670,49,12,61
Leicestershire,Ivanhoe College,899,159,13,172
Staffordshire,The Rural Enterprise Academy,236,103,12,115
Hertfordshire,Tring School,1540,166,25,191
Nottinghamshire,Cotgrave Candleby Lane School,586,67,7,74
Hertfordshire,St Thomas More Roman Catholic Primary School,224,18,2,20
Wirral,Hilbre High School,1189,215,76,291
Hertfordshire,St George's School,1369,154,20,174
Rotherham,Thurcroft Junior Academy,275,44,2,46
Leicestershire,Kibworth Church of England Primary School,592,60,10,70
Leicestershire,"Great Bowden Academy, A Church of England Primary School",123,14,4,18
Hertfordshire,St Mary's Church of England High School (VA),1092,138,20,158
Sheffield,Notre Dame High School,1508,65,31,96
Darlington,Gurney Pease Academy,214,52,1,53
Waltham Forest,Willow Brook Primary School Academy,636,80,22,102
Wokingham,Oakbank,553,72,26,98
Hillingdon,Parkside Studio College,43,4,1,5
Torbay,Barton Hill Academy,645,125,40,165
Torbay,Torquay Academy,1422,69,37,106
Reading,Meadow Park Academy,370,112,11,123
Suffolk,Chantry Academy,934,113,47,160
Walsall,West Walsall E-ACT Academy,1172,193,23,216
Somerset,Bridgwater College Academy,1568,413,59,472
"Bristol, City of",The Dolphin School,223,34,9,43
Bromley,Clannad Education Centre,4,1,3,4
Liverpool,Everton Free School,197,22,12,34
Leeds,Lighthouse School Leeds,81,0,81,81
Enfield,Enfield Heights Academy,199,22,9,31
Bromley,Kings London,119,9,4,13
"Bournemouth, Christchurch and Poole",LeAF Studio,431,57,7,64
Bexley,Park View Academy,35,0,35,35
Hertfordshire,Garden City Academy,203,42,4,46
East Sussex,Heron Park Primary Academy,323,52,4,56
East Sussex,Oakwood Primary Academy,322,38,8,46
East Sussex,Glenleigh Park Primary Academy,397,66,7,73
Barnsley,Wilthorpe Primary School,415,44,10,54
Birmingham,Chilwell Croft Academy,392,59,6,65
Birmingham,Nechells Primary E-ACT Academy,210,38,3,41
Birmingham,Ark Tindal Primary Academy,446,58,4,62
Calderdale,Field Lane Primary School,111,30,6,36
Bolton,The Ferns Primary Academy,446,77,5,82
East Sussex,King Offa Primary Academy,414,52,1,53
Wakefield,Willow Green Academy,226,29,7,36
West Sussex,Portfield Primary Academy,245,42,21,63
Newham,London Academy of Excellence,474,15,0,15
Essex,Briscoe Primary School & Nursery Academy,334,62,4,66
Kent,Earlscliffe (Sussex Summer Schools Ltd),129,12,0,12
Wandsworth,Wandsworth Preparatory School,83,17,1,18
Kent,Pier View Academy,29,0,29,29
"Bristol, City of",Oasis Academy Bank Leaze,213,33,2,35
Birmingham,Percy Shurmer Academy,459,38,26,64
Nottinghamshire,Meden School,1030,136,7,143
West Sussex,Southway Primary School,554,76,8,84
Sheffield,Chaucer School,835,151,15,166
Barnsley,Gooseacre Primary Academy,353,53,6,59
Salford,Dukesgate Academy,224,58,6,64
Walsall,Croft Academy,250,45,5,50
Gloucestershire,The Dean Academy,604,65,30,95
West Northamptonshire,Eastfield Academy,224,20,6,26
Swindon,The Croft Primary School,419,57,9,66
Birmingham,The Shirestone Academy,241,30,0,30
Gloucestershire,The Ridge Academy,63,1,62,63
Warwickshire,Race Leys Junior School,239,38,4,42
Birmingham,St Clement's Church of England Academy,207,33,1,34
Birmingham,"St Michael's CofE Primary Academy, Handsworth",179,23,4,27
Kent,Northdown Primary School,325,45,13,58
Staffordshire,Tamworth Enterprise College and AET Academy,587,76,11,87
Kent,Newlands Primary School,291,83,16,99
Hampshire,Bridgemary School,823,194,25,219
Kent,Salmestone Primary School,215,36,6,42
Milton Keynes,Sir Herbert Leon Academy,625,80,12,92
Milton Keynes,Charles Warren Academy,205,28,7,35
Calderdale,Compass Community School North,7,2,5,7
Lincolnshire,Skegness Junior Academy,316,52,12,64
Derby,Wyndham Spencer Academy,484,92,10,102
Lincolnshire,Ingoldmells Academy,127,35,4,39
Lincolnshire,Mablethorpe Primary Academy,335,55,14,69
Haringey,Harris Primary Academy Coleraine Park,444,36,13,49
Haringey,Harris Primary Academy Philip Lane,439,33,18,51
"Bristol, City of",Orchard School Bristol,905,217,15,232
Greenwich,Harris Academy Greenwich,1163,136,31,167
Cheshire West and Chester,The Bridge Short Stay School,52,46,4,50
Walsall,Reedswood E-ACT Academy,494,68,14,82
West Sussex,Broadfield Primary Academy,532,85,3,88
Waltham Forest,Lime Academy Hornbeam,265,0,265,265
North Somerset,Voyage Learning Campus,44,38,4,42
Brent,Wembley High Technology College,1396,27,24,51
Harrow,Salvatorian Roman Catholic College,618,103,15,118
Kingston upon Thames,The Holy Cross School,977,58,24,82
Richmond upon Thames,Teddington School,1307,133,29,162
Richmond upon Thames,Waldegrave School,1457,142,48,190
Solihull,Tudor Grange Primary Academy Hockley Heath,220,24,1,25
Liverpool,St Francis Xavier's College,1097,195,16,211
Trafford,Loreto Grammar School,1034,25,1,26
"Bristol, City of",St Patrick's Catholic Primary School,206,17,5,22
North Somerset,Nailsea School,1096,45,42,87
North East Lincolnshire,Bursar Primary Academy,293,50,7,57
North East Lincolnshire,Thrunscoe Primary and Nursery Academy,310,42,7,49
Luton,Chantry Primary Academy,667,147,26,173
Derbyshire,"St Mary's Catholic High School, A Catholic Voluntary Academy",1353,134,28,162
Dorset,The Gryphon School,1552,103,42,145
East Sussex,Hailsham Community College,1633,139,32,171
East Sussex,Seaford Head School,1376,121,27,148
East Sussex,Ratton School,1194,146,15,161
East Sussex,The Cavendish School,1362,181,14,195
Southampton,St Anne's Catholic School,1228,100,12,112
Leicestershire,The Castle Rock School,1221,230,21,251
Swindon,King William Street Church of England Primary School,205,10,4,14
Kent,The Harvey Grammar School,1026,29,3,32
Nottinghamshire,Rushcliffe Spencer Academy,2000,92,21,113
Cheshire West and Chester,Tarporley High School and Sixth Form College,1217,96,16,112
Hertfordshire,The Sele School,423,105,12,117
Hertfordshire,Knightsfield School,65,0,65,65
Lincolnshire,Branston Junior Academy,171,24,7,31
Lincolnshire,St Andrew's CofE Primary School,294,29,6,35
Oxfordshire,Didcot Girls' School,1614,179,23,202
Surrey,The Bishop Wand Church of England School,1142,114,30,144
West Sussex,Greenway Junior School,336,57,4,61
West Northamptonshire,Spring Lane Primary School,473,68,15,83
Merton,Harris Academy Morden,868,176,31,207
Gloucestershire,SGS Forest High School,281,57,8,65
Stoke-on-Trent,Harpfield Primary Academy,236,33,3,36
Bolton,Bolton Islamic Girls School,121,0,0,0
Oxfordshire,Wykham Park,963,180,6,186
Oxfordshire,Dashwood Banbury Academy,439,58,8,66
Croydon,Robert Fitzroy Academy,577,86,10,96
Worcestershire,Arrow Vale High School,839,106,10,116
Suffolk,Ormiston Sudbury Academy,703,143,17,160
Hertfordshire,The Grove Academy,524,60,11,71
Nottingham,"St Augustine's Catholic Primary and Nursery School, A Voluntary Academy",339,33,0,33
Medway,Phoenix Primary School,359,75,7,82
Medway,The Robert Napier School,1037,232,14,246
Derby,St John Fisher Catholic Voluntary Academy,203,38,1,39
Hackney,Vishnitz Girls School,446,30,8,38
Redbridge,Ark Isaac Newton Academy,1750,159,49,208
North Lincolnshire,Worlaby Academy,62,5,0,5
Leicestershire,Brockington College,1189,168,31,199
Bath and North East Somerset,Ralph Allen School,1371,121,55,176
Darlington,St Bede's Catholic Primary School,330,30,5,35
West Berkshire,Trinity School,1234,64,71,135
Sunderland,Portland Academy,190,1,189,190
Leicestershire,Thomas Estley Community College,885,151,26,177
Leicestershire,Cosby Primary School,287,21,4,25
Sunderland,Barbara Priestman Academy,170,0,170,170
"Bristol, City of",Westbury Park School,417,30,7,37
Manchester,Melland High School,186,0,186,186
Essex,Newlands Spring Primary and Nursery School,464,18,10,28
Sunderland,Holley Park Academy,258,21,4,25
Wakefield,Simpson's Lane Academy,378,95,8,103
Solihull,Balsall Common Primary School,695,77,12,89
Blackpool,Hawes Side Academy,523,43,6,49
Hertfordshire,Northgate Primary School,458,39,7,46
Walsall,Jubilee Academy Mossley,207,42,6,48
Somerset,King Ina Church of England Academy,375,15,9,24
North East Lincolnshire,Yarborough Academy,445,52,14,66
Salford,Broughton Jewish Cassel Fox Primary School,411,37,5,42
Lancashire,Albany Academy,723,80,35,115
Sheffield,Meadowhead School Academy Trust,1919,267,40,307
Greenwich,Charlton Park Academy,225,2,223,225
Stoke-on-Trent,Sutherland Primary Academy,519,105,8,113
Stoke-on-Trent,Haywood Academy,1154,178,38,216
Stoke-on-Trent,Eaton Park Academy,474,91,5,96
Stoke-on-Trent,The Crescent Academy,669,98,18,116
Leicester,Queensmead Primary Academy,428,31,10,41
County Durham,Acre Rigg Academy,256,65,4,69
County Durham,Victoria Lane Academy,189,36,4,40
County Durham,Stephenson Way Academy and Nursery School,320,72,2,74
County Durham,Tudhoe Colliery Primary School,214,37,2,39
Central Bedfordshire,St. Augustine's Academy,178,36,4,40
Middlesbrough,Brambles Primary Academy,336,50,6,56
Middlesbrough,Pennyman Primary Academy,415,47,39,86
Warrington,King's Leadership Academy Warrington,760,65,9,74
South Gloucestershire,Aurora Hedgeway School,55,0,55,55
Tower Hamlets,Buttercup Primary School,153,39,0,39
Brighton and Hove,Central Hub Brighton,88,61,27,88
Sunderland,Christ's College,698,114,10,124
Oldham,Darul Hadis Latifiah Northwest,76,0,0,0
Nottinghamshire,Mansfield Primary Academy,215,28,6,34
Central Bedfordshire,Queensbury Academy,1238,171,33,204
Essex,White Hall Academy,736,172,18,190
North Tyneside,Grasmere Academy,105,31,22,53
Newcastle upon Tyne,Welbeck Academy,453,114,20,134
Kent,Water Meadows Primary School,148,27,5,32
Shropshire,Physis Academy,6,5,1,6
Thurrock,Thameside Primary School,857,177,25,202
Hertfordshire,Samuel Ryder Academy,1508,184,27,211
Buckinghamshire,Chalfont Valley E-ACT Primary Academy,179,23,3,26
Kirklees,Christ Church CE Academy,219,60,12,72
Hampshire,The New Forest Academy,573,59,23,82
Birmingham,Nishkam High School,652,48,13,61
Haringey,Noel Park Primary School,587,38,18,56
Haringey,Trinity Primary Academy,475,16,16,32
Birmingham,Slade Primary School,453,57,8,65
Walsall,Goldsmith Primary Academy,445,86,8,94
Kent,St Laurence In Thanet Church of England Junior Academy,177,36,9,45
Wakefield,The Featherstone Academy,485,81,27,108
Cambridgeshire,Middlefield Primary Academy,208,30,3,33
Halton,Hope Corner School,4,0,4,4
Kensington and Chelsea,The Stewart Bilingual School,44,3,0,3
Oxfordshire,Kings Education (Oxford),254,11,0,11
North Somerset,Herons' Moor Academy,461,34,6,40
Essex,Greensted Primary School & Nursery,454,52,11,63
Milton Keynes,Orchard Academy,357,43,18,61
Walsall,Blue Coat Church of England Academy,897,138,24,162
Hammersmith and Fulham,Lady Margaret School,763,102,19,121
Brent,Sudbury Primary School,913,82,20,102
Brent,Queens Park Community School,1288,294,42,336
Brent,Alperton Community School,1909,176,25,201
Bromley,Crofton Infant School,596,9,23,32
Croydon,St Thomas Becket Catholic Primary School,411,36,10,46
Hillingdon,Cranford Park Academy,915,76,24,100
Trafford,Altrincham College,1007,84,34,118
Barnsley,Upperwood Academy,306,40,3,43
Bath and North East Somerset,Chew Stoke Church School,172,12,4,16
West Sussex,The Oaks Primary School & Nursery,444,60,9,69
Swindon,"St Catherine's Catholic Primary School, Swindon",228,15,5,20
West Sussex,Thomas Bennett Community College,1257,229,34,263
Hillingdon,Wood End Park Academy,936,45,17,62
Derby,"Saint Benedict, A Catholic Voluntary Academy",1338,162,35,197
Wiltshire,St John's Marlborough,1728,182,30,212
Southampton,Ludlow Infant Academy,271,82,8,90
Southampton,Portswood Primary School,458,48,13,61
Leicestershire,Long Field Spencer Academy,909,162,26,188
Wiltshire,Easton Royal Academy,57,10,0,10
Wiltshire,Devizes School,1211,207,36,243
Devon,Aveton Gifford CofE Primary School,104,13,2,15
Hertfordshire,Monk's Walk School,1394,166,32,198
County Durham,Ribbon School,500,79,9,88
North Northamptonshire,Maplefields Academy,115,0,115,115
Windsor and Maidenhead,White Waltham CofE Academy,202,27,2,29
Swindon,Holy Family Catholic Primary School,322,23,5,28
Lincolnshire,Louth Kidgate Primary Academy,422,49,8,57
Lincolnshire,Kesteven and Grantham Girls' School,1200,130,1,131
Lincolnshire,The Nettleham Infant and Nursery School,201,17,2,19
Lincolnshire,The Gainsborough Parish Church Primary School,298,68,2,70
Nottinghamshire,The Kimberley School,1392,64,9,73
Norfolk,Costessey Primary School,582,80,11,91
Warwickshire,Hartshill Academy,969,206,9,215
West Sussex,Seymour Primary School,477,56,7,63
Lancashire,Parklands High School,1107,84,13,97
West Sussex,Hilltop Primary School,603,106,5,111
Bexley,St Columba's Catholic Boys' School,841,133,45,178
Richmond upon Thames,Orleans Park School,1364,110,48,158
Gateshead,The Cedars Academy,238,0,238,238
Manchester,Briscoe Lane Academy,626,102,15,117
Trafford,Elmridge Primary School,234,23,3,26
"Bristol, City of",Begbrook Primary Academy,601,86,10,96
Calderdale,Siddal Primary School,198,41,7,48
"Bristol, City of",Summerhill Academy,244,33,7,40
Slough,Castleview Primary School,475,22,41,63
Nottinghamshire,Foxwood Academy,113,0,113,113
Cheshire East,Eaton Bank Academy,1052,44,32,76
Nottingham,Whitemoor Academy (Primary and Nursery),433,75,11,86
Worcestershire,Waseley Hills High School,775,125,16,141
Lincolnshire,"Queen Elizabeth's Grammar School, Horncastle",842,61,0,61
Derby,St George's Catholic Voluntary Academy,328,50,8,58
Oxfordshire,Lord Williams's School,2229,203,72,275
"Bristol, City of",Filton Avenue Primary School,588,66,20,86
Cornwall,Tregolls Academy,309,42,22,64
North Northamptonshire,Beanfield Primary School,722,66,66,132
Leeds,Park View Primary Academy,248,34,0,34
Gloucestershire,Brockworth Primary Academy,350,69,9,78
Bradford,Ryecroft Primary Academy,216,25,3,28
"Kingston upon Hull, City of",Newington Academy,413,65,9,74
"Kingston upon Hull, City of",The Green Way Academy,416,80,4,84
"Kingston upon Hull, City of",Hall Road Academy,386,46,10,56
Hammersmith and Fulham,Ark Bentworth Primary Academy,181,16,7,23
Wandsworth,Ark Putney Academy,940,106,48,154
Wandsworth,Southfields Academy,1296,240,78,318
Westminster,Millbank Academy,230,20,21,41
Barking and Dagenham,Thames View Infants,419,102,6,108
Barnet,Copthall School,962,42,20,62
Bexley,Cleeve Park School,1007,233,32,265
Croydon,Oasis Academy Byron,203,40,2,42
Harrow,Krishna Avanti Primary School,452,18,9,27
Kingston upon Thames,Latchmere School,870,99,32,131
Waltham Forest,Barclay Primary School,1325,97,45,142
Waltham Forest,Chingford Foundation School,1485,96,76,172
Birmingham,Greenholm Primary School,633,81,6,87
Birmingham,Barr View Primary & Nursery Academy,450,65,11,76
Birmingham,George Dixon Academy,1026,127,2,129
Liverpool,West Derby School,1020,205,29,234
Oldham,New Bridge School,596,0,596,596
Salford,Beis Yaakov High School,309,61,8,69
Wigan,The Byrchall High School,1001,128,27,155
Barnsley,The Hill Primary Academy,372,34,8,42
Barnsley,Highgate Primary Academy,351,36,10,46
Barnsley,Carrfield Primary Academy,289,38,9,47
Doncaster,St Oswald's CofE Academy,230,31,0,31
Doncaster,Armthorpe Shaw Wood Academy,418,67,11,78
Kirklees,King James's School,1030,111,16,127
Wakefield,Horbury Academy,1109,141,32,173
"Bristol, City of",Cotham Gardens Primary School,536,91,6,97
"Bristol, City of",Greenfield E-ACT Primary Academy,368,55,9,64
"Bristol, City of",Oasis Academy New Oak,201,54,27,81
Middlesbrough,Outwood Academy Ormesby,923,193,17,210
North Lincolnshire,Epworth Primary Academy,295,26,3,29
North Lincolnshire,Westwoodside Church of England Academy,140,17,3,20
Central Bedfordshire,The Vale Academy,617,63,5,68
Milton Keynes,Shepherdswell Academy,137,17,8,25
Dorset,Wyvern Academy,89,0,89,89
County Durham,Woodham Academy,1025,154,15,169
County Durham,Hope Wood Academy,223,0,223,223
Hampshire,Hook-With-Warsash Church of England Academy,409,30,4,34
Hampshire,Eggar's School,844,81,21,102
Leicestershire,Ibstock Community College,709,122,20,142
Staffordshire,The Faber Catholic Primary School,66,6,1,7
Staffordshire,St Filumena's Catholic Primary School,183,13,0,13
Staffordshire,St Giles Catholic Primary School,216,9,1,10
Staffordshire,St Mary's Catholic Academy,168,19,4,23
Staffordshire,St Thomas' Catholic Primary School,207,12,2,14
Staffordshire,St Joseph's Catholic Primary School,190,16,4,20
Staffordshire,The Rawlett School (An Aet Academy),1074,96,12,108
Staffordshire,Painsley Catholic College,1310,73,17,90
Slough,Phoenix Infant Academy,259,65,13,78
Warrington,Lymm High School,1916,137,46,183
Devon,Christow Primary School,94,10,0,10
Essex,"Joyce Frankland Academy, Newport",1022,73,13,86
Thurrock,Kenningtons Primary Academy,420,46,8,54
Thurrock,Beacon Hill Academy,73,1,72,73
Kent,West Malling Church of England Primary School and McGinty Speech and Language Srp,207,25,20,45
Kent,Sturry Church of England Primary School,406,51,9,60
Blackpool,Norbreck Primary Academy,598,55,7,62
Nottingham,Old Basford School,463,56,0,56
Nottingham,The Milford Academy,471,72,3,75
Cheshire West and Chester,Kelsall Primary  and Nursery School,253,8,3,11
Cheshire West and Chester,"The County High School, Leftwich",1029,86,18,104
Cumbria,Ghyllside Primary School,463,48,10,58
Gloucestershire,Newent Community School and Sixth Form Centre,1091,204,17,221
Hertfordshire,Hertswood Academy,1216,114,15,129
Lincolnshire,Ling Moor Primary Academy,419,52,8,60
Lincolnshire,Hogsthorpe Primary Academy,57,12,0,12
Lincolnshire,Skegness Infant Academy,315,27,6,33
Lincolnshire,Carlton Road Academy,449,73,8,81
Lincolnshire,Staniland Academy,545,90,9,99
Lincolnshire,Ellison Boulters Church of England Primary School,286,47,3,50
Lincolnshire,Haven High Academy,1446,264,40,304
Lincolnshire,William Lovell Church of England Academy,296,89,19,108
Lincolnshire,Skegness Grammar School,669,67,5,72
Norfolk,Acle Academy,578,36,14,50
West Northamptonshire,Boughton Primary School,192,23,2,25
North Northamptonshire,Gretton Primary Academy,143,11,3,14
Oxfordshire,St Birinus School,1040,189,22,211
Somerset,Axbridge Church of England First School Academy,183,5,1,6
Surrey,Danetree Primary School,932,145,29,174
Surrey,The Matthew Arnold School,966,163,50,213
Surrey,Wishmore Cross Academy,78,0,78,78
Warwickshire,Shipston High School,605,109,9,118
Windsor and Maidenhead,"The King's House School, Windsor",44,11,0,11
Hounslow,The St Michael Steiner School,129,6,1,7
Torbay,Curledge Street Academy,459,83,23,106
Torbay,Kings Ash Academy,407,144,19,163
Oxfordshire,John Henry Newman Academy,344,95,11,106
Birmingham,East Birmingham Network Academy,0,0,0,0
Derby,Zaytouna Primary School,419,48,7,55
Camden,La Petite Ecole Bilingue,97,5,0,5
Norfolk,Novaturient School,14,0,14,14
Lincolnshire,King Edward VI Academy,437,114,14,128
Manchester,Rushbrook Primary Academy,566,79,25,104
Manchester,Stanley Grove Primary Academy,694,82,19,101
Gloucestershire,Offa's Mead Academy,145,38,8,46
Liverpool,Childwall Sports & Science Academy,1046,256,15,271
Trafford,Forest Gate Academy,222,45,8,53
"Bristol, City of",Minerva Primary Academy,379,59,9,68
Derby,Landau Forte Academy Moorhead,207,19,5,24
"Bristol, City of",Frome Vale Academy,193,19,5,24
Norfolk,Great Yarmouth Primary Academy,433,55,12,67
"Bristol, City of",Fishponds Church of England Academy,365,95,8,103
Norfolk,Dersingham Primary School,211,48,2,50
Norfolk,Kelling CE Primary School,49,8,0,8
Norfolk,Walsingham CE VA Primary School,38,7,0,7
Birmingham,Nansen Primary School,702,115,6,121
Newham,Hafs Academy,66,2,0,2
Lambeth,"Octavia House Schools, London",82,0,82,82
Leicestershire,Ashby Hill Top Primary School,305,31,3,34
Leicestershire,Broomfield Community Primary School,184,22,4,26
Leicestershire,Eastfield Primary School,356,47,9,56
Leicestershire,Gaddesby Primary School,191,20,2,22
Lincolnshire,Huttoft Primary & Nursery School,176,40,7,47
Leicestershire,Lady Jane Grey Primary School,212,1,6,7
Nottinghamshire,Christ The King Voluntary Academy,850,68,14,82
Nottinghamshire,"The Good Shepherd Catholic Primary, Arnold",450,46,2,48
Nottinghamshire,Holy Cross Primary Catholic Voluntary Academy,223,17,7,24
Nottinghamshire,The Sacred Heart Primary Catholic Voluntary Academy,223,6,3,9
Nottingham,St Margaret Clitherow Catholic Primary School,228,13,1,14
"Bournemouth, Christchurch and Poole",Stourfield Infant School,304,57,6,63
Lincolnshire,"The Little Gonerby Church of England Primary Academy, Grantham",106,13,7,20
Oxfordshire,The Marlborough Church of England School,1072,159,42,201
Leicestershire,The Merton Primary School,411,52,3,55
Leicestershire,The Priory Belvoir Academy,688,88,29,117
Leicestershire,Castle Donington College,639,64,7,71
West Northamptonshire,Wootton Primary School,377,39,8,47
Windsor and Maidenhead,Charters School,1727,147,28,175
Leeds,Manston St James Primary Academy,383,55,7,62
Richmond upon Thames,Grey Court School,1549,220,51,271
County Durham,New Seaham Academy,236,15,0,15
North Lincolnshire,St Norbert's Catholic Voluntary Academy,126,11,4,15
Sheffield,"St Thomas of Canterbury School, a Catholic Voluntary Academy",252,31,17,48
Norfolk,Reepham High School and College,1027,145,25,170
Sheffield,St Wilfrid's Catholic Primary School,301,44,7,51
North Lincolnshire,Winterton Community Academy,487,76,12,88
Nottinghamshire,Alderman White School,756,90,12,102
Essex,Brentwood Ursuline Convent High School,1007,43,6,49
Lancashire,Bacup and Rawtenstall Grammar School,1245,33,5,38
Derbyshire,The Bolsover School,855,104,20,124
Nottinghamshire,Bramcote College,731,70,5,75
Leicestershire,The Pochin School,133,19,0,19
Lincolnshire,"Sir William Robertson Academy, Welbourn",1047,135,34,169
West Northamptonshire,Welton Church of England Academy,130,9,1,10
Sheffield,King Ecgbert School,1387,71,66,137
Somerset,St. Michael's Academy,255,47,8,55
Central Bedfordshire,Holywell School,719,110,16,126
Redcar and Cleveland,Nunthorpe Academy,1521,146,28,174
North East Lincolnshire,Ormiston South Parade Academy,561,91,14,105
Sheffield,"St Marie's School, A Catholic Voluntary Academy",216,15,4,19
Somerset,Pen Mill Infant and Nursery Academy,150,20,1,21
Liverpool,St Margaret's Church of England Academy,1026,187,26,213
Bolton,"St Paul's CofE Primary School, Astley Bridge",254,24,9,33
Wolverhampton,St Peter's Collegiate Academy,1341,221,14,235
Wirral,Woodchurch High School,1426,369,74,443
Middlesbrough,North Ormesby Primary Academy,296,34,3,37
"Bristol, City of",Redland Green School,1622,183,38,221
North East Lincolnshire,Edward Heneage Primary Academy,249,47,5,52
West Northamptonshire,Abbeyfield School,1347,159,16,175
Waltham Forest,South Chingford Foundation School,557,51,20,71
"Bournemouth, Christchurch and Poole",Queen's Park Academy,480,44,5,49
Torbay,Paignton Academy,1461,262,55,317
Birmingham,Montgomery Primary Academy,464,73,5,78
Essex,The James Hornsby School,970,141,37,178
North East Lincolnshire,Strand Primary Academy,156,27,10,37
Bradford,Feversham Primary Academy,486,109,7,116
Lancashire,Meadow View Learning Centre,9,0,9,9
Leicester,Madani Boys School,392,42,7,49
Gloucestershire,OneSchoolGlobal Bristol Campus,124,35,2,37
Oxfordshire,The Treehouse School,15,6,0,6
Shropshire,Amberleigh Therapeutic School,12,2,4,6
Suffolk,Include Suffolk,48,9,18,27
Liverpool,Assess Education,46,18,18,36
Windsor and Maidenhead,Desborough College,837,80,22,102
Norfolk,Turnstone House School,9,0,9,9
Birmingham,St John's & St Peter's CofE Academy,210,29,8,37
Blackburn with Darwen,Aurora Woodlands School,50,0,50,50
Wiltshire,The Clarendon Academy,979,118,53,171
Birmingham,Billesley Primary School,681,103,25,128
Birmingham,Kings Rise Academy,440,77,6,83
North East Lincolnshire,Macaulay Primary Academy,432,49,10,59
Leicestershire,Broom Leys School,605,101,12,113
Leeds,Lane End Primary School,439,64,4,68
Leicestershire,Wigston College,268,16,2,18
East Sussex,Bexhill High Academy,1519,268,34,302
Cumbria,Crosby-on-Eden CofE School,90,11,0,11
Oxfordshire,Gosford Hill School,838,139,10,149
Southampton,Hollybrook Infant School,179,16,6,22
Staffordshire,The Mosley Academy,212,12,3,15
"Bristol, City of",Little Mead Primary Academy,453,63,20,83
Essex,Notley Green Primary School,400,54,7,61
Leicestershire,St Michael & All Angels Church of England Primary School,78,18,2,20
Southampton,Shirley Infant School,270,15,7,22
"Bristol, City of",Parson Street Primary School,353,50,9,59
Leicestershire,Bottesford Church of England Primary School,235,12,11,23
Leicestershire,Holywell Primary School,418,28,7,35
Doncaster,Dunsville Primary School,262,31,3,34
Leicestershire,Rendell Primary School,387,49,5,54
Warwickshire,Tanworth-in-Arden CofE Primary School,236,22,3,25
Southampton,Shirley Junior School,361,28,10,38
Essex,Cann Hall Primary School,420,80,7,87
Warwickshire,Dordon Primary School,209,48,4,52
Warwickshire,Riverside Academy,211,46,4,50
Warwickshire,Oakfield Primary Academy,404,60,4,64
Bradford,St Oswald's Church of England Primary Academy,441,32,9,41
West Northamptonshire,Briar Hill Primary School & Nursery,305,36,2,38
Norfolk,The Nicholas Hamond Academy,668,99,12,111
Hampshire,Winton Community Academy,927,130,49,179
Doncaster,Kirk Sandall Infant School,272,20,0,20
Sunderland,Oxclose Community Academy,1122,200,33,233
Hounslow,Heston Community School,1301,34,42,76
Sheffield,Fir Vale School,1022,253,16,269
Leicestershire,Thrussington Church of England Primary School,87,12,3,15
Blackpool,Thames Primary Academy,437,52,22,74
Surrey,Warlingham School,1437,269,33,302
Leicestershire,Church Hill Infant School,169,16,2,18
Leicestershire,Church Hill Church of England Junior School,292,45,2,47
Leicestershire,Queniborough Church of England Primary School,204,17,4,21
West Northamptonshire,Kingsthorpe College,1422,188,10,198
Milton Keynes,Rickley Park Primary School,460,65,12,77
Warwickshire,Birchwood Primary School,451,60,4,64
Leicestershire,Wigston Birkett House Community Special School,244,0,244,244
Staffordshire,The Wilnecote School,888,185,17,202
Birmingham,King Edward VI Handsworth Wood Girls' Academy,1014,72,4,76
Central Bedfordshire,Harlington Lower School,149,11,1,12
Central Bedfordshire,Sundon Lower School,76,8,0,8
Gloucestershire,Christ Church CofE Primary School,217,32,14,46
Wakefield,Sacred Heart Catholic Primary School,117,23,5,28
Somerset,St Cuthbert's Church of England Academy Infants and Pre-School,187,10,1,11
Havering,Upminster Infant School,261,15,3,18
Havering,Upminster Junior School,359,29,1,30
Leeds,St Benedict's Catholic Primary School,221,21,4,25
Wakefield,St Ignatius Catholic Primary School,148,31,3,34
Wakefield,St Joseph's Catholic Primary School,239,43,5,48
Lancashire,Penwortham Priory Academy,797,53,16,69
Wakefield,St Joseph's Catholic Primary School Castleford,202,27,1,28
Wakefield,"St Thomas à Becket Catholic Secondary School, A Voluntary Academy",756,76,58,134
Wakefield,St Wilfrid's Catholic High School & Sixth Form College: A Voluntary Academy,1503,167,65,232
West Northamptonshire,Abington Vale Primary School,439,30,8,38
West Northamptonshire,Ecton Brook Primary School,598,81,9,90
West Northamptonshire,Headlands Primary School,480,68,66,134
West Northamptonshire,Lings Primary School,429,42,7,49
West Northamptonshire,Weston Favell CofE Primary School,416,38,2,40
Bolton,"Ss Simon & Jude CofE Primary School, Bolton",601,51,10,61
Wakefield,St. John the Baptist Catholic Primary School,229,31,4,35
Southwark,Sacred Heart Catholic School,870,70,18,88
Southwark,St Michael's Catholic College,927,51,27,78
Thurrock,Herringham Primary Academy,401,47,11,58
Cornwall,Whitemoor Academy,104,17,0,17
Nottinghamshire,East Leake Academy,1090,107,9,116
Leicestershire,Barwell Church of England Academy,237,24,7,31
Reading,Trinity Christian School,21,4,0,4
Lincolnshire,Lincoln Carlton Academy,418,62,19,81
Birmingham,SILVER BIRCH SCHOOL,24,1,23,24
Kent,Dame Janet Primary Academy,371,62,10,72
Leeds,Cottingley Primary Academy,298,57,0,57
Medway,St James Church of England Primary Academy,199,27,4,31
North East Lincolnshire,Wybers Wood Academy,393,32,9,41
Sunderland,Hasting Hill Academy,231,55,4,59
Trafford,Acre Hall Primary School,306,36,36,72
Kirklees,Overthorpe CofE Academy,267,60,5,65
Staffordshire,Anglesey Primary Academy,591,71,7,78
Hillingdon,Belmore Primary Academy,614,79,16,95
Bath and North East Somerset,Broadlands Academy,495,89,8,97
Leeds,Co-op Academy Brownhill,444,68,4,72
Darlington,The Rydal Academy,619,146,16,162
"Bournemouth, Christchurch and Poole",Elm Academy,449,84,12,96
Derby,Grampian Primary Academy,222,34,12,46
Cambridgeshire,Hatton Park Primary School,394,41,10,51
Essex,Heybridge Primary School,446,76,3,79
Newcastle upon Tyne,Hilton Primary Academy,440,91,11,102
Essex,Kingsmoor Academy,343,37,4,41
Nottinghamshire,Kingston Park Academy,202,23,1,24
Birmingham,Mansfield Green E-ACT Academy,422,69,9,78
Leicestershire,Millfield L.E.A.D. Academy,405,47,3,50
Birmingham,Moor Green Primary Academy,448,37,4,41
Worcestershire,Perry Wood Primary and Nursery School,413,64,4,68
Birmingham,Reaside Academy,200,49,3,52
Birmingham,Lea Forest Primary Academy,559,66,8,74
Barnsley,Shafton Primary Academy,257,23,12,35
Leicestershire,Beacon Academy,328,45,55,100
Barnsley,St Helen's Primary Academy,219,29,2,31
Solihull,"Tudor Grange Primary Academy, St James",242,15,8,23
North East Lincolnshire,Saint Mary's Catholic Voluntary Academy,228,31,9,40
Birmingham,Tame Valley Academy,223,28,4,32
Birmingham,Merritts Brook Primary E-ACT Academy,204,52,4,56
Leeds,Co-op Academy Woodlands,468,92,0,92
Waltham Forest,The Woodside Primary Academy,1245,157,60,217
Bolton,Al-Huda Primary School,137,2,0,2
Peterborough,The Beeches Independent School,14,0,14,14
Devon,Woodwater Academy,333,57,14,71
Worcestershire,Ipsley CofE Middle School,641,101,9,110
Kent,Drapers Mills Primary Academy,330,48,9,57
Wiltshire,The Corsham Regis Primary Academy,143,43,2,45
North Lincolnshire,Oasis Academy Henderson Avenue,647,113,7,120
North Lincolnshire,Oasis Academy Parkwood,330,46,0,46
Sunderland,Fulwell Infant School Academy,370,18,5,23
Southampton,Ludlow Junior School,560,80,14,94
West Northamptonshire,Southfield Primary School,129,19,1,20
Wirral,St John Plessington Catholic College,1615,257,37,294
"Bristol, City of",St Nicholas of Tolentine Catholic Primary School,127,30,2,32
"Bristol, City of",St Teresa's Catholic Primary School,208,16,3,19
Leicestershire,Mountfields Lodge School,499,57,13,70
North Lincolnshire,Crowle Primary Academy,236,35,6,41
Hertfordshire,Kings Langley School,1100,142,22,164
"Bournemouth, Christchurch and Poole",Oak Academy,504,93,16,109
Leicestershire,Outwoods Edge Primary School,414,46,7,53
West Northamptonshire,Preston Hedges Primary School,418,22,4,26
Calderdale,St John's Primary School In Rishworth,145,15,2,17
Birmingham,"St Marys C of E Primary and Nursery, Academy, Handsworth",421,49,2,51
Sandwell,Bristnall Hall Academy,1042,135,94,229
Bradford,Whetley Academy,517,59,4,63
Birmingham,Four Dwellings Academy,571,88,6,94
Birmingham,Greenwood Academy,959,190,29,219
"Bristol, City of",Bridge Learning Campus,1154,315,24,339
"Bristol, City of",Bannerman Road Community Academy,388,69,10,79
Kent,Temple Grove Academy,208,46,6,52
Lancashire,Pendle Primary Academy,413,43,12,55
Manchester,Oasis Academy Harpur Mount,471,60,10,70
Milton Keynes,New Chapter Primary School,258,50,3,53
Norfolk,Iceni Academy,781,127,20,147
North Lincolnshire,Melior Community Academy,856,106,15,121
North Northamptonshire,Lodge Park Academy,1065,149,11,160
West Northamptonshire,The Arbours Primary Academy,296,15,3,18
Nottinghamshire,The Dukeries Academy,726,60,4,64
Nottinghamshire,Sutton Community Academy,817,104,12,116
Oxfordshire,Cutteslowe Primary School,336,65,11,76
Portsmouth,Beacon View Primary Academy,389,73,5,78
Reading,Battle Primary Academy,458,28,6,34
South Gloucestershire,Abbeywood Community School,1175,191,48,239
Stoke-on-Trent,Thistley Hough Academy,1044,180,19,199
Surrey,Weyfield Academy,202,35,8,43
Stoke-on-Trent,North Road Academy,215,22,4,26
Cornwall,Penryn Primary Academy,378,67,17,84
Kent,Meopham School,989,30,49,79
Kirklees,Manor Croft Academy,1013,99,20,119
Leeds,Co-op Academy Oakwood,455,65,2,67
Manchester,Seymour Road Academy,456,60,7,67
Oxfordshire,Kingfisher School,104,0,104,104
Wakefield,Outwood Primary Academy Kirkhamgate,229,13,3,16
West Berkshire,Fir Tree Primary School and Nursery,231,39,11,50
Peterborough,City of Peterborough Academy,845,107,16,123
Barnsley,Carlton Primary Academy,316,37,10,47
Barnsley,Parkside Primary Academy,248,38,9,47
Barnsley,Summerfields Primary Academy,212,31,4,35
Cambridgeshire,Histon and Impington Park Primary School,317,21,8,29
Cambridgeshire,Histon and Impington Brook Primary School,458,39,11,50
Cambridgeshire,Kennett Primary School,106,13,2,15
Cornwall,Lerryn CofE Primary School,30,3,2,5
Cornwall,St Mabyn CofE School,42,5,1,6
Cornwall,St Petroc's Church of England Voluntary Aided Primary School,560,57,11,68
Cornwall,St Tudy CofE Primary School,48,11,0,11
Cornwall,St Winnow CofE School,84,4,2,6
Croydon,Aerodrome Primary Academy,474,48,28,76
Hounslow,Brentford School for Girls,891,57,14,71
Kent,Allington Primary School,465,24,12,36
Leicestershire,Measham Church of England Primary School,200,36,2,38
Leicestershire,St Peter's Church of England Primary Academy,238,46,11,57
Norfolk,Eaton Hall Specialist Academy,52,0,52,52
Shropshire,Lakelands Academy,549,87,45,132
Sunderland,Farringdon Academy,381,56,1,57
Thurrock,Dilkes Academy,483,27,19,46
Thurrock,Belmont Castle Academy,728,46,28,74
Thurrock,Woodside Academy,665,145,25,170
Wakefield,Outwood Primary Academy Ledger Lane,451,40,7,47
West Sussex,Worthing High School,1075,133,52,185
Redcar and Cleveland,Kilton Thorpe Specialist Academy,168,0,168,168
West Northamptonshire,Woodvale Primary Academy,456,35,7,42
West Northamptonshire,Sunnyside Primary Academy,364,32,7,39
Liverpool,Harmonize Academy AP Free School,30,1,24,25
Bexley,Belvedere Junior School,311,35,8,43
"Bristol, City of",Henbury Court Primary Academy,302,70,6,76
Hillingdon,Brookside Primary School,348,32,4,36
"Kingston upon Hull, City of",Kingswood Academy,1375,149,15,164
Birmingham,Oasis Academy Blakenhale Infants,271,41,5,46
South Tyneside,Ridgeway Primary Academy,448,115,13,128
Birmingham,Oasis Academy Short Heath,468,110,3,113
Birmingham,"St George's Church of England Academy, Newtown",332,46,5,51
Warwickshire,The Nethersole CofE Academy,255,43,6,49
Birmingham,Oasis Academy Woodview,417,74,12,86
Birmingham,Oasis Academy Blakenhale Junior,348,65,3,68
Lancashire,Colne Primet Academy,827,91,17,108
Birmingham,Four Dwellings Primary Academy,335,61,5,66
Barnsley,Meadstead Primary Academy,234,42,25,67
Sheffield,Southey Green Primary School and Nurseries,734,159,11,170
Sheffield,Fox Hill Primary,313,65,25,90
Barnsley,The Forest Academy,353,51,11,62
Sheffield,Mansel Primary,450,93,8,101
Wolverhampton,Aldersley High School,1251,171,44,215
Cheshire East,All Hallows Catholic College,1235,146,38,184
Lincolnshire,Boston High School,833,59,2,61
Lincolnshire,Bracebridge Infant and Nursery School,77,9,0,9
Shropshire,Bridgnorth Endowed School,572,53,6,59
Wirral,Calday Grange Grammar School,1530,93,2,95
Oxfordshire,Cheney School,1694,298,48,346
Dorset,Chickerell Primary Academy,408,50,15,65
Manchester,Chorlton High School,1503,310,52,362
Suffolk,Elveden Church of England Primary Academy,98,26,2,28
Gloucestershire,Forest View Primary School,368,100,12,112
Surrey,Gordon's School,946,99,26,125
Warrington,Great Sankey High School,2124,139,26,165
Essex,Hedingham School and Sixth Form,1141,219,33,252
Hertfordshire,Hitchin Boys' School,1307,211,20,231
Cornwall,Launceston College,1389,156,61,217
West Northamptonshire,Magdalen College School,1432,109,12,121
Hertfordshire,Mandeville Primary School,429,68,11,79
Bedford,Mark Rutherford School,1298,188,44,232
Birmingham,Parkfield Community School,679,54,7,61
Buckinghamshire,Seer Green Church of England School,215,13,2,15
Gloucestershire,Severnbanks Primary School,261,81,20,101
Thurrock,Shaw Primary Academy,434,59,12,71
Sheffield,Silverdale School,1450,110,42,152
Haringey,St Ann's CE Primary School,212,26,7,33
Gloucestershire,St David's Church of England Primary School,269,41,9,50
Staffordshire,St Edward's Church of England Academy,723,102,14,116
Birmingham,St John's CofE Primary School,471,134,15,149
Birmingham,St Michael's Church of England Primary School,433,102,3,105
Haringey,St Michael's CofE Primary School,138,11,3,14
Haringey,St Paul's and All Hallows CofE Infant School,104,10,2,12
Haringey,St Paul's and All Hallows CofE Junior School,126,11,7,18
Lincolnshire,Stamford St Gilberts Church of England Primary School,302,17,7,24
Essex,Tabor Academy,963,203,22,225
Lincolnshire,The Boston Grammar School,848,63,6,69
Essex,The Bromfords School,1160,177,55,232
Calderdale,The Crossley Heath School,1147,11,4,15
Birmingham,The Oaklands Primary School,422,41,4,45
Sunderland,Venerable Bede Church of England Academy,892,110,14,124
Worcestershire,Walkwood Church of England Middle School,650,78,18,96
Kent,Warden House Primary School,437,25,6,31
Lincolnshire,Welton St Mary's Church of England Primary Academy,381,33,12,45
"Herefordshire, County of",Whitecross Hereford,940,150,27,177
Lincolnshire,Park Academy,369,44,9,53
Surrey,Guildford County School,1208,151,29,180
Leicestershire,St Mary's Church of England Primary School,200,35,4,39
Darlington,Skerne Park Academy,313,78,9,87
Warrington,Beamont Collegiate Academy,898,117,37,154
Hertfordshire,Links Academy,0,0,0,0
Slough,Willow Primary School,470,64,6,70
Wolverhampton,Woden Primary School,475,54,4,58
Leicestershire,St Simon and St Jude CofE Primary School,159,19,1,20
Bradford,Christ Church Church of England Academy,205,40,6,46
North Somerset,Kingshill Church School,149,20,4,24
Swindon,Hazelwood Academy,251,32,7,39
Barnsley,Outwood Academy Carlton,1094,109,77,186
Barnsley,Outwood Academy Shafton,1367,123,28,151
Bexley,Christ Church (Erith) CofE Primary School,577,55,22,77
Bexley,St Augustine of Canterbury CofE Primary School,197,27,5,32
Birmingham,Oasis Academy Hobmoor,483,80,3,83
Nottinghamshire,Tuxford Primary Academy,281,35,2,37
Nottingham,Sneinton St Stephen's CofE Primary School,241,32,0,32
Luton,Whipperley Infant Academy,260,41,7,48
Tower Hamlets,Date Palm Primary,338,3,2,5
Rotherham,Coleridge Primary,221,20,4,24
Rotherham,East Dene Primary,297,52,3,55
Stoke-on-Trent,"Star Academy, Sandyford",197,33,4,37
Stoke-on-Trent,Maple Court Academy,447,78,13,91
Bradford,Merlin Top Primary Academy,346,60,7,67
Barnsley,Queens Road Academy,213,21,6,27
Nottingham,Windmill L.E.A.D. Academy,448,79,3,82
Staffordshire,The JCB Academy,812,133,20,153
Lincolnshire,Burton Hathow Preparatory School,117,26,1,27
Westminster,Eifa International School,280,25,2,27
Haringey,Holy Trinity CofE Primary School,185,29,8,37
"Herefordshire, County of","St Mary's Primary School, Dilwyn",77,10,0,10
Birmingham,Oasis Academy Boulton,242,21,0,21
"Bristol, City of",The Kingfisher School,150,36,2,38
Essex,"The Ramsey Academy, Halstead",783,77,23,100
Essex,Messing Primary School,79,14,4,18
Kent,Chantry Community Academy,454,65,10,75
Kent,"Christ Church Church of England Junior School, Ramsgate",200,41,3,44
"Bournemouth, Christchurch and Poole",The Cornerstone Academy,600,105,26,131
Waltham Forest,Chapel End Junior Academy,284,41,18,59
Wiltshire,River Mead School,269,62,45,107
Manchester,Haveley Hey Community School,476,80,31,111
Lincolnshire,Bridge House Independent School,84,1,83,84
Southampton,Rosewood Free School,65,8,57,65
Lincolnshire,Fishtoft Academy,56,13,4,17
Birmingham,St George's Church of England Primary School,212,39,4,43
Reading,UTC Reading,489,117,11,128
Birmingham,Hawkesley Church Primary Academy,230,50,2,52
Calderdale,Mount Pellon Primary Academy,328,61,9,70
Cambridgeshire,Neale-Wade Academy,1333,183,32,215
Hampshire,Front Lawn Primary Academy,436,84,14,98
Wolverhampton,Nishkam Primary School Wolverhampton,415,40,9,49
Hillingdon,Laurel Lane Primary School,362,91,9,100
Hounslow,Kingsley Academy,881,115,31,146
North Lincolnshire,Outwood Academy Brumby,772,143,21,164
Somerset,Churchfield Church School,479,68,13,81
Wakefield,St Michael's CofE Academy,484,64,16,80
Wakefield,Sandal Magna Community Academy,261,37,7,44
Wiltshire,Oasis Academy Longmeadow,113,35,5,40
Leicestershire,Ratby Primary School,379,51,4,55
Worcestershire,St John's Church of England Middle School Academy,669,77,16,93
Leicestershire,Stonebow Primary School Loughborough,212,31,4,35
Suffolk,Westbourne Academy,1027,151,33,184
Plymouth,Widewell Primary Academy,232,31,1,32
Lancashire,Academy@Worden,545,50,8,58
Gloucestershire,Bourton-on-the-Water Primary School,290,45,1,46
Coventry,Caludon Castle School,1570,222,32,254
Waltham Forest,Connaught School for Girls,619,39,8,47
Tameside,Copley Academy,603,131,6,137
Hillingdon,Coteford Junior School,286,35,30,65
Lincolnshire,Gipsey Bridge Academy,93,20,3,23
Sheffield,Greengate Lane Academy,224,27,2,29
Oxfordshire,Harriers Banbury Academy,434,80,8,88
Plymouth,Hooe Primary Academy,212,18,4,22
Wigan,Platt Bridge Community  School,485,45,5,50
Hillingdon,St Matthew's CofE Primary School,414,46,4,50
Wiltshire,Wansdyke School,233,44,29,73
Lincolnshire,Spalding Grammar School,966,60,6,66
Walsall,Woods Bank Academy,390,72,8,80
Hillingdon,Cowley St Laurence CofE Primary School,428,39,11,50
Havering,Bower Park Academy,998,100,41,141
"Herefordshire, County of",Canon Pyon CofE Academy,73,10,2,12
Kent,"Christ Church Cep Academy, Folkestone",422,66,11,77
Kent,Folkestone St. Mary's Church of England Primary Academy,449,70,12,82
Norfolk,Hobart High School,658,75,12,87
Oxfordshire,The Iffley Academy,182,0,182,182
"Herefordshire, County of",Llangrove CE Academy,79,7,3,10
South Tyneside,Monkton Infants' School,165,23,1,24
Kent,St Eanswythe's Church of England Primary School,212,28,3,31
Lincolnshire,Greenfields Academy,78,0,78,78
Waltham Forest,Whittingham Primary Academy,402,29,11,40
Stockton-on-Tees,Conyers School,1401,173,26,199
Brent,Preston Manor School,1966,174,70,244
Bedford,Greys Education Centre,40,19,21,40
Oxfordshire,Fitzwaryn School,119,0,119,119
Somerset,St James Church School,485,60,10,70
North Northamptonshire,Kingswood Primary Academy,214,37,8,45
Nottingham,Firbeck Academy,183,23,1,24
County Durham,North East Centre for Autism - Aycliffe School,51,0,51,51
Lewisham,Rose House Montessori School,21,3,0,3
Lincolnshire,Mercer's Wood Academy,170,43,8,51
Slough,James Elliman Academy,753,77,8,85
Sheffield,Firth Park Academy,1149,131,24,155
Sheffield,Meynell Community Primary School,472,157,9,166
Gloucestershire,Dursley Church of England Primary Academy,273,62,11,73
Somerset,St John and St Francis Church School,401,74,10,84
Leicestershire,Asfordby Hill Primary School,186,27,2,29
Leicestershire,Swallowdale Primary School and Community Centre,370,44,2,46
Leicestershire,Great Dalby School,139,9,4,13
Cheshire West and Chester,"The Catholic High School, Chester",816,135,25,160
Leicestershire,Red Hill Field Primary School,278,39,8,47
South Gloucestershire,Downend School,1361,108,27,135
Sheffield,St Joseph's Primary School,224,30,3,33
Sheffield,St Patrick's Catholic Voluntary Academy,319,27,5,32
South Gloucestershire,The Castle School,1520,107,40,147
Leicestershire,St Peter and St Paul Church of England Academy,412,45,11,56
Leeds,"St Joseph's Catholic Primary School, A Voluntary Academy",327,49,2,51
Leeds,"St. Mary's Menston, a Catholic Voluntary Academy",1228,103,13,116
Leeds,"St Mary's Catholic Primary School, Horsforth",209,21,2,23
Bradford,The Sacred Heart Catholic Primary School,130,11,3,14
Leeds,"Ss. Peter and Paul Catholic Primary School, a Voluntary Academy",209,19,0,19
Leeds,"St Joseph's Catholic Primary School, Otley",200,28,0,28
Kirklees,Birstall Primary Academy,188,33,2,35
Kirklees,Fieldhead Primary Academy,177,36,3,39
Bradford,Shibden Head Primary Academy,402,43,10,53
Wakefield,Castleford Park Junior Academy,405,83,25,108
Essex,Kelvedon St Mary's Church of England Primary Academy,427,50,6,56
Lincolnshire,White's Wood Academy,203,33,8,41
Haringey,St Thomas More Catholic School,1300,173,38,211
Hammersmith and Fulham,Fulham Cross Academy,554,75,12,87
Hammersmith and Fulham,Fulham Cross Girls' School and Language College,583,96,15,111
Leicestershire,Cobden Primary School & Community Centre,374,67,7,74
Buckinghamshire,The Beaconsfield School,848,115,22,137
Halton,Wade Deacon High School,1594,107,31,138
Westminster,St George's Catholic School,1110,149,28,177
Peterborough,Fulbridge Academy,915,83,17,100
Central Bedfordshire,Toddington St George Church of England School,306,29,12,41
Bedford,Grange Academy,136,0,136,136
Dorset,The Swanage School,335,73,16,89
Cheshire West and Chester,St Martin's Academy Chester,172,37,2,39
Birmingham,Yarnfield Primary School,637,73,5,78
Cheshire West and Chester,Rudheath Primary Academy and Nursery,389,38,14,52
Thurrock,Purfleet Primary Academy,591,67,24,91
Wiltshire,Burbage Primary School,176,15,3,18
Thurrock,Benyon Primary School,406,39,15,54
Coventry,St Laurences CofE Primary School,418,69,6,75
Coventry,Stretton Church of England Academy,198,70,12,82
Somerset,Manor Court Community Primary School,382,75,14,89
Wiltshire,Pembroke Park Primary School,238,82,6,88
Somerset,Wellesley Park Primary School,342,44,10,54
Sunderland,Plains Farm Academy,190,34,1,35
Sunderland,New Penshaw Academy,150,32,2,34
Stockton-on-Tees,Hardwick Green Primary Academy,360,82,3,85
Croydon,Applegarth Academy,448,48,26,74
Devon,St Nicholas Catholic Primary School,313,51,12,63
"Kingston upon Hull, City of",The Boulevard Academy,687,131,15,146
Kent,Kemsley Primary Academy,232,32,10,42
Kent,Milton Court Primary Academy,245,40,9,49
Essex,Freshwaters Primary Academy,419,30,5,35
Essex,Roydon Primary Academy,191,7,5,12
Cambridgeshire,North Cambridge Academy,677,83,32,115
Essex,Alec Hunter Academy,1029,132,33,165
Suffolk,Ormiston Denes Academy,753,175,25,200
Manchester,Abbey Hey Primary Academy,665,100,25,125
Hartlepool,Dyke House Sports and Technology College,1309,149,8,157
Havering,Langtons Junior Academy,214,33,8,41
Cambridgeshire,Cambourne Village College,1305,108,55,163
Brighton and Hove,King's School,789,86,40,126
Barnet,St Andrew the Apostle Greek Orthodox School,703,79,10,89
Central Bedfordshire,The Academy of Central Bedfordshire,62,43,16,59
Blackburn with Darwen,The Heights Free School,0,0,0,0
Windsor and Maidenhead,Beech Lodge School,75,2,73,75
Westminster,Halcyon London International School,170,0,0,0
Hertfordshire,Elstree Screen Arts Academy,474,129,11,140
Merton,The London Acorn School,54,12,0,12
Islington,St Mary Magdalene Academy: the Courtyard,55,9,46,55
North East Lincolnshire,Willows Academy,185,23,4,27
Richmond upon Thames,St Mary's Hampton Church of England Primary,185,26,5,31
Cumbria,St Martin & St Mary Church of England Primary School,410,37,13,50
Tower Hamlets,Our Lady and St Joseph Catholic Primary School,448,119,20,139
West Northamptonshire,Thorplands Primary School,227,46,7,53
Lancashire,Prospect House,0,0,0,0
Nottingham,Berridge Primary and Nursery School,613,72,5,77
Nottingham,Seely Primary School,553,152,6,158
Calderdale,Trinity Sixth Form Academy,717,51,8,59
Buckinghamshire,Aylesbury UTC,128,52,7,59
Walsall,Birchills Church of England Community Academy,453,78,5,83
Kent,Temple Ewell Church of England Primary School,145,19,0,19
Dudley,Bramford Primary School,472,53,17,70
Manchester,The Willows Primary School,442,86,21,107
Birmingham,Tiverton Academy,206,41,1,42
Leicestershire,Mercenfeld Primary School,272,46,5,51
Leicestershire,South Charnwood High School,868,124,14,138
Birmingham,Acocks Green Primary School,488,74,2,76
Manchester,Webster Primary School,479,62,18,80
Buckinghamshire,Brill Church of England School,188,18,4,22
"Bournemouth, Christchurch and Poole",Queen's Park Infant Academy,360,69,7,76
Suffolk,St Louis Catholic Academy,320,14,2,16
Milton Keynes,Heronsgate School,381,64,4,68
Birmingham,Mere Green Primary School,438,36,9,45
"Bournemouth, Christchurch and Poole",Pokesdown Community Primary School,418,63,6,69
Isle of Wight,Northwood Primary School,201,48,6,54
Shropshire,Church Stretton School,541,79,9,88
Manchester,Saint Paul's Catholic High School,916,194,69,263
Solihull,Knowle Church of England Primary Academy,505,49,8,57
Manchester,St Anthony's Catholic Primary School,724,108,17,125
Cheshire East,Worth Primary School,213,6,3,9
North Northamptonshire,St Mary's Church of England Voluntary Aided Primary School,256,27,5,32
North Northamptonshire,Freemans Endowed Church of England Junior Academy,238,57,7,64
Essex,Highwoods Community Primary School,427,67,8,75
Birmingham,Brookvale Primary School,210,31,5,36
Cambridgeshire,Peckover Primary School,450,104,19,123
Manchester,St John Fisher and Thomas More Catholic Primary School,381,47,8,55
Warwickshire,Oak Wood Primary School,141,0,141,141
Warwickshire,Oak Wood Secondary School,170,0,170,170
Lincolnshire,The Lincoln Manor Leas Junior School,278,41,7,48
North Somerset,Birdwell Primary School,431,35,3,38
North East Lincolnshire,Old Clee Primary Academy,588,72,9,81
Central Bedfordshire,Raynsford Church of England Academy,238,19,12,31
Bradford,One In A Million Free School,378,84,7,91
Middlesbrough,Caldicotes Primary Academy,256,48,5,53
Oxfordshire,Our Lady's Roman Catholic Primary School,314,20,4,24
West Sussex,Rustington Community Primary School,618,50,9,59
Surrey,Broadmere Primary Academy,279,30,13,43
Oxfordshire,"St John Fisher Catholic Primary School, Littlemore",203,35,6,41
Rutland,Leighfield Primary School,193,21,3,24
North Yorkshire,The Woodlands Academy,134,0,134,134
"Kingston upon Hull, City of",The Compass Academy,26,19,7,26
Birmingham,Fairway Primary Academy,197,33,5,38
Suffolk,Kedington Primary Academy,211,23,3,26
Norfolk,Taverham High School,1204,133,27,160
Ealing,Brentside Primary School,433,62,15,77
Barnet,Deansbrook Junior School,290,46,10,56
Nottingham,St Patrick's Catholic Primary and Nursery School,209,17,1,18
Norfolk,Heartsease Primary Academy,482,114,9,123
Stockton-on-Tees,St Gregory's Catholic Academy,229,24,1,25
Medway,Woodlands Primary School,758,129,11,140
Bexley,Pelham Primary School,432,51,19,70
Lancashire,Moorside Community Primary Academy School,265,22,7,29
Manchester,King David Primary School,425,18,5,23
"Bournemouth, Christchurch and Poole",The Quay School,81,64,12,76
Wakefield,Larks Hill Junior and Infant School,210,14,4,18
Wakefield,The King's School,1037,98,13,111
Wakefield,Carleton High School,1025,90,26,116
Wakefield,Halfpenny Lane Junior Infant and Nursery School,459,38,4,42
Wakefield,Orchard Head Junior and Infant and Nursery School,350,46,8,54
Wakefield,The Rookeries Carleton Junior and Infant School,315,22,25,47
"Bristol, City of",Stoke Bishop Church of England Primary School,408,20,9,29
Hertfordshire,Christ Church Chorleywood CofE School,231,22,6,28
"Kingston upon Hull, City of",Biggin Hill Primary School,669,107,20,127
Hammersmith and Fulham,Ormiston Bridge Academy,35,29,6,35
Bedford,Sharnbrook Primary,234,15,2,17
"Kingston upon Hull, City of",Bude Park Primary School,233,38,6,44
"Kingston upon Hull, City of",Highlands Primary School,438,85,12,97
"Kingston upon Hull, City of",Sutton Park Primary School,348,36,5,41
Blackburn with Darwen,Wensley Fold CofE Primary Academy,421,58,13,71
Bedford,St John Rigby Catholic Primary School,328,25,5,30
Bedford,St Thomas More Catholic School,930,50,21,71
Warwickshire,St Nicholas CofE Primary,422,20,7,27
Bedford,Putnoe Primary School,514,53,6,59
Birmingham,Hill West Primary School,411,48,4,52
East Sussex,Glyne Gap School,119,3,116,119
Bedford,The Hills Academy,441,21,5,26
Bedford,Goldington Green Academy,627,89,33,122
Gloucestershire,Blockley Church of England Primary School,145,17,3,20
"Kingston upon Hull, City of",Dorchester Primary School,319,59,24,83
Birmingham,James Brindley School,138,20,118,138
Oxfordshire,"Our Lady of Lourdes Catholic Primary School, Witney",181,27,6,33
Oxfordshire,"St Joseph's Catholic Primary School, Thame",196,25,3,28
Oxfordshire,"St Thomas More Catholic Primary School, Kidlington",196,27,6,33
Darlington,St Augustine's Catholic Primary School,206,16,4,20
Oxfordshire,"St Joseph's Catholic Primary School, Carterton",100,15,0,15
Darlington,Holy Family Catholic Primary School,200,30,5,35
Essex,The Sweyne Park School,1480,178,73,251
Norfolk,Ormiston Cliff Park Primary Academy,526,65,10,75
Telford and Wrekin,The Telford Park School,659,197,21,218
Cambridgeshire,All Saints Interchurch Academy,197,31,8,39
Sunderland,St Aidan's Catholic Academy,877,111,2,113
Cheshire East,Stapeley Broad Lane CofE Primary School,218,25,4,29
Torbay,Combe Pafford School,268,0,268,268
Hammersmith and Fulham,Ormiston Courtyard Academy,7,2,5,7
Kent,Wrotham School,1029,119,16,135
Essex,Rayleigh Primary School,455,46,4,50
Sheffield,Monteney Primary School,447,98,11,109
Hertfordshire,Flamstead End School,485,33,10,43
Hammersmith and Fulham,West London Free School Primary,416,46,5,51
Bedford,St Joseph's and St Gregory's Catholic Primary School,354,38,13,51
Hampshire,Cornerstone CofE (VA) Primary School,267,27,7,34
Richmond upon Thames,Thomson House School,374,26,6,32
Hertfordshire,Chaulden Junior School,152,42,10,52
North Northamptonshire,Windmill Primary School,383,51,18,69
Devon,The Ilfracombe Church of England Academy,1097,202,32,234
Kent,Trinity School,1130,123,37,160
Cambridgeshire,The Shade Primary School,243,15,9,24
Cambridgeshire,Chesterton Primary School,191,25,6,31
Surrey,Lime Tree Primary School,441,66,22,88
Leicestershire,ALP Leicester,28,0,28,28
Wakefield,Pinderfields Hospital PRU,80,3,77,80
Bexley,Hope Community School,108,29,3,32
Barnet,Alma Primary,201,19,8,27
Sandwell,George Betts Primary Academy,411,45,10,55
Thurrock,Stanford-Le-Hope Primary School,428,56,18,74
Slough,Colnbrook Church of England Primary School,223,34,15,49
"Kingston upon Hull, City of",Ainthorpe Primary School,309,45,9,54
Norfolk,Fakenham Academy,777,85,26,111
Wakefield,St Helen's CE Primary School,229,68,7,75
Thurrock,Quarry Hill Academy,501,42,28,70
Essex,St Luke's Catholic Academy,224,28,3,31
Thurrock,The Hathaway Academy,730,93,18,111
"Kingston upon Hull, City of",Wheeler Primary School,459,90,6,96
Norfolk,Woodlands Primary Academy,463,54,7,61
Essex,St Clare's Catholic Primary School,377,17,6,23
Hartlepool,Eskdale Academy,217,49,2,51
North Northamptonshire,Grange Primary Academy,241,32,6,38
Southwark,Compass School Southwark,405,96,15,111
Liverpool,Liverpool Life Sciences UTC,556,74,5,79
Liverpool,The Studio School Liverpool,273,75,7,82
Wandsworth,Tooting Primary School,391,49,29,78
Barnet,The Archer Academy,813,119,45,164
Lincolnshire,Boston Pioneers Free School Academy,404,67,13,80
Manchester,Co-Op Academy New Islington,382,39,10,49
Enfield,Heron Hall Academy,1107,121,57,178
Westminster,The St Marylebone Church of England Bridge School,62,0,62,62
Tower Hamlets,The Complete Works,81,7,73,80
Staffordshire,Scientia Academy,460,56,9,65
Nottinghamshire,R.E.A.L Independent Schools,43,0,43,43
Plymouth,Marine Academy Primary,507,74,5,79
Thurrock,Abbots Hall Primary School,359,40,9,49
Stockton-on-Tees,All Saints Church of England Academy,869,110,9,119
"Herefordshire, County of",Barrs Court School,86,0,86,86
"Herefordshire, County of",Burghill Community Academy,95,10,0,10
Hillingdon,Charville Academy,467,57,15,72
Walsall,Edgar Stammers Primary Academy,361,46,11,57
Rutland,English Martyrs' Catholic Voluntary Academy,151,30,4,34
Luton,The Ferrars Academy,339,24,9,33
Thurrock,Graham James Primary Academy,468,80,15,95
Knowsley,Halewood Academy,1104,342,19,361
Kent,Hartley Primary Academy,443,40,7,47
Haringey,Heartlands High School,1172,115,60,175
Somerset,Horrington Primary School,103,12,1,13
Lincolnshire,Huntingtower Community Primary Academy,418,51,14,65
Southampton,Kanes Hill Primary School,393,56,16,72
Leicestershire,The Pastures Primary School,303,9,4,13
Lincolnshire,"Our Lady of Good Counsel Catholic Primary School, A Voluntary Academy",163,19,4,23
Lincolnshire,Our Lady of Lincoln Catholic Primary School A Voluntary Academy,209,35,5,40
Lincolnshire,"St Peter and St Paul, Catholic Voluntary Academy",602,115,37,152
Leicestershire,Beauchamp College,2170,87,28,115
Lincolnshire,"The Eresby School, Spilsby",85,0,85,85
Lincolnshire,St Augustine's Catholic Voluntary Academy,96,26,5,31
Lincolnshire,"St Hugh's Catholic Primary, A Voluntary Academy",270,64,2,66
"Kingston upon Hull, City of",Tweendykes School,166,0,166,166
"Kingston upon Hull, City of",Winifred Holtby Academy,1338,241,36,277
Shropshire,Woodside Primary School,647,73,13,86
Birmingham,Pegasus Primary School,198,35,1,36
Southampton,Hollybrook Junior School,240,28,5,33
Barnet,Parkfield Primary School,454,64,6,70
Cambridgeshire,The Round House Primary Academy,381,95,16,111
Birmingham,Woodhouse Primary Academy,469,76,23,99
Bromley,Gray's Farm Primary Academy,421,85,10,95
Croydon,Harris Primary Academy Kenley,434,40,3,43
Essex,Ravens Academy,351,65,6,71
Gloucestershire,Primrose Hill Church of England Primary Academy,211,22,9,31
Isle of Wight,St Blasius Shanklin CofE Primary Academy,197,51,3,54
Kensington and Chelsea,Ark Brunel Primary Academy,303,34,19,53
Leeds,Leeds City Academy,922,134,7,141
Worcestershire,Continu Plus Academy,34,31,3,34
North East Lincolnshire,Beacon Academy,579,154,36,190
West Northamptonshire,Queen Eleanor Primary Academy,225,26,6,32
Oldham,Richmond Academy,424,44,12,56
Reading,The Palmer Primary Academy,443,68,9,77
Somerset,Brymore Academy,339,128,52,180
Stockton-on-Tees,St Michael's Catholic Academy,1030,155,28,183
East Sussex,Anderida Learning Centre,9,0,9,9
North Tyneside,Kings Priory School,1516,159,24,183
Lambeth,Oasis Academy South Bank,726,100,35,135
Gloucestershire,Abbey View,0,0,0,0
Hertfordshire,The Reach Free School,734,132,26,158
Buckinghamshire,Sir Thomas Fremantle School,575,97,29,126
Kent,Wye School,573,87,22,109
Norfolk,The Pinetree School,36,2,34,36
West Sussex,Chichester Free School,1027,139,16,155
Birmingham,Reach School,4,0,4,4
Lewisham,Haberdashers' Hatcham Free School,413,29,1,30
Stockton-on-Tees,The Grangefield Academy,1012,123,22,145
West Sussex,Eastbrook Primary Academy,415,42,16,58
Blackpool,Unity Academy Blackpool,994,248,23,271
Brighton and Hove,City Academy Whitehawk,398,123,11,134
Bromley,Harris Primary Academy Kent House,396,42,4,46
Buckinghamshire,Denham Green E-ACT Primary Academy,230,43,6,49
Coventry,St Bartholomew's Church of England Academy,201,72,2,74
Coventry,Hill Farm Academy,514,96,10,106
Devon,Isca,994,178,45,223
East Sussex,Ore Village Primary Academy,335,82,2,84
Kent,Copperfield Academy,443,31,17,48
Liverpool,Liverpool College,1620,230,52,282
Wandsworth,Mosaic Jewish Primary School,225,80,8,88
Leeds,Primley Wood Primary School,289,31,3,34
West Northamptonshire,Silverstone UTC,440,53,8,61
Darlington,Marchbank Free School,48,1,47,48
"Bournemouth, Christchurch and Poole",Jewell Academy Bournemouth,391,48,11,59
Gloucestershire,Waterwells Primary Academy,388,66,7,73
South Gloucestershire,Wallscourt Farm Academy,408,55,5,60
Sheffield,UTC Sheffield City Centre,485,41,3,44
Kent,The Wells Free School,208,31,5,36
Kent,Hadlow Rural Community School,371,73,36,109
Ealing,Ark Priory Primary Academy,449,38,15,53
Leeds,Co-op Academy Nightingale,415,87,7,94
Lincolnshire,Beacon Primary Academy,209,62,11,73
Newham,Harris Academy Chobham,2041,202,51,253
Oldham,Coppice Primary Academy,554,80,19,99
Luton,Dallow Primary School,619,61,8,69
Birmingham,R.Y.A.N Education Academy,9,0,9,9
Oxfordshire,Abbey Woods Academy,162,44,7,51
Plymouth,Mayflower Academy,454,80,15,95
"Bournemouth, Christchurch and Poole",Magna Academy,946,134,28,162
Portsmouth,The Victory Primary School,435,62,41,103
Portsmouth,Ark Ayrton Primary Academy,418,42,14,56
Portsmouth,The Portsmouth Academy,1173,137,43,180
Somerset,Hamp Academy,346,109,11,120
Southwark,Ark All Saints Academy,597,119,24,143
Staffordshire,Landau Forte Academy Greenacres,367,37,9,46
Hounslow,Nishkam School West London,1211,90,28,118
Surrey,St John's Church of England Primary School,223,60,14,74
Sutton,Carew Academy,247,0,247,247
Waltham Forest,Riverley Primary School,448,31,10,41
Waltham Forest,Sybourn Primary School,561,65,26,91
Ealing,William Perkin Church of England High School,1376,31,63,94
Reading,Thames Valley School,53,0,53,53
Newcastle upon Tyne,West Newcastle Academy,198,34,3,37
Manchester,Connell Co-Op College,604,54,4,58
Birmingham,Titan St Georges Academy,0,0,0,0
Suffolk,Churchill Special Free School,69,0,69,69
Leicestershire,Woodside Lodge Outdoor Learning Centre,36,0,36,36
Tameside,All Saints Catholic College,774,73,23,96
Norfolk,Arden Grove Infant and Nursery School,210,24,3,27
Leicestershire,Battling Brook Primary School,591,110,9,119
Leicestershire,Brocks Hill Primary School,423,47,4,51
Cornwall,Caradon Alternative Provision Academy,24,19,5,24
Cornwall,Community & Hospital Education Service Ap Academy,6,4,2,6
Sandwell,Corngreaves Academy,209,36,3,39
Leicestershire,Frisby Church of England Primary School,112,6,1,7
Birmingham,Hamstead Hall Academy,1140,167,60,227
Southampton,Harefield Primary School,412,48,11,59
Barnsley,Heather Garth Primary School Academy,243,31,5,36
Worcestershire,Honeybourne Primary Academy,184,46,6,52
Oxfordshire,Ladygrove Park Primary School,437,66,16,82
Leicestershire,Launde Primary School,629,36,6,42
Cheshire East,Leighton Academy,452,70,13,83
Wiltshire,Malmesbury Church of England Primary School,418,54,11,65
Northumberland,Morpeth Road Academy,354,103,27,130
Cornwall,Nine Maidens Alternative Provision Academy,26,23,3,26
Cornwall,North Cornwall Alternative Provision Academy,25,23,2,25
Cornwall,Penwith Alternative Provision Academy,14,14,0,14
Cornwall,Restormel Alternative Provision Academy,15,7,1,8
Oxfordshire,St John's Primary School,210,36,9,45
Essex,Shenfield St. Mary's Church of England Primary School,419,33,4,37
Cheshire East,St Thomas More Catholic High School,653,58,17,75
Nottingham,The Nottingham Emmanuel School,1144,157,15,172
Telford and Wrekin,The Telford Langley School,1047,232,18,250
Leicestershire,Thringstone Primary School,162,27,6,33
Sandwell,Timbertree Academy,217,49,6,55
Shropshire,William Brookes School,936,164,27,191
Oxfordshire,Willowcroft Community School,492,106,13,119
Gloucestershire,Edward Jenner School,41,12,16,28
Leeds,Leeds Jewish Free School,137,23,3,26
Lincolnshire,Acorn Free School,3,0,2,2
Wandsworth,Rutherford House School,387,33,8,41
Bolton,The Olive Tree Primary School Bolton,418,32,7,39
Oxfordshire,Tyndale Community School,366,66,8,74
Oxfordshire,Oxford Sixth Form College,153,26,0,26
Luton,River Bank Primary School,708,140,17,157
Derby,Maple View School,15,0,15,15
Birmingham,Waverley Studio College,250,61,2,63
Walsall,Walsall Studio School,188,26,4,30
Manchester,Longsight Community Primary,213,28,3,31
Barking and Dagenham,Riverside School,1379,72,15,87
Devon,Sparkwell All Saints Primary School,97,18,2,20
East Sussex,Gildredge House,1226,157,21,178
Bedford,Kimberley 16 - 19 Stem College,636,38,2,40
"Kingston upon Hull, City of",Wansbeck Primary School,250,22,24,46
Wolverhampton,SS. Mary and John's Catholic Primary Academy,225,12,4,16
Essex,Potter Street Academy,203,54,3,57
Suffolk,Gusford Community Primary School,576,104,11,115
Suffolk,Westwood Primary School,218,64,7,71
North Northamptonshire,Rockingham Primary School,377,56,4,60
Essex,Kirby Primary Academy,207,30,5,35
Gateshead,Haskel School,15,0,15,15
Essex,Burrsville Infant Academy,180,15,1,16
Kent,Petham Primary School,103,11,0,11
Croydon,The Cedars School,263,40,1,41
Blackburn with Darwen,The Olive School Blackburn,635,48,20,68
Hackney,The Olive School Hackney,627,73,30,103
Enfield,Ark John Keats Academy,1804,135,71,206
Barnet,The Hyde School,476,53,18,71
Devon,St Michael's Church of England Primary Academy,414,58,14,72
North Northamptonshire,Weavers Academy,1284,60,19,79
Hammersmith and Fulham,Ark Swift Primary Academy,214,24,8,32
East Sussex,Ark Alexandra Academy,1557,318,7,325
Kent,Archbishop Courtenay Primary School,307,58,3,61
Middlesbrough,Outwood Academy Acklam,1159,224,34,258
Westminster,Wilberforce Primary,109,14,8,22
Worcestershire,Crabbs Cross Academy,218,45,4,49
Redbridge,Read Academy Education,226,13,0,13
North Northamptonshire,Corby Primary Academy,464,44,11,55
"Bristol, City of",Cathedral Primary School,420,43,12,55
Croydon,Harris Aspire Academy,0,0,0,0
Brent,Ark Franklin Primary Academy,658,31,8,39
Manchester,Sol Christian Academy,41,1,2,3
Camden,Abacus Belsize Primary School,153,15,4,19
"Kingston upon Hull, City of",Bellfield Primary School,246,17,6,23
Sunderland,Biddick Academy,1138,189,51,240
Warrington,Birchwood Community High School,922,139,26,165
Birmingham,Broadway Academy,1219,168,9,177
Wandsworth,Burntwood School,1651,232,33,265
Cambridgeshire,Burrowmoor Primary School,363,44,10,54
Cambridgeshire,Bury CofE Primary School,195,20,5,25
Leicestershire,Captains Close Primary School,173,17,23,40
Stoke-on-Trent,Carmountside Primary Academy,238,69,3,72
West Northamptonshire,Chipping Warden Primary Academy,80,19,1,20
"Kingston upon Hull, City of",Collingwood Primary School,340,34,13,47
Sunderland,Diamond Hall Infant Academy,379,50,8,58
"Kingston upon Hull, City of",Eastfield Primary School,618,122,19,141
Hartlepool,Eldon Grove Academy,509,53,3,56
Sunderland,Farringdon Community Academy,666,107,37,144
Wokingham,The Forest School,742,75,10,85
Leicestershire,Gilmorton Chandler Church of England Primary School,212,27,4,31
Leicestershire,Glenmere Community Primary School,212,23,2,25
Sheffield,Hinde House 2-16 Academy,1382,245,26,271
West Northamptonshire,Kings Sutton Primary Academy,130,36,2,38
Rutland,Langham CofE (Controlled) Primary School,200,16,3,19
Leicestershire,Langmoor Primary School Oadby,208,11,3,14
Birmingham,The Orchards Primary Academy,226,59,3,62
Milton Keynes,Loughton School,465,75,12,87
Sheffield,Lound Infant School,149,10,1,11
Sheffield,Lound Junior School,221,20,1,21
Leicestershire,Lubenham All Saints Church of England Primary School,70,10,1,11
West Northamptonshire,Middleton Cheney Primary Academy,346,56,2,58
Suffolk,Mildenhall College Academy,1311,149,25,174
Lincolnshire,North Thoresby Primary Academy,102,6,4,10
Hounslow,Norwood Green Junior School,398,97,15,112
Wolverhampton,Perry Hall Primary School,498,49,11,60
Essex,Powers Hall Academy,277,34,12,46
Dudley,Redhill School,1219,189,30,219
Hertfordshire,Richard Hale School,1227,167,14,181
Leicestershire,Rothley Church of England Primary School,485,17,6,23
Sandwell,Shireland Hall Primary Academy,677,61,26,87
Rotherham,St Bede's Catholic Primary School,328,89,4,93
Rotherham,St Gerard's Catholic Primary School,150,21,0,21
South Tyneside,St Joseph's Catholic Academy,1300,123,21,144
West Sussex,St Lawrence CofE Primary School,616,92,7,99
Rotherham,St Mary's Catholic Primary School,208,36,3,39
Rotherham,St Mary's Catholic Primary School (Maltby),134,16,1,17
Windsor and Maidenhead,"St Mary's Catholic Primary School, Maidenhead",309,29,10,39
Wigan,Standish St Wilfrid's Church of England Primary Academy,603,61,6,67
Hartlepool,Stranton Primary School,345,78,8,86
Lincolnshire,The Utterby Primary Academy,67,6,5,11
"Kingston upon Hull, City of",Thoresby Primary School,567,53,7,60
Devon,Uffculme Primary School,221,23,6,29
Birmingham,Washwood Heath Academy,1745,202,10,212
Hounslow,Westbrook Primary School,581,87,19,106
Surrey,New Monument Primary Academy,254,42,4,46
Wolverhampton,St Edmunds Catholic Academy,1142,159,23,182
Wolverhampton,St Michael's Catholic Primary Academy and Nursery,224,35,6,41
Wolverhampton,St Teresa's Catholic Primary Academy,168,20,2,22
Wolverhampton,SS Peter and Paul Catholic Primary Academy & Nursery,235,23,7,30
Norfolk,Sir Isaac Newton Sixth Form Free School,484,13,6,19
Westminster,Pimlico Primary,358,32,15,47
Wokingham,Windmill Primary School,193,19,12,31
Wokingham,Wheatfield Primary School,211,25,2,27
Southend-on-Sea,Southend YMCA Community School,15,1,14,15
Birmingham,Grestone Academy,419,86,3,89
Croydon,Harris Primary Academy Benson,199,29,5,34
Southwark,Judith Kerr Primary School,382,21,3,24
Hillingdon,Hewens Primary School,431,19,5,24
Cheshire East,Cranberry Academy,430,36,8,44
Coventry,Kingsbury Academy,101,0,101,101
Kirklees,Windmill CofE (VC) Primary School,414,68,17,85
Warwickshire,Arley Primary School,204,48,2,50
Surrey,Marden Lodge Primary School and Nursery,234,43,4,47
Surrey,Warlingham Village Primary School,210,23,12,35
Essex,"St Teresa's Catholic Primary School, Basildon",234,25,10,35
Sandwell,Wodensborough Ormiston Academy,1149,246,66,312
Hampshire,The Holme Church of England Primary School,183,33,3,36
"Kingston upon Hull, City of",Mersey Primary Academy,217,21,8,29
"Kingston upon Hull, City of",The Parks Primary Academy,349,45,11,56
Blackburn with Darwen,Darwen Aldridge Enterprise Studio,266,56,5,61
Harrow,The Jubilee Academy,0,0,0,0
Hillingdon,Nanaksar Primary School,107,3,1,4
Medway,Kingfisher Community Primary School,219,39,2,41
Medway,Saxon Way Primary School,425,45,3,48
Norfolk,Norwich Primary Academy,315,53,12,65
Peterborough,Highlees Primary School,376,60,15,75
Redcar and Cleveland,Dormanstown Primary Academy,262,32,29,61
Sheffield,E-ACT Pathways Academy,410,121,14,135
Somerset,Cheddon Fitzpaine Church School,137,8,7,15
South Gloucestershire,Charfield Primary School,207,12,3,15
Warwickshire,Nicholas Chamberlaine School,1320,147,17,164
Warwickshire,The Queen Elizabeth Academy,701,125,21,146
Westminster,Churchill Gardens Primary Academy,188,45,20,65
Nottinghamshire,Skegby Junior Academy,155,27,0,27
Slough,Foxborough Primary School,230,60,3,63
Hampshire,Frogmore Junior School,221,37,9,46
Somerset,Hayesdown First School,298,27,4,31
Southampton,Hightown Primary School,180,32,5,37
Surrey,Jubilee High School,652,99,28,127
Essex,Purford Green Primary School,204,37,6,43
Surrey,Pyrcroft Grange Primary School,248,21,24,45
North East Lincolnshire,Reynolds Primary Academy,423,46,4,50
Cheshire East,Sir William Stanier Community School,736,98,37,135
Plymouth,St George's CofE Primary Academy,96,26,2,28
Cornwall,St Newlyn East Learning Academy,162,19,0,19
Nottinghamshire,The Holgate Academy,1161,265,8,273
North Northamptonshire,Kingswood Secondary Academy,1240,175,24,199
West Sussex,The Mill Primary Academy,543,70,8,78
Stockton-on-Tees,The Oak Tree Academy,259,69,6,75
Cornwall,Truro Learning Academy,200,22,6,28
North Northamptonshire,Wrenn School,1365,186,12,198
Birmingham,Aspire Ap School,7,0,2,2
West Berkshire,Engaging Potential,12,0,12,12
Sutton,Harris Junior Academy Carshalton,357,46,7,53
Bromley,Harris Primary Academy Crystal Palace,379,33,2,35
Portsmouth,Cliffdale Primary Academy,215,33,182,215
"Kingston upon Hull, City of",Wold Academy,466,102,6,108
Windsor and Maidenhead,Holyport College,576,82,23,105
Reading,The Heights Primary School,350,46,6,52
Islington,Dania Scandinavian School,23,0,0,0
Stockton-on-Tees,Abbey Hill Academy,359,0,359,359
Bradford,Beckfoot School,1632,357,51,408
Hartlepool,Catcote Academy,202,0,202,202
Bradford,Hazelbeck Special School,155,0,155,155
Bradford,Co-op Academy Southfield,310,0,310,310
Wiltshire,Dauntsey Academy Primary School,195,20,6,26
North East Lincolnshire,Eastfield Primary Academy,230,24,3,27
Leicester,Humberstone Junior School,352,41,5,46
Bromley,Parish Church of England Primary School,606,81,17,98
Oxfordshire,Pegasus School,476,88,9,97
Sheffield,Porter Croft Church of England Primary Academy,211,32,3,35
Gloucestershire,Stone with Woodford Church of England Primary School,103,18,2,20
North Northamptonshire,The Ferrers School,914,21,19,40
Hounslow,The Green School for Girls,923,96,9,105
Bedford,Ursula Taylor Church of England School,352,36,11,47
Thurrock,West Thurrock Academy,442,77,15,92
Rotherham,Wingfield Academy,987,175,18,193
Surrey,Woking High School,1199,154,49,203
Birmingham,Yardleys School,942,147,11,158
Bradford,Oasis Academy Lister Park,881,152,33,185
Oxfordshire,Carfax College,13,0,11,11
Bury,Radcliffe Primary School,256,64,9,73
Knowsley,Kirkby High School,949,224,33,257
Northumberland,The Blyth Academy,782,101,20,121
Wakefield,West End Academy,210,19,5,24
Warwickshire,Park Lane Primary School,477,57,6,63
"Bournemouth, Christchurch and Poole",Winton Academy,929,188,19,207
"Bournemouth, Christchurch and Poole",Glenmoor Academy,895,110,14,124
Kent,Cliftonville Primary School,828,116,24,140
Thurrock,Ortu Corringham Primary School and Nursery,500,49,36,85
Birmingham,Ark Boulton Academy,910,133,8,141
Norfolk,Ormiston Herman Academy,384,46,13,59
Nottingham,Highbank Primary and Nursery School,301,28,3,31
North Yorkshire,Thomas Hinderwell Primary Academy,197,50,7,57
Essex,Little Parndon Primary Academy,408,25,10,35
Cornwall,Looe Primary Academy,257,37,7,44
Blackpool,South Shore Academy,779,222,34,256
Havering,Oasis Academy Pinewood,366,36,14,50
Wakefield,De Lacy Primary School,321,55,6,61
Essex,Cooks Spinney Primary Academy and Nursery,461,32,10,42
Sheffield,"St John Fisher Primary, A Catholic Voluntary Academy",214,27,7,34
Surrey,St Mary's Church of England Primary School,222,20,3,23
Cornwall,St Michael's Church of England Primary School,363,46,6,52
Surrey,St Paul's CofE Primary School,410,124,13,137
North Northamptonshire,St Peter's Church of England Academy,223,13,1,14
Peterborough,Stanground St Johns CofE Primary School,205,21,5,26
Suffolk,Stoke High School - Ormiston Academy,742,105,21,126
Norfolk,Clover Hill VA Infant and Nursery School,183,29,5,34
Surrey,The Echelford Primary School,624,50,15,65
Salford,Ahavas Torah Boys Academy,74,3,0,3
Hertfordshire,The Thomas Alleyne Academy,973,176,31,207
Bexley,Break Through School,41,13,25,38
Medway,Oasis Academy Skinner Street,410,59,8,67
Worcestershire,Oasis Academy Warndon,594,116,16,132
Peterborough,Welland Academy,409,64,6,70
Suffolk,Westfield Primary Academy,404,100,12,112
Croydon,Tudor Academy,541,70,10,80
Hampshire,Clay Hill School,54,0,54,54
Suffolk,Set Ixworth School,482,109,48,157
West Sussex,Downview Primary School,616,97,5,102
Hertfordshire,Westfield Academy,1319,171,23,194
Westminster,Gateway Academy,605,87,26,113
North Northamptonshire,Havelock Infant School,246,27,2,29
Manchester,Oasis Academy Aspinal,221,47,2,49
Wigan,Bedford Hall Methodist Primary School,241,17,6,23
North Northamptonshire,Havelock Junior School,338,63,10,73
Rochdale,Wardle Academy,1296,131,51,182
West Northamptonshire,Boddington Church of England Voluntary School,52,2,2,4
Surrey,Boxgrove Primary School,645,114,12,126
West Northamptonshire,Chacombe CEVA Primary Academy,90,23,1,24
North Northamptonshire,Loatlands Primary School,444,59,15,74
West Northamptonshire,Newnham Primary School,74,7,0,7
North Northamptonshire,Rothwell Victoria Infant School,302,22,3,25
Somerset,St Andrew's Church School,232,23,9,32
Tower Hamlets,Culloden Primary - A Paradigm Academy,684,23,52,75
West Northamptonshire,Culworth Church of England Primary Academy,114,6,1,7
Hounslow,Kew House,596,259,5,264
"Bournemouth, Christchurch and Poole",Longspee Academy,108,0,108,108
Leeds,East Garforth Primary Academy,246,23,1,24
Hampshire,Fareham Academy,853,147,59,206
Derbyshire,English Martyrs' Catholic Voluntary Academy,267,46,1,47
Nottinghamshire,Fairfield Spencer Academy,655,76,8,84
Stockton-on-Tees,Frederick Nattrass Primary Academy,230,29,5,34
North Northamptonshire,Rothwell Junior School,357,49,8,57
North Northamptonshire,Rushton Primary School,99,10,3,13
Central Bedfordshire,Gravenhurst Academy,52,10,2,12
Bradford,Harden Primary School,210,33,5,38
North Yorkshire,Springwell Harrogate,14,12,2,14
Devon,The Duchy School Bradninch,196,31,6,37
Bath and North East Somerset,Three Ways School,230,1,229,230
Bromley,Alexandra Junior School,233,33,7,40
Newcastle upon Tyne,St Mary's Catholic School,1434,128,22,150
Bromley,Highfield Infants' School,267,3,1,4
Cheshire East,Holmes Chapel Primary School,419,27,15,42
Surrey,The Horsell Village School,268,22,3,25
Wakefield,Outwood Primary Academy Lofthouse Gate,462,21,12,33
Wigan,Leigh Westleigh Methodist Primary School,220,44,5,49
Bromley,Raglan Primary School,432,40,38,78
West Sussex,River Beach Primary School,676,98,22,120
Surrey,The Oaktree School,262,34,9,43
Rochdale,Hollingworth Academy,1341,149,47,196
Torbay,Torre Church of England Academy,333,42,10,52
Cheshire West and Chester,Cloughwood Academy,120,0,120,120
North Northamptonshire,Wilbarston Church of England Primary School,86,8,1,9
Leicestershire,Old Dalby Church of England Primary School,143,20,1,21
Tower Hamlets,Old Ford Primary - A Paradigm Academy,666,21,15,36
Cheshire West and Chester,Over Hall Community School,184,35,8,43
Hampshire,Milford-on-Sea Church of England Primary School,319,23,9,32
Oldham,Roundthorn Primary Academy,245,32,8,40
Leicestershire,Sileby Redlands Community Primary School,383,43,4,47
West Northamptonshire,"St Loys Church of England Primary Academy, Weedon Lois",50,12,2,14
Leicestershire,Hastings High School,845,88,15,103
Plymouth,Eggbuckland Community College,1059,141,28,169
West Sussex,Chichester High School,1353,284,21,305
Calderdale,Wainstalls School,203,26,0,26
Cheshire East,Alsager School,1568,73,39,112
Rotherham,Canklow Woods Primary School,253,38,2,40
Wakefield,Darrington Church of England Primary School,126,14,2,16
Bradford,Iqra Academy,669,111,7,118
Wiltshire,Morgan's Vale and Woodfalls Church of England Primary School,102,17,4,21
Croydon,Forest Academy,198,27,2,29
Stoke-on-Trent,St Marys Catholic Academy,238,29,5,34
Rotherham,Whiston Junior and Infant School,206,24,3,27
Rotherham,Whiston Worrygoose Junior and Infant School,239,27,5,32
Surrey,Tomlinscote School,1502,144,33,177
East Riding of Yorkshire,Dunswell Primary School,93,5,5,10
North Northamptonshire,Oakley Vale Primary School,417,45,5,50
Suffolk,Horizon School,17,15,2,17
Harrow,Alexandra School,80,0,80,80
Staffordshire,Alleyne's Academy,903,85,16,101
Blackpool,Anchorsholme Primary Academy,613,68,3,71
Warwickshire,Austrey CofE Primary School,90,21,4,25
Dudley,Bishop Milner Catholic College,861,98,24,122
Warwickshire,Cawston Grange Primary School,437,57,15,72
Blackpool,Devonshire Primary Academy,450,119,8,127
Staffordshire,Our Lady of Grace Catholic Academy,118,18,3,21
Manchester,Green End Primary School,483,41,21,62
Tameside,Hawthorns School,196,1,195,196
Warwickshire,Henley-In-Arden CofE Primary School,136,19,11,30
Sandwell,Jubilee Park Academy,213,26,7,33
Manchester,Ladybarn Primary School,486,52,16,68
Southwark,Newlands Academy,67,2,65,67
Warwickshire,Newton Regis CofE Primary School,96,10,0,10
Sandwell,Ocker Hill Academy,254,34,19,53
Stoke-on-Trent,Our Lady and St Benedict Catholic Academy,214,34,4,38
Trafford,Park Road Sale Primary School,466,25,5,30
Blackpool,Park Community Academy,322,0,322,322
Dudley,St Chad's Catholic Primary School,234,28,3,31
Stoke-on-Trent,St George and St Martin's Catholic Academy,220,42,9,51
Staffordshire,St John the Evangelist Catholic Primary,189,42,6,48
Dudley,St Joseph's Catholic Primary School,249,22,8,30
Stoke-on-Trent,"St Joseph's Catholic Academy, Goldenhill",235,36,5,41
Stoke-on-Trent,St Margaret Ward Catholic Academy,1157,129,25,154
Stoke-on-Trent,St Peter's Catholic Academy,237,44,4,48
Stoke-on-Trent,St Wilfrid's Catholic Primary School,335,48,4,52
Warwickshire,Warton Nethersole's CofE Primary School,142,19,4,23
Warwickshire,Woodside CofE Primary School,210,28,4,32
Staffordshire,Madeley High School,704,43,20,63
Hounslow,Oriel Academy West London,412,70,12,82
Birmingham,Chivenor Primary School,337,76,5,81
Wolverhampton,Thomas Telford University Technical College,704,90,5,95
Birmingham,Oasis Academy Foundry,219,39,1,40
Kent,Tymberwood Academy,384,76,18,94
Kent,Valley Invicta Primary School At Aylesford,381,53,4,57
"Kingston upon Hull, City of",Craven Primary Academy,228,28,2,30
Rotherham,Wath Victoria Primary School,318,71,19,90
Calderdale,Abbey Park Academy,218,33,2,35
Cambridgeshire,Ramnoth Junior School,326,33,18,51
Cambridgeshire,The Nene Infant & Nursery School,242,33,10,43
Cheshire East,St Michael's Community Academy,467,58,10,68
East Sussex,West St Leonards Primary Academy,380,78,14,92
Essex,Southminster Church of England Primary School,270,39,4,43
Essex,Weeley St Andrew's CofE Primary School,196,35,3,38
Hampshire,Oakmoor School,830,104,31,135
"Herefordshire, County of",St Thomas Cantilupe CofE Academy,221,30,3,33
"Kingston upon Hull, City of",Endike Academy,430,68,9,77
Lincolnshire,The Wainfleet Magdalen Church of England/Methodist School,183,41,5,46
Medway,Lordswood School,410,52,9,61
Norfolk,Hethersett Academy,1108,136,23,159
Norfolk,Moorlands CofE Primary Academy,303,37,6,43
West Northamptonshire,Abbey CofE Academy,160,18,1,19
North Northamptonshire,Greenfields Primary School and Nursery,456,76,6,82
North Northamptonshire,Victoria Primary Academy,415,45,16,61
Staffordshire,Churchfields Primary School,401,65,12,77
Walsall,Rivers Primary Academy,439,63,6,69
Waltham Forest,Joseph Clarke School,102,1,101,102
Warwickshire,Racemeadow Primary Academy,350,62,9,71
West Sussex,Ormiston Six Villages Academy,654,113,9,122
Blackpool,Langdale Free School,97,26,3,29
Hammersmith and Fulham,Westside School,20,0,20,20
Surrey,Peaslake Free School,40,0,1,1
Bradford,Bradford Girls' Grammar School,1031,93,17,110
Bury,Cambian Chesham House School,12,1,11,12
South Gloucestershire,Immanuel Christian School,42,8,1,9
Buckinghamshire,Lace Hill Academy,226,23,5,28
Croydon,Harris Primary Academy Haling Park,365,46,7,53
Croydon,Oasis Academy Arena,471,80,17,97
Hackney,Mossbourne Victoria Park Academy,836,114,35,149
Hampshire,Berewood Primary School,422,59,23,82
Kensington and Chelsea,Kensington Aldridge Academy,1281,179,73,252
Kensington and Chelsea,Kensington Primary Academy,232,31,12,43
Lincolnshire,Bourne Elsea Park Church of England Primary Academy,272,17,9,26
Medway,New Horizons Children's Academy,639,74,6,80
North Somerset,Haywood Village Academy,452,44,12,56
Oxfordshire,"Endeavour Academy, Oxford",32,0,32,32
Sheffield,Oasis Academy Fir Vale,446,131,3,134
Sheffield,Oasis Academy Watermead,426,57,6,63
Somerset,Willowdown Primary School,306,17,11,28
Southwark,South Bank University Academy,654,55,15,70
Wandsworth,Oasis Academy Putney,184,24,3,27
Wiltshire,Castle Mead School,379,72,46,118
Wiltshire,Wellington Lions Primary Academy,272,41,9,50
Shropshire,Bridge School,0,0,0,0
Central Bedfordshire,Clifton All Saints Academy,180,25,8,33
"Kingston upon Hull, City of",Appleton Primary School,263,39,7,46
Leicestershire,Barrow Hall Orchard Church of England Primary School,539,62,8,70
Nottingham,Blue Bell Hill Primary and Nursery School,452,40,8,48
Cornwall,Braddock CofE Primary School,98,5,2,7
Kirklees,Boothroyd Primary Academy,600,64,11,75
"Kingston upon Hull, City of",Bricknell Primary School,651,31,28,59
Barnet,Broadfields Primary School,711,70,76,146
Oxfordshire,Charlton Primary School,462,48,7,55
Hertfordshire,Countess Anne Church of England School,211,29,4,33
Nottingham,The Glapton Academy,370,47,2,49
Barnsley,Hoyland Common Primary School,426,40,10,50
Bexley,Hurst Primary School,656,76,11,87
Slough,Littledown School,31,0,31,31
"Kingston upon Hull, City of",Longhill Primary School,383,28,10,38
"Kingston upon Hull, City of",Maybury Primary School,235,39,10,49
"Kingston upon Hull, City of",Neasden Primary School,287,21,11,32
Coventry,President Kennedy School Academy,1781,279,41,320
Hertfordshire,Ralph Sadleir School,348,45,8,53
Surrey,Saxon Primary School,411,28,14,42
Leicestershire,Stanton Under Bardon Community Primary School,108,13,0,13
Milton Keynes,Bridge Academy,26,2,19,21
Leicestershire,Thornton Primary School,126,10,4,14
Oxfordshire,Wantage Church of England Primary School,431,51,13,64
Surrey,Connaught Junior School,439,61,7,68
Bromley,Highfield Junior School,366,19,8,27
Worcestershire,Astwood Bank Primary School,410,32,4,36
South Gloucestershire,Stoke Lodge Primary School,318,40,8,48
Sutton,Cheam Park Farm Primary Academy,923,64,19,83
Worcestershire,Regency High School,246,0,246,246
Birmingham,Robin Hood Academy,610,85,9,94
Southampton,Beechwood Junior School,357,47,9,56
Swindon,Moredon Primary School,419,78,13,91
Cambridgeshire,Cambridge Academy for Science and Technology,433,117,1,118
"Bristol, City of",Redfield Educate Together Primary Academy,376,68,11,79
"Bristol, City of",Oasis Academy Marksbury Road,394,75,6,81
"Bristol, City of",Fairlawn Primary School,266,42,4,46
Stockton-on-Tees,King Edwin School,90,0,90,90
Walsall,Chase House School,8,4,4,8
"Kingston upon Hull, City of",Kingswood Parks Primary School,679,50,12,62
Central Bedfordshire,Beecroft Academy,419,80,20,100
North Northamptonshire,Friars Academy,148,3,145,148
Oxfordshire,Buckland Church of England Primary School,116,11,2,13
Oxfordshire,Cholsey Primary School,304,34,4,38
Stoke-on-Trent,Co Op Academy Glebe,239,65,6,71
Central Bedfordshire,Gothic Mede Academy,312,47,14,61
Nottinghamshire,Hillside Primary and Nursery School,468,31,3,34
Oxfordshire,Longcot and Fernham Church of England Primary School,144,10,1,11
Swindon,Millbrook Primary School,325,43,17,60
Stoke-on-Trent,Newstead Primary Academy,418,41,5,46
Central Bedfordshire,Oak Bank School,128,0,128,128
Stoke-on-Trent,Our Lady's Catholic Academy,222,27,4,31
Swindon,Peatmoor Community Primary School,203,21,0,21
"Kingston upon Hull, City of",Priory Primary School,433,74,14,88
Swindon,Shaw Ridge Primary School,431,29,7,36
Worcestershire,South Bromsgrove High,1334,107,13,120
Oxfordshire,Shrivenham Church of England Controlled School,201,37,9,46
Hertfordshire,Simon Balle All-Through School,1597,147,50,197
Redbridge,St Aidan's Catholic Primary Academy,306,16,4,20
Stoke-on-Trent,St Augustine's Catholic Academy,202,30,3,33
Stoke-on-Trent,St Gregory's Catholic Academy,470,48,3,51
Stoke-on-Trent,St Maria Goretti Catholic Academy,227,37,4,41
Stoke-on-Trent,St Matthews Church of England Academy,82,2,4,6
Oxfordshire,Watchfield Primary School,371,53,10,63
Swindon,Westlea Primary School,297,58,25,83
Nottingham,Hogarth Academy,228,17,1,18
Stoke-on-Trent,St Thomas More Catholic Academy,1146,194,26,220
Somerset,Preston CofE Primary School,422,27,5,32
Cumbria,Penny Bridge CofE School,101,11,0,11
Oxfordshire,John Blandy Primary School,261,43,9,52
Essex,The Cornelius Vermuyden School,816,107,18,125
Worcestershire,Matchborough First School Academy,383,74,7,81
Sheffield,Hillsborough Primary School,384,74,3,77
East Sussex,Dudley Infant Academy,178,18,1,19
Wakefield,Glasshoughton Infant Academy,232,12,11,23
Manchester,Beaver Road Primary School,970,86,24,110
Leicestershire,Kirby Muxloe Primary School,399,43,5,48
Leicestershire,Enderby Danemill Primary School,367,51,13,64
Leicestershire,Croxton Kerrial Church of England Primary School,58,7,1,8
Cornwall,Summercourt Academy,113,28,1,29
Redcar and Cleveland,Skelton Primary School,516,87,3,90
Bexley,Barnehurst Infant School,230,11,4,15
Bexley,Barnehurst Junior School,240,30,2,32
Kent,Furley Park Primary Academy,575,56,9,65
Kent,Hamstreet Primary Academy,269,36,7,43
County Durham,Cleves Cross Primary and Nursery School Academy,249,49,5,54
Portsmouth,Mary Rose Academy,184,15,169,184
Calderdale,The Halifax Academy,1445,162,33,195
West Northamptonshire,Green Oaks Primary Academy,228,61,7,68
Cornwall,Falmouth Primary Academy,287,85,2,87
Lincolnshire,Castle Wood Academy,283,33,9,42
Stoke-on-Trent,Kinetic Academy,25,1,24,25
Cornwall,Foxhole Learning Academy,96,12,2,14
Wakefield,England Lane Academy,209,28,4,32
Cornwall,Millbrook CofE Primary School,104,14,1,15
Slough,Montem Academy,909,87,19,106
Wakefield,Carleton Park Junior and Infant School,205,18,6,24
Surrey,St John's Primary School,228,28,2,30
Doncaster,"St Joseph's School, a Catholic Voluntary Academy",249,49,2,51
Sheffield,St Mary's Church of England Primary School,219,20,0,20
Cornwall,"St Nicolas' CofE VA School, Downderry",109,9,1,10
North Lincolnshire,Ulceby St Nicholas Church of England Primary School,124,17,0,17
Oxfordshire,Wheatley Church of England Primary School,295,32,5,37
Cornwall,St Martin's CofE Primary School,272,33,8,41
Surrey,Kenyngton Manor Primary School,464,80,15,95
Surrey,Cordwalles Junior School,216,40,12,52
Surrey,Springfield Primary School,431,84,14,98
Wiltshire,Whitesheet Church of England Primary Academy,36,9,2,11
Wiltshire,Southbroom St James Academy,158,52,6,58
Doncaster,Carr Lodge Academy,458,47,8,55
Warwickshire,Avon Park School,84,3,81,84
Wolverhampton,St Jude's Church of England Primary Academy,479,25,8,33
Croydon,The Laurels School,111,23,1,24
Nottinghamshire,Arnbrook Primary School,164,20,0,20
Bradford,Dixons Marchbank Primary,490,48,12,60
County Durham,Browney Primary Academy,178,32,3,35
Hounslow,The Rise Free School,136,1,135,136
West Northamptonshire,Castle Academy,449,37,11,48
Norfolk,Nelson Academy,415,51,24,75
Norfolk,Cliff Park Ormiston Academy,844,165,28,193
Coventry,Ernesford Grange Community Academy,1058,220,22,242
Essex,Great Clacton Church of England Junior School,286,77,4,81
Buckinghamshire,George Grenville Academy,200,38,5,43
Nottingham,Bluecoat Beechdale Academy,900,246,25,271
West Northamptonshire,Hardingstone Academy,229,22,5,27
Warwickshire,Harris Church of England Academy,825,160,26,186
Warwickshire,Henry Hinde Junior School,262,27,4,31
Newham,Langdon Academy,2062,179,77,256
Peterborough,Ormiston Meadows Academy,199,35,11,46
Essex,Meadgate Primary School,210,46,6,52
Peterborough,Newark Hill Academy,447,48,8,56
Rotherham,Eastwood Village Primary School,185,32,0,32
Reading,Civitas Academy,404,63,4,67
Essex,Pemberley Academy,209,12,6,18
Staffordshire,Veritas Primary Academy,451,55,15,70
East Sussex,Burfield Academy,210,31,5,36
East Sussex,High Cliff Academy,232,61,1,62
Cambridgeshire,Kimbolton Primary Academy,91,13,1,14
Hillingdon,John Locke Academy,621,55,10,65
Oldham,Hollinwood Academy,287,15,272,287
Coventry,Radford Primary Academy,231,26,7,33
Hillingdon,Lake Farm Park Academy,710,85,33,118
Kirklees,Diamond Wood Community Academy,393,43,12,55
Kent,Thistle Hill Academy,359,52,21,73
Sheffield,Oasis Academy Don Valley,1095,128,14,142
Croydon,Harris Primary Academy Purley Way,438,34,11,45
Essex,Braiswick Primary School,426,33,6,39
Worcestershire,Riversides School,70,0,70,70
Nottinghamshire,The Flying High Academy,438,28,5,33
Leeds,"Holy Trinity Church of England Academy, Rothwell",168,31,0,31
Staffordshire,Silverdale Primary Academy,160,21,5,26
Staffordshire,Springhill Primary Academy,193,18,4,22
Worcestershire,Kingfisher School,135,12,123,135
Waltham Forest,Thomas Gamuel Primary School,371,45,17,62
West Berkshire,Whitelands Park Primary School,398,47,7,54
Somerset,Woolavington Village Primary School,158,29,4,33
"Bristol, City of",Oasis Academy Long Cross,500,79,44,123
East Sussex,Pebsham Primary Academy,203,30,0,30
Knowsley,Lord Derby Academy,1072,126,37,163
Leeds,Hillcrest Academy,459,75,3,78
West Northamptonshire,Kings Heath Primary Academy,351,63,10,73
Sheffield,Outwood Academy City,1133,221,14,235
Somerset,Court Fields School,751,92,25,117
Stockport,St Matthew's Church of England Primary School,210,36,14,50
Warwickshire,Wood End Primary School,158,32,2,34
Warwickshire,Queen's Church of England Academy,351,61,9,70
Swindon,Tadpole Farm CofE Primary Academy,469,50,17,67
Wandsworth,Floreat Wandsworth Primary School,324,25,7,32
West Sussex,Bohunt School Worthing,922,136,34,170
Plymouth,St Matthew's Church of England Primary and Nursery Academy,477,57,6,63
Hackney,Mossbourne Riverside Academy,540,46,10,56
Tameside,Inspire Academy,441,67,12,79
Tameside,Discovery Academy,212,76,5,81
Bradford,Bradford Forster Academy,983,133,30,163
Kent,Valley Invicta Primary School At Leybourne Chase,227,19,18,37
Kent,Valley Invicta Primary School at Holborough Lakes,228,21,21,42
Kent,Valley Invicta Primary School At Kings Hill,222,17,19,36
Kent,Martello Primary,172,31,24,55
Croydon,Chestnut Park Primary School,596,70,16,86
Croydon,Heathfield Academy,353,26,7,33
West Northamptonshire,Billing Brook Special School,257,0,257,257
"Kingston upon Hull, City of",Cleeve Primary School,433,52,10,62
Cheshire East,Parkroyal Community School,417,17,14,31
Sheffield,"Sacred Heart School, A Catholic Voluntary Academy",199,19,2,21
Sheffield,"St Mary's Primary School, A Catholic Voluntary Academy",174,22,1,23
Sheffield,"St Ann's Catholic Primary School, A Voluntary Academy",96,16,2,18
Stockton-on-Tees,St Bede's Catholic Academy,218,22,1,23
Bexley,Bursted Wood Primary School,616,83,4,87
Cheshire East,Ash Grove Academy,236,41,13,54
Lincolnshire,The Kirkby-la-Thorpe Church of England Primary School,118,27,4,31
Essex,Woodville Primary School,416,29,8,37
Bromley,Perry Hall Primary School,436,46,11,57
Bromley,Farnborough Primary School,247,50,8,58
Bromley,Manor Oak Primary School,191,50,3,53
Bromley,Alexandra Infant School,188,34,16,50
Bath and North East Somerset,St John's CofE Primary School,399,48,13,61
Wakefield,St Giles C of E Academy,340,66,16,82
Wiltshire,Christian Malford CofE Primary School,67,9,1,10
Somerset,Huish Primary School,421,23,13,36
Somerset,Horsington Church School,83,11,0,11
Cheshire East,Adelaide School,93,0,93,93
Wirral,Our Lady of Pity Catholic Primary School,404,46,4,50
Rotherham,Oakwood High School,1064,167,4,171
Barnsley,West Meadows Primary School,232,24,4,28
Solihull,Bentley Heath Church of England Primary School,400,50,5,55
Birmingham,Holy Trinity CE Primary Academy (Handsworth),180,19,2,21
"Herefordshire, County of",Mordiford CofE Primary School,155,17,2,19
Cornwall,Bishop Bronescombe CofE School,306,62,8,70
Cornwall,Grampound Road Village CofE School,106,20,2,22
Cornwall,Ladock C of E School,108,14,1,15
Cornwall,Veryan CofE School,43,6,2,8
Staffordshire,Chesterton Community Sports College,883,217,19,236
York,Robert Wilkinson Primary Academy,562,38,15,53
West Sussex,"Bishop Luffa School, Chichester",1552,194,26,220
Oxfordshire,The Hendreds Church of England School,139,12,2,14
Oxfordshire,Grove Church of England School,191,35,9,44
Redbridge,Loxford School,2791,597,77,674
Leicestershire,Robert Bakewell Primary School,283,52,8,60
Cornwall,Quethiock CofE School,81,11,0,11
Southampton,Townhill Infant School,155,37,5,42
Sheffield,Seraphic Academy,91,0,0,0
Manchester,Manchester Communication Primary Academy,461,75,9,84
Cambridgeshire,Isle of Ely Primary School,449,26,10,36
Hillingdon,St Martin's Church of England Primary School,317,90,27,117
Bury,Woodlands,5,2,3,5
Staffordshire,Norton Canes Primary Academy,215,36,5,41
Staffordshire,Heath Hayes Primary Academy,200,29,9,38
Salford,Kerem Shloime,221,33,0,33
Barnet,Beis Medrash Elyon,96,0,0,0
East Sussex,The Baird Primary Academy,349,121,3,124
Windsor and Maidenhead,Braywick Court School,244,20,9,29
Islington,Whitehall Park School,266,49,8,57
Merton,Jus'T'Learn,39,6,13,19
Lincolnshire,Wygate Park Academy,274,31,10,41
Cambridgeshire,Park Lane Primary & Nursery School,461,21,20,41
Bolton,Smithills School,1104,136,19,155
Cheshire East,The Quinta Primary School,467,80,15,95
Birmingham,Leigh Primary School,441,67,3,70
Middlesbrough,Sunnyside Academy,295,56,43,99
Middlesbrough,Rose Wood Academy,364,51,9,60
Middlesbrough,Viewley Hill Academy,304,54,6,60
Essex,Rolph Church of England Primary School and Nursery,216,19,2,21
Southwark,John Donne Primary School,406,53,13,66
Surrey,Beaufort Primary School,477,51,29,80
Surrey,Sythwood Primary and Nursery School,602,135,19,154
West Northamptonshire,Northampton School for Girls,1766,238,21,259
Gloucestershire,Mitton Manor Primary School,209,14,4,18
Cornwall,Landulph School,74,10,3,13
Cornwall,St Stephens Community Academy,219,32,15,47
Cornwall,Windmill Hill Academy,178,13,6,19
Swindon,Nova Hreod Academy,985,140,11,151
Southampton,Glenfield Infant School,261,37,6,43
Croydon,Atwood Primary School,457,58,13,71
Birmingham,Twickenham Primary School,454,84,0,84
Stockton-on-Tees,Norton Primary Academy,352,49,8,57
Kent,"St Joseph's Catholic Primary School, Aylesham",131,19,2,21
Kent,South Avenue Primary School,407,114,11,125
Staffordshire,Lark Hall Infant & Nursery Academy,87,5,1,6
Staffordshire,Flax Hill Junior Academy,308,32,0,32
Birmingham,Bishop Walsh Catholic School,1030,67,14,81
Birmingham,Holy Cross Catholic Primary School,211,22,4,26
"Herefordshire, County of",Marden Primary Academy,90,11,4,15
"Bournemouth, Christchurch and Poole",Stanley Green Infant Academy,263,26,5,31
Birmingham,St Joseph's Catholic Primary School,412,26,7,33
Birmingham,St Nicholas Catholic Primary School,211,29,0,29
Warwickshire,"Tudor Grange Primary Academy, Haselor",85,18,3,21
Shropshire,Severndale Specialist Academy,413,0,413,413
Bexley,Sherwood Park Primary School,309,59,14,73
Bromley,Elmstead Wood Primary School,319,39,9,48
Norfolk,Attleborough Academy,884,49,15,64
Cambridgeshire,Great Staughton Primary Academy,89,8,1,9
Southend-on-Sea,Darlinghurst Academy,523,52,4,56
Kent,St Simon Stock Catholic School,1106,132,35,167
Cambridgeshire,New Road Primary & Nursery School,229,13,14,27
Barnsley,Dodworth St John the Baptist CofE Primary Academy,182,22,0,22
Surrey,Barnsbury Primary School and Nursery,458,40,11,51
Nottinghamshire,Bishop Alexander L.E.A.D. Academy,247,56,2,58
Norfolk,Ditchingham Church of England Primary Academy,85,6,0,6
Sheffield,Emmanuel Anglican/Methodist Junior School,171,36,2,38
Sheffield,Forge Valley School,1484,203,33,236
Nottingham,Glenbrook Spencer Academy,424,65,2,67
Nottinghamshire,Magnus Church of England Academy,754,128,8,136
Nottingham,Portland Spencer Academy,441,74,4,78
East Riding of Yorkshire,Quay Academy,358,55,9,64
Rotherham,Rawmarsh Community School,1085,250,29,279
Nottingham,Djanogly Strelley Academy,404,94,7,101
Oxfordshire,"St Christopher's Church of England School, Cowley",370,88,9,97
Norfolk,St Clement's High School,668,97,24,121
Wakefield,"St Joseph's Catholic Primary School, Moorthorpe",199,18,4,22
Blackburn with Darwen,St Luke and St Philips Church of England Primary School,209,42,8,50
Dorset,Beaminster St Mary's Academy,102,21,8,29
Dorset,Dunbury Church of England Academy,118,14,1,15
Stoke-on-Trent,Saint Nathaniel's Academy,490,72,9,81
York,Haxby Road Primary Academy,262,17,20,37
Lambeth,King's College London Maths School,146,20,2,22
Leeds,The Ruth Gorse Academy,1301,201,7,208
Bradford,J.A.M.E.S,19,4,8,12
Bradford,St Bede's and St Joseph's Catholic College,1836,344,23,367
Suffolk,Red Oak Primary School,446,138,4,142
Nottinghamshire,Archbishop Cranmer Church of England Academy,215,8,2,10
Redbridge,Beal High School,2670,190,85,275
Cornwall,Boyton Community Primary School,48,8,0,8
Cornwall,Callington Primary School,369,35,6,41
Halton,The Cavendish High Academy,101,2,99,101
Oldham,Greenhill Academy,516,128,29,157
Oxfordshire,John Mason School,1031,173,22,195
North East Lincolnshire,Laceby Acres Primary Academy,206,27,0,27
Cornwall,Lewannick Community Primary School,91,13,0,13
Rotherham,Maltby Redwood Academy,198,32,5,37
Sunderland,Newbottle Primary Academy,453,44,7,51
Doncaster,Richmond Hill Primary Academy,441,46,6,52
"Kingston upon Hull, City of",Spring Cottage Primary School,480,56,27,83
Sheffield,St Catherine's Catholic Primary School (Hallam),460,73,24,97
Oldham,St Chad's Church of England Primary School,275,9,4,13
Rotherham,St Joseph's Catholic Primary School,145,32,3,35
Nottinghamshire,East Bridgford St Peters Church of England Academy,283,11,0,11
Kent,The Brent Primary School,652,106,5,111
Kent,The Gateway Primary Academy,210,21,3,24
Surrey,The Hermitage School,312,45,30,75
Kent,The Skinners' School,1118,71,2,73
Sheffield,Totley Primary School,424,17,2,19
Oldham,Werneth Primary School,414,57,19,76
Cheshire East,Whirley Primary School,209,16,9,25
Stockton-on-Tees,Yarm Primary School,351,46,5,51
Cumbria,Energy Coast UTC,377,12,12,24
Barnet,Millbrook Park Primary School,440,41,13,54
Barnsley,Darton Primary School,300,12,3,15
Portsmouth,Miltoncross Academy,898,100,30,130
Medway,"Gordons Children's Academy, Junior",336,56,1,57
Medway,"Gordons Children's Academy, Infant",164,19,0,19
Leicestershire,Glenfield Primary School,414,43,29,72
Sheffield,Concord Junior Academy,190,47,0,47
Sheffield,Wincobank Nursery and Infant Academy,196,30,2,32
Hertfordshire,Wilshere-Dacre Junior Academy,257,46,6,52
Halton,Bridgewater Park Primary School,104,34,1,35
Nottinghamshire,Sunnyside Spencer Academy,201,26,4,30
Nottinghamshire,Holgate Primary and Nursery School,368,66,4,70
"Herefordshire, County of",Leominster Primary School,533,78,13,91
Wiltshire,Salisbury Sixth Form College,330,50,5,55
Cambridgeshire,Meadow Primary School,211,25,4,29
Suffolk,Trinity Church of England Voluntary Aided Primary School,164,13,1,14
Portsmouth,Madani Academy,53,2,0,2
North Lincolnshire,Willoughby Road Primary Academy,306,38,9,47
North Lincolnshire,The Grange Primary School,387,52,8,60
Wigan,Three Towers Alternative Provision Academy,98,81,3,84
West Northamptonshire,Stimpson Avenue Academy,432,25,2,27
Torbay,All Saints Babbacombe CofE Primary School,197,41,8,49
Cornwall,Coverack Primary School,32,6,0,6
Somerset,Danesfield Church of England Voluntary Controlled Community Middle School,352,46,9,55
Cornwall,Grade-Ruan CofE School,73,11,1,12
Stoke-on-Trent,The Excel Academy,1144,178,31,209
Cornwall,Manaccan Primary School,46,7,1,8
Somerset,"Old Cleeve CofE School, Washford",110,7,3,10
Nottinghamshire,Peafield Lane Academy,327,35,3,38
Gateshead,Sacred Heart Catholic Primary School,229,19,5,24
Bradford,Shirley Manor Primary School,206,52,3,55
Kent,St Gregory's Catholic School,1339,120,34,154
Kent,"St Joseph's Catholic Primary School, Broadstairs",199,30,5,35
Cornwall,St Keverne Community Primary School,62,9,2,11
Torbay,St Marychurch Church of England Primary and Nursery School,307,46,8,54
Somerset,St Peter's Church of England First School,118,17,4,21
Rotherham,Wickersley School and Sports College,2098,219,55,274
Cheshire East,Wistaston Academy,466,52,22,74
Bromley,St John's Church of England Primary School,147,26,7,33
Southampton,Southampton Hospital School,0,0,0,0
Surrey,Esher Church of England High School,1165,104,37,141
West Sussex,Forge Wood Primary School,359,46,13,59
Oxfordshire,Aureus Primary School,392,80,16,96
Oxfordshire,Aureus School,589,163,35,198
Warwickshire,Discovery Academy,98,0,98,98
Hertfordshire,White Trees Independent School,33,0,33,33
Birmingham,Alston Primary School,656,134,3,137
Harrow,Aylward Primary School,513,54,23,77
Wolverhampton,Berrybrook Primary School,236,30,11,41
Nottinghamshire,Birklands Primary School,300,27,1,28
Kirklees,Colne Valley High School,1426,150,30,180
Manchester,Cravenwood Primary Academy,425,37,6,43
Norfolk,Eastgate Academy,271,47,6,53
Cheshire West and Chester,The Oak View Academy,174,43,9,52
Essex,Howbridge Church of England Junior School,337,43,8,51
Kingston upon Thames,Knollmead Primary School,250,38,25,63
Suffolk,Newmarket Academy,836,112,37,149
Cornwall,Pendeen School,79,8,4,12
Hillingdon,Pinkwell Primary School,616,73,20,93
Southend-on-Sea,Prince Avenue Academy and Nursery,506,110,4,114
Blackpool,Revoe Learning Academy,443,89,16,105
Croydon,Oasis Academy Ryelands,456,67,6,73
Cornwall,St Ives School,614,99,7,106
Plymouth,St Paul's Roman Catholic Primary School,153,26,10,36
Bath and North East Somerset,Aspire Academy,103,0,103,103
East Sussex,Seahaven Academy,754,147,14,161
Norfolk,Weeting Church of England Primary School,95,13,4,17
Wandsworth,Westbridge Academy,164,23,5,28
Croydon,Winterbourne Boys' Academy,220,48,4,52
Sunderland,Oxclose Primary Academy,196,45,13,58
Wiltshire,Zouch Academy,403,82,24,106
Camden,Kings Cross Academy,389,81,12,93
Barking and Dagenham,Dorothy Barley Junior Academy,339,50,13,63
Oxfordshire,Didcot Primary Academy,455,79,10,89
Hampshire,The Cambridge Primary School,301,69,13,82
Isle of Wight,The Island Free School,622,78,24,102
Manchester,Cringle Brook Primary School,212,13,6,19
Plymouth,St Boniface's RC College,350,67,16,83
Warwickshire,St James' CofE Academy,218,38,5,43
Devon,Our Lady and St Patrick's Roman Catholic Primary School,161,29,3,32
Leicestershire,Ab Kettleby Primary School,64,7,0,7
Portsmouth,Admiral Lord Nelson School,1173,180,31,211
Nottinghamshire,All Saints Catholic Voluntary Academy,1113,104,9,113
Wiltshire,Netheravon All Saints CofE Primary School,139,31,2,33
Sunderland,Barnwell Academy,282,44,2,46
Medway,Bradfields Academy,375,0,375,375
Leicestershire,Brownlow Primary School,551,70,6,76
Manchester,Burnage Academy for Boys,947,142,25,167
Croydon,Chipstead Valley Primary School,694,55,23,78
"Bournemouth, Christchurch and Poole",Christ The King Catholic Primary School,375,60,8,68
Birmingham,Cottesbrooke Infant and Nursery School,277,34,1,35
Hertfordshire,Crabtree Infants' School,180,4,3,7
Hertfordshire,Crabtree Junior School,255,20,6,26
Manchester,Crossacres Primary Academy,718,120,33,153
Bexley,Days Lane Primary School,663,46,14,60
Norfolk,Duchy of Lancaster Methwold CofE Primary School,97,14,1,15
West Sussex,Durrington High School,1599,240,26,266
Middlesbrough,Easterside Academy,343,58,14,72
Nottingham,Edale Rise Primary & Nursery School,236,39,0,39
"Kingston upon Hull, City of",Estcourt Primary Academy,336,40,7,47
Croydon,Fairchildes Primary School,482,69,22,91
Hounslow,Oak Hill Academy,459,63,7,70
Portsmouth,The Flying Bull Academy,461,105,13,118
Thurrock,Giffards Primary School,405,78,7,85
Buckinghamshire,Great Missenden CofE Combined School,423,38,12,50
Middlesbrough,Green Lane Primary Academy,681,39,8,47
West Sussex,Harlands Primary School,418,42,2,44
Cheshire East,Hermitage Primary School,210,25,11,36
Leicestershire,Highcliffe Primary School and Community Centre,408,57,11,68
Plymouth,Holy Cross Catholic Primary School,302,58,6,64
Nottinghamshire,Holy Trinity Catholic Voluntary Academy,299,49,1,50
"Bristol, City of",Hotwells Primary School,143,7,2,9
Bromley,Keston Church of England Primary School,175,25,7,32
Plymouth,Keyham Barton Catholic Primary School,131,35,4,39
Worcestershire,Tudor Grange Academy Redditch,370,75,40,115
Hampshire,LWS Academy,58,0,58,58
Solihull,Marston Green Infant Academy,331,35,5,40
Milton Keynes,Middleton Primary School,630,29,6,35
Essex,Monkwick Infant and Nursery School,202,40,3,43
West Northamptonshire,Naseby Church of England Primary Academy,67,18,2,20
Plymouth,Notre Dame RC School,785,122,22,144
Trafford,Old Trafford Community Academy,412,72,10,82
Devon,"Our Lady's Catholic Primary School, Barnstaple",257,43,8,51
Cheshire East,Pear Tree Primary School,219,27,11,38
Cornwall,Penponds School,107,8,4,12
Wiltshire,Pewsey Primary School,180,25,3,28
Torbay,"Priory Roman Catholic Primary School, Torquay",76,18,5,23
Essex,Purleigh Community Primary School,212,34,4,38
Torbay,Our Lady of the Angels Catholic Primary School,157,39,8,47
Leicestershire,Riverside Community Primary School Birstall,451,62,9,71
Essex,Rochford Primary and Nursery School,224,34,6,40
Hillingdon,Ruislip High School,1257,173,45,218
Torbay,Sacred Heart Catholic School,221,18,11,29
Redcar and Cleveland,Saint Gabriel's Catholic Primary School,214,12,4,16
Redcar and Cleveland,St Peter's Catholic College,543,73,31,104
Bromley,Scotts Park Primary School,392,24,9,33
Norfolk,Short Stay School for Norfolk,315,118,136,254
Leicestershire,Somerby Primary School,37,2,4,6
Dorset,"St Augustine's Catholic Primary School, Weymouth",203,34,8,42
Dorset,St Catherine's Roman Catholic School,117,23,6,29
Manchester,St Elizabeth's Catholic Primary School,235,45,13,58
Blackpool,St George's School A Church of England Academy,994,155,7,162
"Bournemouth, Christchurch and Poole",St James' Church of England Primary Academy,409,51,16,67
Devon,"St John the Baptist Roman Catholic Primary School, Dartmouth",85,19,6,25
Devon,St John's Catholic Primary School,121,15,2,17
Cornwall,"St John's Catholic Primary School, Camborne",159,28,3,31
Plymouth,St Joseph's Catholic Primary School,191,16,4,20
Devon,St Joseph's Catholic Primary School,118,28,5,33
Devon,"St Joseph's Catholic Primary School, Exmouth",162,29,3,32
"Bournemouth, Christchurch and Poole","St Joseph's Catholic Primary School, Poole",382,48,10,58
Torbay,St Margaret Clitherow Catholic Primary School,65,16,2,18
Redcar and Cleveland,St Margaret Clitherows RC Primary School,352,50,4,54
Dorset,St Mary & St Joseph's Catholic Primary School,153,27,3,30
Dorset,"St Mary's Catholic First School, Dorchester",190,21,2,23
Devon,"St Mary's Catholic Primary School, Axminster",135,29,6,35
Cornwall,"St Mary's Catholic Primary School, Bodmin",253,47,7,54
Devon,"St Mary's Catholic Primary School, Buckfast",137,17,10,27
Cornwall,"St Mary's Catholic Primary School, Falmouth",205,24,7,31
Dorset,"St Mary's Catholic Primary School, Marnhull",91,13,2,15
"Bournemouth, Christchurch and Poole","St Mary's Catholic Primary School, Poole",405,67,11,78
Cornwall,"St Mary's Catholic School, Penzance",154,30,2,32
Redcar and Cleveland,St Mary's Catholic Primary School,236,42,13,55
Dorset,"St Mary's Catholic Primary School, Swanage",188,25,6,31
Cornwall,St Meriadoc CofE Junior Academy,215,25,7,32
Cornwall,St Meriadoc CofE Infant Academy,229,52,6,58
Nottinghamshire,"St Patrick's Catholic Primary School, A Voluntary Academy",227,26,0,26
Plymouth,St Peter's RC Primary School,131,21,1,22
Plymouth,The Cathedral School of St Mary,113,16,1,17
Hertfordshire,The Hertfordshire & Essex High School and Science College,1483,97,12,109
Leicestershire,The Cedars Academy,999,158,32,190
Newcastle upon Tyne,Thomas Walling Primary Academy,424,59,8,67
Gloucestershire,Tredworth Infant and Nursery Academy,217,43,5,48
Cornwall,Troon Community Primary School,149,11,7,18
Cheshire East,Tytherington School,1373,164,49,213
Sandwell,Silvertrees Academy,338,47,5,52
Sandwell,Wednesbury Oak Academy,455,69,10,79
West Sussex,White Meadows Primary Academy,610,107,15,122
Waltham Forest,Whitefield Schools,358,0,358,358
Brent,Woodfield School,185,0,185,185
Gloucestershire,Winchcombe Abbey Church of England Primary School,303,43,15,58
Wolverhampton,Wolverhampton Girls' High School,1147,53,0,53
Rotherham,Rawmarsh Ashwood Primary School,194,29,3,32
Kent,Whitehill Primary School,659,37,12,49
North East Lincolnshire,Humberston Cloverfields Academy,337,35,7,42
Staffordshire,St John Fisher Catholic College,1121,114,26,140
Staffordshire,St Mary's Catholic Primary School,410,27,4,31
Stoke-on-Trent,St Teresa's Catholic (A) Primary School,321,37,6,43
Stoke-on-Trent,St Thomas Aquinas Catholic Primary School,240,25,6,31
Westminster,Ormiston Beachcroft Academy,55,45,10,55
Kensington and Chelsea,Ormiston Latimer Academy,47,33,11,44
Surrey,Banstead Infant School,232,15,4,19
Surrey,Warren Mead Junior School,282,27,4,31
Hammersmith and Fulham,Earl's Court Free School Primary,204,25,5,30
Cheshire East,Cheshire Studio School,120,23,11,34
Tameside,Brambles School,3,2,1,3
Norfolk,Jane Austen College,1066,117,13,130
Doncaster,North Bridge Enterprise College,28,9,0,9
Havering,Drapers' Brookside Junior School,238,53,7,60
Norfolk,Stalham Academy,243,60,0,60
North Northamptonshire,St Andrew's Church of England Primary School,361,64,17,81
Sheffield,Newfield Secondary School,1046,127,32,159
Suffolk,Sidegate Primary School,655,54,49,103
Suffolk,Grove Primary School,334,60,13,73
Leeds,Ryecroft Academy,339,82,2,84
Sheffield,Emmaus Catholic and CofE Primary School,321,64,4,68
Oxfordshire,Eynsham Community Primary School,402,60,15,75
Essex,Larchwood Primary School,416,34,2,36
West Northamptonshire,Falconer's Hill Academy,237,30,3,33
"Kingston upon Hull, City of",Westcott Primary School,300,41,7,48
Thurrock,Tilbury Pioneer Academy,484,58,23,81
Brent,Gladstone Park Primary School,663,78,19,97
Central Bedfordshire,Langford Village Academy,261,23,17,40
Cornwall,Fowey River Academy,583,88,15,103
Cornwall,Gulval School,212,25,7,32
Cornwall,Liskeard Hillfort Primary School,400,45,10,55
Cornwall,Altarnun Primary School,57,13,0,13
Croydon,Broadmead Primary School,410,73,5,78
Croydon,Rowdown Primary School,327,39,5,44
Derby,Bishop Lonsdale Church of England Primary School and Nursery,232,30,2,32
Derbyshire,Newbold CofE Primary School,213,22,2,24
Essex,St Cedd's Church of England Primary School,102,11,0,11
Isle of Wight,"Cowes Enterprise College, An Ormiston Academy",1238,195,39,234
"Kingston upon Hull, City of",Buckingham Primary Academy,235,30,6,36
"Kingston upon Hull, City of",St Vincent's Voluntary Catholic Academy,238,41,7,48
"Kingston upon Hull, City of",Southcoates Primary Academy,339,62,6,68
Leicestershire,Barlestone Church of England Primary School,189,16,0,16
Leicestershire,Woolden Hill Primary School,193,29,5,34
Norfolk,Snettisham Primary School,88,17,2,19
North Northamptonshire,Oakway Academy,588,83,17,100
Nottinghamshire,The Beech Academy,88,0,88,88
Peterborough,West Town Primary Academy,391,37,14,51
Sandwell,St John's Church of England Primary Academy,194,24,5,29
Slough,Western House Academy,674,47,9,56
Staffordshire,Havergal CofE (C) Primary School,160,11,0,11
Stoke-on-Trent,Norton-Le-Moors Primary Academy,234,22,6,28
Surrey,Sayes Court School,252,24,11,35
Thurrock,Olive AP Academy - Thurrock,56,32,4,36
Brent,Michaela Community School,708,96,17,113
Birmingham,The University of Birmingham School,1170,113,55,168
Halton,Ormiston Chadwick Academy,948,137,21,158
Doncaster,The McAuley Catholic High School,1422,144,13,157
East Riding of Yorkshire,The Snaith School,849,156,38,194
Hartlepool,English Martyrs Catholic School and Sixth Form College,1459,145,19,164
"Herefordshire, County of",Fairfield High School,555,112,20,132
Middlesbrough,Kader Academy,480,61,7,68
Norfolk,St Martin At Shouldham Church of England Primary Academy,185,13,7,20
Oxfordshire,Stanton Harcourt CofE Primary School,119,20,2,22
Stoke-on-Trent,Sandon Primary Academy,522,154,9,163
Kent,"St Gregory's Catholic Primary School, Margate",291,59,13,72
Kent,"St Anselm's Catholic School, Canterbury",1099,157,68,225
Oxfordshire,Wheatley Park School,1138,192,34,226
Surrey,New Haw Community Junior School,357,56,7,63
Trafford,Lime Tree Primary Academy,492,100,15,115
Warwickshire,St Nicolas CofE Academy,423,54,3,57
Blackburn with Darwen,Witton Park Academy,1240,215,16,231
Surrey,Hillcroft Primary School,453,59,17,76
Cambridgeshire,Littleport & East Cambs Academy,543,91,31,122
Cambridgeshire,Highfield Littleport Academy,137,0,137,137
Westminster,Marylebone Boys' School,727,66,16,82
Oxfordshire,Futures Institute Banbury,141,24,0,24
Suffolk,Hillside Primary School,467,66,9,75
Cambridgeshire,Kingsfield Primary School,378,92,22,114
Birmingham,Albert Bradbeer Primary Academy,435,99,5,104
Birmingham,Heathlands Primary Academy,424,52,3,55
Blackburn with Darwen,Darwen St James CofE Primary Academy,218,49,3,52
Buckinghamshire,Beaconsfield High School,1270,124,4,128
Cheshire East,Smallwood CofE Primary School,181,31,4,35
Cheshire East,Marlfields Primary School,215,21,23,44
Cheshire West and Chester,St Bernard's Roman Catholic Primary School,228,34,4,38
Cornwall,Mawgan-In-Pydar Primary School,100,18,0,18
Dorset,Shaftesbury School,905,151,22,173
Kent,Bobbing Village School,208,17,4,21
Kent,Iwade School,621,65,15,80
"Kingston upon Hull, City of",Christopher Pickering Primary School,440,77,38,115
"Kingston upon Hull, City of",St Mary Queen of Martyrs VC Academy,325,52,5,57
"Kingston upon Hull, City of",Ganton School,169,0,169,169
"Kingston upon Hull, City of",Endsleigh Holy Child VC Academy,307,19,7,26
"Kingston upon Hull, City of",St Nicholas Primary School,210,29,8,37
Leicestershire,St Peter's Church of England Primary School Wymondham,41,4,0,4
Leicestershire,Redmile Church of England Primary School,71,8,2,10
Leicestershire,Loughborough Church of England Primary School,205,17,3,20
Leicestershire,Tugby Church of England Primary School,46,4,1,5
Leicestershire,Waltham on the Wolds Church of England Primary School,96,10,0,10
Norfolk,"The Norman Church of England Primary School, Northwold",118,27,1,28
Oxfordshire,"St Peter's Church of England Primary School, Cassington",118,11,2,13
Oxfordshire,Freeland Church of England Primary School,134,16,1,17
Peterborough,William Law CofE Primary School,570,71,6,77
Redcar and Cleveland,Normanby Primary School,522,59,2,61
Redcar and Cleveland,Nunthorpe Primary Academy,239,38,1,39
Sandwell,St Pauls Church of England Academy,203,29,5,34
Shropshire,Idsall School,1312,139,19,158
Solihull,Smith's Wood Primary Academy,447,59,3,62
South Tyneside,Cleadon Church of England Academy,474,53,7,60
Stockport,Hursthead Junior School,362,52,4,56
Sunderland,Ryhope Infant School Academy,169,16,3,19
Surrey,Pyrford Church of England Primary School,477,72,7,79
Wirral,Townfield Primary School,505,68,8,76
Worcestershire,Bengeworth CE Academy,514,53,12,65
Worcestershire,Hollymount School,407,47,6,53
Bromley,Harris Primary Academy Beckenham,406,29,12,41
Haringey,Harris Academy Tottenham,1309,115,45,160
Bromley,Harris Primary Academy Shortlands,350,46,8,54
Southwark,Harris Primary Academy East Dulwich,384,44,7,51
Thurrock,Harris Primary Academy Mayflower,1028,75,31,106
Westminster,Harris Westminster Sixth Form,589,53,4,57
Sheffield,Chapeltown Academy,285,17,7,24
Cornwall,Oak Tree School,75,0,75,75
West Northamptonshire,Malcolm Arnold Preparatory School,417,27,8,35
Stockton-on-Tees,Ingleby Manor Free School & Sixth Form,629,91,19,110
Lincolnshire,Lincoln UTC,375,56,9,65
Croydon,Harris Invictus Academy Croydon,992,175,19,194
Wokingham,Evendons Primary School,392,40,20,60
Hertfordshire,Lanchester Primary School,342,18,7,25
Hertfordshire,Jupiter Primary School,385,45,7,52
Hertfordshire,Ascot Road Primary School,380,31,12,43
Waltham Forest,"Eden Girls' School, Waltham Forest",607,28,8,36
Coventry,Eden Girls' School Coventry,601,71,7,78
Bolton,Eden Boys' School Bolton,620,56,24,80
Coventry,WMG Academy for Young Engineers,498,45,6,51
Barking and Dagenham,Goresbrook School,1102,113,7,120
Ealing,St Mary's Church of England Primary Norwood Green,167,17,4,21
Doncaster,XP School,248,55,10,65
Newcastle upon Tyne,Studio West,573,93,21,114
Lambeth,Trinity Academy,616,139,28,167
Croydon,Paxton Academy Sports And Science,190,22,3,25
Suffolk,Sybil Andrews Academy,682,90,11,101
Devon,Exeter Mathematics School,127,32,3,35
Bolton,Essa Primary School,397,68,11,79
Hounslow,Alexandra Primary School,700,61,9,70
Liverpool,Anfield Road Primary School,680,177,17,194
Dorset,Dorset Studio School,357,105,36,141
Barnsley,Kirk Balk Academy,1332,234,36,270
Kent,The Holy Family Catholic Primary School,209,30,4,34
Cheshire East,Black Firs Primary School,368,35,2,37
Oxfordshire,Standlake Church of England Primary School,132,21,2,23
Nottingham,Nottingham University Academy of Science and Technology,917,88,6,94
Wandsworth,Harris Academy Battersea,1031,97,22,119
Kent,The Leigh UTC,730,116,14,130
Lincolnshire,Weston St Mary Church of England Primary School,40,11,1,12
Medway,Warren Wood Primary Academy,486,86,36,122
Norfolk,Edith Cavell Academy and Nursery,217,35,9,44
North East Lincolnshire,The Canon Peter Hall CofE Primary School,221,43,1,44
Nottinghamshire,Hall Park Academy,934,111,5,116
Rotherham,Thrybergh Primary School,147,66,3,69
Slough,The Langley Heritage Primary,529,57,8,65
Staffordshire,Moorgate Primary Academy,310,30,3,33
Staffordshire,Rowley Park Primary Academy,200,15,5,20
Staffordshire,Walton Hall Academy,191,0,191,191
Suffolk,Tollgate Primary School,383,69,6,75
Bromley,La Fontaine Academy,412,25,5,30
Warwickshire,Studley St Mary's CofE Academy,207,45,6,51
Sandwell,Al Khair Primary School,69,2,0,2
Bradford,Dixons McMillan Academy,655,73,13,86
Birmingham,Jewellery Quarter Academy,609,77,1,78
Hertfordshire,The Watford UTC,54,1,1,2
Medway,INSPIRE Free Special School,61,0,61,61
Redbridge,Beacon Business Innovation Hub,47,30,16,46
Warwickshire,Arc School Napton,19,0,19,19
Warwickshire,Arc School Ansley,51,0,51,51
Slough,Ditton Park Academy,1131,106,49,155
Nottingham,Nottingham Free School,659,58,5,63
Leicester,Falcons Primary School,313,27,4,31
Blackburn with Darwen,Eden School,57,0,57,57
Enfield,Meridian Angel Primary School,152,29,1,30
Brent,Ark Elvin Academy,1273,167,24,191
Portsmouth,Ark Dickens Primary Academy,464,59,9,68
East Sussex,Ark Blacklands Primary Academy,629,67,8,75
East Sussex,Ark Little Ridge Primary Academy,429,27,14,41
Merton,The Norwegian Kindergarten In London,16,1,0,1
Kent,Jubilee Primary School,301,28,5,33
Merton,Park Academy,115,11,5,16
Lancashire,Burnley High School,570,78,11,89
Southwark,Treasure House (London) CIC,14,0,14,14
North Northamptonshire,Rushden Primary Academy,383,44,1,45
Knowsley,Finch Woods Academy,88,0,88,88
Worcestershire,The Aspire Academy,16,0,0,0
Hillingdon,De Salis Studio College,153,10,0,10
Surrey,Trinity Oaks Church of England Primary School,219,14,6,20
"Kingston upon Hull, City of",Aspire Academy,83,34,49,83
West Sussex,The Gatwick School,935,117,15,132
Tower Hamlets,"Canary Wharf College, Glenworth",315,28,6,34
Cumbria,Walney School,479,67,27,94
South Gloucestershire,Hanham Woods Academy,803,120,46,166
Dorset,Archbishop Wake Church of England Primary School,396,58,13,71
West Northamptonshire,Barby Church of England Primary School,99,19,0,19
Sunderland,Barnes Infant Academy,326,39,4,43
Dorset,Blandford St Mary Church of England Primary School,189,33,4,37
Bexley,Brampton Primary Academy,389,21,3,24
West Northamptonshire,Braunston Church of England Primary School,192,26,2,28
Norfolk,Flitcham Church of England Primary Academy,71,6,3,9
Oxfordshire,Glory Farm Primary School,327,40,6,46
Essex,Grove Wood Primary School,630,58,19,77
Oxfordshire,Hanborough Manor CofE School,203,25,6,31
Harrow,Heathland School,659,52,20,72
Hillingdon,Hillingdon Primary School,695,59,10,69
Doncaster,Holy Family Catholic Primary School,189,24,0,24
Kirklees,Lindley Church of England Infant School,359,21,8,29
Worcestershire,Our Lady of Mount Carmel Catholic First School,288,26,3,29
Bradford,Our Lady of Victories Catholic School,244,18,9,27
Rotherham,Sitwell Junior School,307,53,10,63
Dorset,Spetisbury CofE Primary School,190,27,5,32
Bradford,St Anne's Catholic Primary School,235,31,4,35
Worcestershire,St Augustine's Catholic High School,968,87,11,98
Worcestershire,St Bede's Catholic Middle School,669,89,7,96
Kent,St Mary's Catholic Primary School,185,12,2,14
Worcestershire,St Peter's Catholic First School,264,49,2,51
Kent,"St Simon of England Roman Catholic Primary School, Ashford",209,27,5,32
West Northamptonshire,Staverton Church of England Voluntary Primary School,106,12,4,16
Oxfordshire,The Cooper School,1296,253,29,282
Thurrock,Tudor Court Primary School,764,88,15,103
Harrow,Whitefriars School,1514,144,30,174
West Northamptonshire,Woodford Halse Church of England Primary Academy,269,50,4,54
Staffordshire,Woodhouse Academy,430,31,6,37
Liverpool,Blessed Sacrament Catholic Primary School,722,100,38,138
West Northamptonshire,Badby School,157,10,6,16
"Kingston upon Hull, City of",Francis Askew Primary School,415,67,12,79
West Northamptonshire,Kilsby Church of England Primary School,143,9,2,11
West Northamptonshire,Weedon Bec Primary School,212,21,2,23
Newham,Oasis Academy Silvertown,471,40,21,61
Kent,Skinners' Kent Primary School,210,33,7,40
Norfolk,University Technical College Norfolk,414,59,6,65
Oldham,Iqra High School,62,7,0,7
"Bournemouth, Christchurch and Poole",Ocean Academy Poole,306,41,14,55
Tower Hamlets,East London Arts & Music,297,30,17,47
Portsmouth,Copnor Primary School,668,109,15,124
Barnsley,The Mill Academy,225,21,4,25
Bradford,St Philip's CofE Primary School,223,16,4,20
Lincolnshire,The Isaac Newton Primary School,409,60,8,68
North East Lincolnshire,Phoenix Park Academy,51,37,14,51
Sheffield,Lowedges Junior Academy,334,72,10,82
Liverpool,Lipa Primary and High School,484,87,12,99
Coventry,Seva School,630,65,7,72
Worcestershire,Holy Trinity School,737,134,11,145
Cumbria,Chetwynde School,506,65,23,88
County Durham,Endeavour Academy Durham,51,38,13,51
"Bristol, City of",Easton Church of England Academy,427,85,2,87
Oxfordshire,UTC Oxfordshire,344,105,8,113
Essex,Unity Primary Academy,427,55,6,61
Bexley,Mayplace Primary School,600,79,30,109
Blackpool,St Cuthbert's Catholic Academy,228,26,2,28
Bromley,Bromley Trust Alternative Provision Academy,55,55,0,55
Bromley,St. Mary Cray Primary Academy,223,26,4,30
Croydon,New Valley Primary School,179,22,3,25
Croydon,St Mark's Church of England Primary Academy,134,24,5,29
Croydon,Beulah Infants' School,198,36,2,38
County Durham,Rosa Street Primary  and Nursery Academy,208,47,2,49
Hampshire,The Ashwood Academy,7,5,0,5
Peterborough,Dogsthorpe Academy,381,84,5,89
Leicestershire,Hardwick House School,42,0,42,42
Stoke-on-Trent,Sporting Stars Academy,58,11,47,58
Islington,The Pears Family School,2,0,2,2
Blackpool,Blackpool Aspire Academy,838,155,14,169
Tower Hamlets,London Enterprise Academy,464,43,7,50
Hammersmith and Fulham,The Fulham Boys School,782,89,21,110
Leicester,Mowmacre Hill Primary School,395,56,9,65
Newham,Education Links,80,5,12,17
Leeds,The Elland Academy,2,2,0,2
Doncaster,"St Wilfrid's Academy, Doncaster",0,0,0,0
Wiltshire,St Bartholomew's Primary Academy,366,98,7,105
Merton,Harris Primary Academy Merton,507,37,30,67
Wakefield,Oyster Park Primary Academy,369,111,13,124
Oxfordshire,Blessed George Napier Catholic School and Sixth Form,869,130,19,149
Surrey,Carwarden House Community School,153,0,153,153
Wiltshire,Dilton Marsh CofE Primary School,176,23,5,28
Bath and North East Somerset,High Littleton CofE VC Primary School,178,8,10,18
Oxfordshire,"Holy Trinity Catholic School, Chipping Norton",189,25,4,29
Leicestershire,Market Harborough Church of England Academy,370,35,5,40
Cheshire East,Mossley CofE Primary School,427,24,7,31
Sunderland,North View Academy,85,0,85,85
Brent,North West London Jewish Day School,205,45,4,49
Oxfordshire,"St Joseph's Catholic Primary School, Banbury",211,50,4,54
Kent,St Margaret Clitherow Catholic Primary School,397,71,11,82
Kent,"St Thomas' Catholic Primary School, Sevenoaks",218,11,5,16
Bromley,St Peter and St Paul Catholic Primary School,231,35,3,38
Somerset,Staplegrove Church School,210,17,7,24
South Tyneside,Holy Trinity Church of England Academy (South Shields),239,53,3,56
Norfolk,Cherry Tree Academy Trust Marham Infant,174,22,9,31
Somerset,Norton Fitzwarren Church School,324,47,6,53
Greenwich,Woolwich Polytechnic School,1584,267,40,307
Camden,The ArtsXchange,36,1,23,24
Blackburn with Darwen,Queen Elizabeth's Grammar School,1286,160,19,179
Lincolnshire,The Barnes Wallis Academy,547,116,22,138
Bury,Elton Community Primary School,316,36,17,53
Norfolk,West Lynn Primary School,152,20,3,23
Worcestershire,Tenbury High Ormiston Academy,470,71,20,91
Essex,Holt Farm Junior School,301,45,1,46
Solihull,Castlewood School,92,0,92,92
Suffolk,Kessingland Church of England Primary Academy,228,42,9,51
Havering,Rise Park Junior School,339,42,5,47
South Gloucestershire,Severn Beach Primary School,140,22,4,26
Portsmouth,Priory School,1235,177,22,199
Shropshire,Sir John Talbot's School,816,74,43,117
Barking and Dagenham,The Warren School,1318,169,37,206
North Yorkshire,The Skipton Academy,474,86,24,110
Shropshire,Morville CofE (Controlled) Primary School,59,5,0,5
West Sussex,Kingsham Primary School,308,44,8,52
Essex,Montgomerie Primary School,204,27,4,31
"Bournemouth, Christchurch and Poole",Broadstone Middle School,686,80,30,110
Gateshead,Thorp Academy,1418,118,33,151
Staffordshire,John Wheeldon Primary Academy,509,75,13,88
Hampshire,The Coppice Spring Academy,54,0,54,54
"Bristol, City of",Barton Hill Academy,334,67,7,74
Norfolk,Thomas Bullock Church of England Primary and Nursery Academy,218,30,3,33
Cheshire East,Broken Cross Primary Academy and Nursery,220,29,26,55
Essex,Water Lane Primary Academy,194,18,3,21
Essex,Willow Brook Primary School and Nursery,187,36,3,39
Manchester,Levenshulme High School,1008,92,9,101
Surrey,Sandfield Primary School,212,28,6,34
Cornwall,St Dennis Primary Academy,207,30,8,38
Medway,Napier Community Primary and Nursery Academy,585,76,12,88
Surrey,Kings College Guildford,465,177,27,204
Oxfordshire,Gagle Brook Primary School,117,24,12,36
Staffordshire,Five Spires Academy,230,34,3,37
Knowsley,Knowsley Lane Primary School,350,39,12,51
Birmingham,Town Junior School,240,37,4,41
Manchester,IncludEd Learning,12,6,3,9
Oxfordshire,LVS Oxford,48,0,48,48
Haringey,Brook House Primary School,398,57,17,74
Croydon,The Archbishop Lanfranc Academy,789,143,10,153
Cambridgeshire,William de Yaxley Church of England Academy,227,27,8,35
Cambridgeshire,Mepal and Witcham Church of England Primary School,112,8,5,13
Cambridgeshire,St Peter's CofE Aided Junior School,226,50,11,61
Essex,Woodlands School,1497,93,48,141
Kent,Reculver Church of England Primary School,493,63,23,86
Kent,St Edmund's Catholic School,567,96,15,111
Kent,St Mary of Charity CofE (Aided) Primary School,208,17,10,27
Leicester,North Mead Primary Academy,445,42,6,48
Leicestershire,Christ Church & Saint Peter's Cofe Primary School,415,83,15,98
Medway,Cuxton Community Junior School,228,26,5,31
Windsor and Maidenhead,The Green Room School,47,1,46,47
Norfolk,Antingham and Southrepps Primary School,58,8,3,11
Norfolk,Cherry Tree Academy Trust Marham Junior,179,40,7,47
Norfolk,Holy Cross Church of England Primary School,47,11,2,13
North Northamptonshire,St Barnabas Church of England School,177,28,1,29
Oxfordshire,Bayards Hill School,270,40,12,52
Plymouth,Austin Farm Academy,140,37,1,38
Rutland,Ryhall CofE Academy,203,27,1,28
Suffolk,Alde Valley Academy,586,99,18,117
Torbay,Preston Primary School,327,42,35,77
Birmingham,Kimichi School,51,1,25,26
Warwickshire,Budbrooke Primary School,197,29,5,34
Wolverhampton,Wednesfield High Academy,1052,172,15,187
Worcestershire,Heronswood Primary School,456,95,5,100
Enfield,Focus 1st Academy,18,4,10,14
Oldham,North Chadderton School,1599,171,47,218
Islington,North Bridge House Senior Canonbury School,247,21,3,24
Hertfordshire,Pinewood School,204,0,204,204
Birmingham,Calthorpe Academy,428,0,428,428
Lincolnshire,Ambergate Sports College,175,0,175,175
Lincolnshire,The Grantham Sandon School,74,0,74,74
Newham,John F Kennedy Special School,156,2,154,156
Blackpool,St Mary's Catholic Academy,1199,122,16,138
"Bournemouth, Christchurch and Poole",Broadstone First School,314,22,12,34
Derbyshire,The Ripley Academy,841,45,20,65
Lincolnshire,Holbeach Primary Academy,317,67,15,82
East Sussex,Churchwood Primary Academy,245,71,14,85
East Sussex,Hollington Primary Academy,378,56,5,61
East Sussex,Robsack Wood Primary Academy,482,137,5,142
Manchester,Whalley Range 11-18 High School,1667,174,17,191
West Sussex,Halsford Park Primary School,415,53,7,60
West Sussex,Fernhurst Primary School,145,22,2,24
West Sussex,"Baldwins Hill Primary School, East Grinstead",187,29,2,31
Norfolk,Northgate High School,1129,191,38,229
Norfolk,"City of Norwich School, An Ormiston Academy",1763,204,26,230
Birmingham,Hillstone Primary School,449,48,2,50
Milton Keynes,Kents Hill School,84,12,1,13
Wiltshire,Queen's Crescent  School,405,62,5,67
Swindon,Haydon Wick Primary School,274,39,9,48
Wiltshire,St Peter's CofE Academy,189,25,9,34
Stockport,Gatley Primary School,579,32,9,41
Medway,Cuxton Community Infant School,180,12,4,16
Warwickshire,Lawrence Sheriff School,1079,7,2,9
Staffordshire,Featherstone Academy,203,23,5,28
Leicestershire,Bringhurst Primary School,163,13,1,14
Warwickshire,Acorns Primary School,93,13,2,15
Warwickshire,Shipston-on-Stour Primary School,395,62,9,71
Wakefield,Walton Primary Academy,340,38,9,47
Cornwall,St Minver School,153,11,3,14
Devon,Blackawton Primary School,129,15,2,17
Devon,Moretonhampstead Primary School,130,7,4,11
Devon,Stoke Fleming Community Primary School,142,14,4,18
Devon,East Allington Primary School,105,14,4,18
Blackpool,Christ The King Catholic Academy,237,23,6,29
North East Lincolnshire,Welholme Academy,544,103,5,108
Wakefield,Castleford Three Lane Ends Academy,414,70,10,80
Bromley,Leesons Primary School,385,129,11,140
Sandwell,Devonshire Junior Academy,356,35,21,56
Sandwell,Devonshire Infant Academy,338,33,18,51
Surrey,Ashley Church of England Primary School,588,37,17,54
Windsor and Maidenhead,Knowl Hill Church of England Primary Academy,119,32,4,36
Newham,Sheringham Primary School,600,117,39,156
Cambridgeshire,Cromwell Academy,202,40,11,51
Coventry,St John's Church of England Academy,210,22,0,22
Havering,Rise Park Infant School,300,15,7,22
Peterborough,Hampton College,1673,156,33,189
Stockton-on-Tees,Harrow Gate Academy,426,135,9,144
North East Lincolnshire,Healing Primary Academy,341,16,7,23
Essex,Pear Tree Mead Academy,464,19,10,29
Isle of Wight,Lanesend Primary School,446,112,28,140
Cheshire East,Nether Alderley Primary School,101,11,2,13
Calderdale,Ryburn Valley High School,1658,155,66,221
Kent,Adisham Church of England Primary School,97,20,4,24
Greenwich,Stationers' Crown Woods Academy,1575,180,64,244
Norfolk,Whitefriars Church of England Primary Academy,373,62,7,69
Greenwich,Pulse and Water College,14,3,4,7
Birmingham,Bournville School,665,98,11,109
Birmingham,Wyndcliffe Primary School,618,91,28,119
Birmingham,Brownmead Primary Academy,341,49,1,50
Blackburn with Darwen,Darwen Vale High School,1044,147,11,158
Cornwall,Delabole Primary School,103,20,0,20
Derby,Allenton Primary School,333,62,7,69
Dudley,The Crestwood School,1000,165,44,209
Essex,Leigh Beck Infant School and Nursery Academy,302,11,7,18
Essex,Forest Hall School,491,97,40,137
Kent,Kennington Church of England Academy,356,54,5,59
Liverpool,Heygreen Primary School,244,55,3,58
Norfolk,Caister Academy,694,165,18,183
Oldham,Alt Academy,330,78,7,85
Nottingham,Jubilee L.E.A.D. Academy,325,77,1,78
Rotherham,Wickersley Northfield Primary School,454,50,4,54
Sefton,St Michael's Church of England High School,693,95,55,150
Sheffield,Woodlands Primary School,484,103,19,122
Shropshire,Stokesay Primary School,157,15,3,18
South Gloucestershire,Marlwood School,514,70,15,85
Staffordshire,Kinver High School and Sixth Form,703,95,11,106
Staffordshire,Wombourne High School,1109,144,17,161
Staffordshire,Three Peaks Primary Academy,372,67,3,70
Stockton-on-Tees,Ash Trees Academy,171,0,171,171
Stoke-on-Trent,Whitfield Valley Primary Academy,459,69,2,71
Surrey,St Lawrence Primary School,203,19,6,25
West Sussex,The Globe Primary Academy,422,51,13,64
Windsor and Maidenhead,St Peter's Church of England Middle School,325,59,9,68
Blackburn with Darwen,St Aidan's Primary School - A Church of England Academy,203,40,3,43
"Bristol, City of",Wicklea Academy,239,48,1,49
Bromley,Trinity Church of England Primary School,382,49,37,86
Devon,Gatehouse Primary Academy,325,41,13,54
Essex,Parkwood Academy,229,34,9,43
Norfolk,Wensum Junior School,179,29,9,38
Norfolk,Eaton Primary School,402,39,1,40
Norfolk,Stradbroke Primary Academy,214,33,12,45
Norfolk,Cobholm Primary Academy,168,32,4,36
Norfolk,St Michael's Church of England Academy,199,25,9,34
North Somerset,Yeo Moor Primary School,363,29,6,35
North Somerset,Tickenham Church of England Primary School,87,7,1,8
Nottingham,The Oakwood Academy,734,108,3,111
Oxfordshire,Millbrook Primary School,470,56,7,63
Rochdale,Deeplish Primary Academy,452,33,9,42
Rotherham,Maltby Manor Academy,398,66,3,69
Shropshire,Longlands Primary School,209,50,13,63
Stockton-on-Tees,Ian Ramsey Church of England Academy,1177,186,12,198
Stockton-on-Tees,Our Lady & St. Bede Catholic Academy,1063,103,33,136
Suffolk,Coupals Primary Academy,331,33,9,42
Suffolk,Castle Hill Infant School,217,22,26,48
Suffolk,Castle Hill Junior School,298,56,23,79
Bradford,Dixons Manningham Academy,434,55,6,61
Coventry,Riverbank School,198,0,198,198
Derbyshire,Outwood Academy Newbold,1041,170,40,210
"Bournemouth, Christchurch and Poole",The Grange School,369,71,21,92
Essex,Longwood Primary Academy,422,46,11,57
Essex,Abbotsweld Primary Academy,289,42,4,46
Essex,Latton Green Primary Academy,205,24,6,30
Stockton-on-Tees,Green Gates Academy,42,0,42,42
Stockton-on-Tees,Westlands Academy,82,0,82,82
Kent,St Edward's Catholic Primary School,197,14,8,22
"Kingston upon Hull, City of",St James' Church of England Academy,217,36,12,48
Lincolnshire,Ingoldsby Academy,64,13,2,15
Lincolnshire,Thomas Middlecott Academy,576,82,9,91
North Yorkshire,Brotherton and Byram Community Primary Academy,188,18,3,21
Norfolk,Stalham High School,458,83,14,97
Nottingham,Rosslyn Park Primary and Nursery School,642,102,6,108
Nottingham,Brocklewood Primary and Nursery School,500,95,6,101
Nottinghamshire,The Bramble Academy,155,20,0,20
Redcar and Cleveland,Outwood Academy Bydales,795,112,17,129
Rochdale,Kentmere Primary Academy,356,53,10,63
Oldham,Westwood Academy,228,35,3,38
Sheffield,High Hazels Nursery Infant Academy,318,43,1,44
Sheffield,High Hazels Junior School,358,58,1,59
Stoke-on-Trent,Mill Hill Primary Academy,461,79,4,83
Suffolk,Glemsford Primary Academy,236,19,5,24
Suffolk,Stone Lodge Academy,169,0,169,169
Tameside,Linden Road Academy and Hearing Impaired Base,221,18,10,28
Wakefield,Airedale Junior School,403,87,18,105
Walsall,All Saints National Academy,253,63,6,69
Waltham Forest,Big Creative Independent School,16,10,5,15
Worcestershire,Cutnall Green CofE Primary School,160,21,5,26
Worcestershire,St Ambrose Catholic Primary,193,32,2,34
Worcestershire,Hagley Catholic High School,1086,115,11,126
Worcestershire,St Clement's CofE Primary,259,32,3,35
Worcestershire,St Wulstan's Catholic Primary School,153,24,3,27
Tameside,Manchester Road Primary Academy,360,89,19,108
Surrey,Queen Eleanor's Church of England School,345,36,10,46
Surrey,Cuddington Croft Primary School,476,30,8,38
Staffordshire,Blackfriars Academy,119,0,119,119
Staffordshire,Coppice Academy,98,0,98,98
Staffordshire,Glascote Academy,281,32,1,33
Shropshire,The Lacon Childe School,543,62,27,89
Rutland,St Nicholas Church of England Primary School,126,11,4,15
Rutland,Ketton Church of England Primary School,184,20,2,22
Rutland,Whissendine Church of England Primary School,158,14,2,16
Rotherham,St Alban's CofE (Aided) Primary School,249,21,3,24
Redcar and Cleveland,"Saint Paulinus Catholic Primary School, A Catholic Voluntary Academy",218,14,4,18
Redcar and Cleveland,"Saint Joseph's Catholic Primary School, A Catholic Voluntary Academy",177,11,4,15
Redcar and Cleveland,St Bede's Catholic Primary School,189,14,2,16
Oxfordshire,St Nicholas CofE Primary School,120,25,2,27
Nottinghamshire,St Philip Neri With St Bede Catholic Voluntary Academy,483,24,2,26
North Northamptonshire,Loddington CofE (VA) Primary School,95,15,1,16
North Northamptonshire,Great Addington CofE Primary School,87,4,2,6
North Yorkshire,Roseberry Academy,246,12,6,18
Norfolk,All Saints Academy,93,8,0,8
Norfolk,Clenchwarton Primary School,199,31,4,35
Medway,The Howard School,1508,199,12,211
Medway,Brompton-Westbrook Primary School,450,72,4,76
Leicestershire,Higham-on-the-Hill Church of England Primary School,80,9,0,9
Leicestershire,The Grove Primary School,157,30,6,36
Kirklees,St John Fisher Catholic Voluntary Academy,1053,133,21,154
Kent,St Peter's Catholic Primary School,212,14,5,19
Kent,More Park Catholic Primary School,207,25,2,27
Hampshire,Fawley Infant School,54,4,7,11
Hampshire,Blackfield Primary School,433,57,21,78
East Sussex,Saxon Mount School,158,0,158,158
East Sussex,Torfield School,96,0,96,96
Dudley,St Joseph's RC Primary School,207,20,4,24
Derbyshire,"St Joseph's Catholic Primary School, A Voluntary Academy",238,34,1,35
Calderdale,Sacred Heart Catholic Voluntary Academy,195,20,2,22
Calderdale,"St Malachy's Catholic Primary School, A Voluntary Academy",157,34,8,42
Bromley,St Vincent's Catholic Primary School,211,22,8,30
Bromley,St Philomena's Primary School,204,17,7,24
Blackburn with Darwen,"Darwen, St Barnabas CofE Primary Academy",207,15,0,15
Birmingham,Our Lady of Fatima Catholic Primary School,211,21,2,23
North Lincolnshire,Coritani Academy,7,1,6,7
Staffordshire,St Giles' and St George's Church of England Academy,324,67,8,75
"Herefordshire, County of",The Brookfield School,94,2,92,94
Rotherham,Bramley Grange Primary School,248,12,10,22
Dudley,St Mary's RC Primary School,200,48,6,54
Staffordshire,Landau Forte Academy Tamworth Sixth Form,386,28,4,32
Staffordshire,Pye Green Academy,401,36,14,50
Southampton,Wordsworth Primary School,647,46,23,69
Sheffield,Handsworth Grange Community Sports College,1010,157,27,184
Norfolk,Filby Primary School,123,13,2,15
Kent,St Richard's Catholic Primary School,191,25,4,29
Cumbria,Workington Academy,1187,117,46,163
Cambridgeshire,University of Cambridge Primary School,663,58,23,81
Cheshire East,High Peak School,59,0,59,59
Essex,Maltese Road Primary School,212,24,5,29
Essex,Langham Oaks,77,0,77,77
South Gloucestershire,Lyde Green Primary School,473,23,29,52
Devon,Cranbrook Education Campus,898,103,26,129
Devon,School for Inspiring Talents,62,0,62,62
Central Bedfordshire,OneSchool Global UK - Biggleswade Campus,188,6,3,9
Leeds,St Chad's Church of England Primary School,235,27,2,29
Wakefield,Airedale Infant School,245,30,4,34
Devon,Axminster Community Primary Academy,290,27,5,32
Dorset,Marshwood CofE Primary Academy,59,11,2,13
Devon,Mrs Ethelston's CofE Primary Academy,190,3,3,6
Dorset,Queen Elizabeth's School,1598,217,33,250
Devon,St Andrew's CofE Primary Academy,102,12,1,13
Cornwall,Tintagel Primary School,76,16,0,16
Bromley,St Nicholas Church of England Primary,216,25,3,28
Portsmouth,New Horizons Primary School,540,66,18,84
Portsmouth,Penbridge Junior School,443,50,9,59
Kent,"Our Lady of Hartley Catholic Primary School, Hartley, Longfield",212,30,3,33
Surrey,Pond Meadow School,149,2,147,149
Kent,Dartford Primary Academy,673,79,6,85
Bromley,St Mary's Catholic Primary School,406,43,6,49
Nottinghamshire,Harworth CofE Academy,192,16,0,16
Rotherham,Anston Greenlands Primary School,212,18,2,20
Halton,Widnes Academy,150,21,4,25
Rotherham,Listerdale Junior Academy,372,36,5,41
Derbyshire,Dovedale Primary School,409,48,2,50
Nottinghamshire,Sparken Hill Academy,558,59,7,66
Derbyshire,Sawley Infant and Nursery School,277,48,4,52
Derbyshire,Sawley Junior School,330,59,6,65
Derbyshire,Shardlow Primary School,97,20,0,20
Nottinghamshire,St Mary Magdalene CofE Primary School,203,11,2,13
Suffolk,Burton End Primary Academy,447,49,21,70
Gloucestershire,Minchinhampton Primary Academy,323,50,8,58
Kent,Lansdowne Primary School,397,49,8,57
Havering,Drapers' Maylands Primary School,366,60,8,68
Suffolk,Easton Primary School,78,9,1,10
Suffolk,Wickham Market Primary School,173,24,4,28
Cambridgeshire,St Andrew's CofE Primary School,470,105,18,123
Medway,Peninsula East Primary Academy,248,34,0,34
Suffolk,Leiston Primary School,378,39,7,46
York,OneSchool Global York Campus,122,40,0,40
Lincolnshire,Manor Farm Academy,211,9,4,13
Cheshire East,Church Lawton School,71,0,71,71
Dudley,Impact Independent School,85,14,14,28
Hillingdon,Rosedale Primary School,422,26,5,31
Barnsley,Springwell Special Academy,108,0,108,108
Barnsley,Springwell Alternative Academy,56,32,6,38
Blackburn with Darwen,Tauheedul Islam Girls' High School,885,99,14,113
Bromley,St Joseph's Catholic Primary School,198,19,5,24
Bromley,St Mark's Church of England Primary School,400,35,6,41
Cheshire East,Wistaston Church Lane Academy,412,45,14,59
Derbyshire,Immaculate Conception Catholic Primary,197,23,4,27
Dudley,Ellowes Hall Sports College,1037,131,14,145
Essex,Northwick Park Primary and Nursery Academy,640,68,10,78
Essex,Katherine Semar Junior School,259,24,5,29
Essex,Katherine Semar Infant School,181,13,3,16
Gloucestershire,Hardwicke Parochial Academy,385,45,8,53
Hackney,Northwold Primary School,345,52,7,59
Havering,Drapers' Pyrgo Priory School,408,48,12,60
Kent,Shorne Church of England Primary School,209,12,8,20
Kent,St Botolph's Church of England Primary School,422,51,8,59
Kent,"St Joseph's Catholic Primary School, Northfleet",208,31,5,36
Lincolnshire,The Banovallum School,608,35,45,80
Liverpool,St Silas Church of England Primary School,338,66,10,76
Norfolk,Howard Junior School,195,68,2,70
Norfolk,Mundford Church of England Primary Academy,207,15,4,19
North East Lincolnshire,Sevenhills Academy,21,21,0,21
Nottingham,Radford Primary School Academy,209,25,3,28
Rotherham,Trinity Croft CofE Primary Academy,191,44,5,49
Rotherham,Thrybergh Fullerton Church of England Primary Academy,223,40,2,42
Rotherham,Flanderwell Primary School,394,90,8,98
Rotherham,Aston All Saints CofE (A) Primary School,206,28,3,31
Suffolk,Cliff Lane Primary School,416,61,10,71
Surrey,Ravenscote Junior School,620,72,17,89
Surrey,Whyteleafe Primary School,450,46,16,62
Wakefield,"Holy Family and St Michael's Catholic Primary School, A Voluntary Academy",202,35,7,42
Wakefield,"English Martyrs Catholic Primary School, A Voluntary Academy",207,30,6,36
Warrington,Bridgewater High School,1609,165,49,214
West Sussex,Rose Green Junior School,358,44,5,49
Windsor and Maidenhead,St Luke's CofE Primary School,324,44,18,62
Windsor and Maidenhead,Burchetts Green CofE Infants' School,49,0,1,1
Bradford,Training and Skills Centre,12,0,1,1
Islington,The Bridge Integrated Learning Space,28,0,28,28
Hillingdon,Pentland Field School,161,0,161,161
Calderdale,Riverbank Primary School,16,0,16,16
Birmingham,Green Meadow Primary School,394,65,2,67
Blackpool,Baines' Endowed Church of England Primary Academy,523,102,20,122
Bromley,Midfield Primary School,452,129,28,157
Cheshire West and Chester,Boughton Heath Academy,220,13,2,15
Cornwall,Tywardreath School,311,36,4,40
Hammersmith and Fulham,The Hurlingham Academy,697,59,24,83
South Gloucestershire,Meadowbrook Primary School,374,37,7,44
Wiltshire,The Avenue Primary School and Children's Centre,291,37,36,73
Cheshire West and Chester,Mill View Primary School,240,37,5,42
Cornwall,Antony Church of England School,84,6,0,6
Cumbria,Stanwix School,404,19,7,26
Devon,Kingswear Community Primary School,13,1,2,3
Essex,Woodham Ley Primary School,251,15,12,27
Essex,Thundersley Primary School,443,60,8,68
Hartlepool,West View Primary School,470,109,5,114
Kent,Ursuline College,978,76,15,91
Kent,Stella Maris Catholic Primary School,211,32,6,38
Leicestershire,Townlands Church of England Primary School,334,96,1,97
North East Lincolnshire,Fairfield Academy,311,27,14,41
North Northamptonshire,Brambleside Primary School,412,36,5,41
North Northamptonshire,Our Lady of Walsingham Catholic Primary School,376,39,4,43
North Northamptonshire,St Edward's Catholic Primary School,191,28,2,30
North Northamptonshire,St Thomas More Catholic Primary School,216,14,7,21
Shropshire,Cleobury Mortimer Primary School,266,25,8,33
Shropshire,Clee Hill Community Academy,164,9,1,10
South Gloucestershire,Charborough Road Primary School,284,51,29,80
Suffolk,Thomas Gainsborough School,1576,208,28,236
Suffolk,Pakefield Primary School,363,41,10,51
Wigan,"St John's Church of England Primary School, Abram",273,39,4,43
Wigan,Hindley Green Community Primary School,419,58,7,65
Wigan,"St Peter's Church of England Primary School, Hindley",290,37,5,42
Wigan,"St John's Church of England Primary School, Hindley Green",183,34,4,38
Wiltshire,"St Mark's CofE Junior School, Salisbury",354,48,10,58
Wiltshire,Wyndham Park Infants' School,240,9,9,18
Wiltshire,Exeter House Special School,164,0,164,164
Wolverhampton,Northwood Park Primary School,586,64,11,75
"Kingston upon Hull, City of",St Richard's VC Academy,295,60,7,67
Kent,South Borough Primary School,509,85,7,92
Barking and Dagenham,Thames View Junior School,339,70,7,77
"Bristol, City of",Oasis Academy Brislington,1323,165,66,231
Cheshire East,Peover Superior Endowed Primary School,97,8,2,10
East Sussex,All Saints CofE Junior Academy,220,36,3,39
Essex,Stambridge Primary School,103,3,4,7
Essex,St James Church of England Primary School,197,25,3,28
Essex,Mistley Norman Church of England Primary School,76,12,2,14
Kent,Charlton Church of England Primary School,199,25,7,32
Kent,Lydd Primary School,274,44,2,46
Norfolk,Tuckswood Academy and Nursery,267,47,5,52
Norfolk,Middleton Church of England Primary Academy,48,16,3,19
Norfolk,Swaffham CofE Primary Academy,223,29,7,36
South Gloucestershire,Sir Bernard Lovell Academy,1192,168,19,187
Southwark,Angel Oak Academy,411,26,11,37
Surrey,Highfield South Farnham School,473,122,9,131
Birmingham,Saltley Academy,1305,145,37,182
Birmingham,St Columba's Catholic Primary School,200,24,2,26
Birmingham,St Joseph's Catholic Primary School,208,26,3,29
"Bournemouth, Christchurch and Poole",King's Park Academy,631,51,15,66
Brent,St Andrew and St Francis CofE Primary School,432,31,9,40
Bury,Gorsefield Primary School,338,19,7,26
Derbyshire,St Giles Church of England Primary School,92,16,1,17
Manchester,Harpurhey Alternative Provision School,22,22,0,22
Essex,Roseacres Primary School,217,22,6,28
Barking and Dagenham,The Sydney Russell School,2557,286,50,336
Doncaster,Kirk Sandall Junior School,340,40,8,48
Hammersmith and Fulham,Langford Primary School,289,43,5,48
Hartlepool,Manor Community Academy,1029,160,31,191
Kirklees,Marsden Junior School,180,37,2,39
Kirklees,"Millbridge, A Share Primary Academy",284,68,5,73
Manchester,St James' CofE Primary School Gorton,452,77,29,106
Cambridgeshire,Godmanchester Bridge Academy,208,30,11,41
Norfolk,Peterhouse CofE Primary Academy,427,76,7,83
Sefton,Hillside High School,661,152,15,167
Sefton,Litherland High School,684,119,12,131
Somerset,Castle Primary School,141,10,5,15
Gloucestershire,Hunts Grove Primary Academy,308,26,6,32
Sandwell,Q3 Academy Langley,1307,91,31,122
Telford and Wrekin,Lawley Village Academy,216,16,1,17
Southwark,PhoenixPlace,19,1,18,19
Suffolk,Reydon Primary School,191,27,2,29
Barnsley,Greenacre School,330,0,330,330
"Bristol, City of",Fairfield High School,1073,284,30,314
"Bristol, City of",Four Acres Academy,448,88,9,97
Cambridgeshire,Ely St Mary's CofE Junior School,286,38,12,50
Cornwall,Mevagissey Community Primary School,135,22,0,22
Cornwall,Carclaze Community Primary School,384,42,7,49
Cumbria,Lazonby C of E Primary School,99,12,0,12
Dudley,Ridgewood High School,591,76,16,92
East Sussex,Silverdale Primary Academy,630,49,9,58
Essex,Hatfield Heath Primary School,207,35,5,40
Essex,Waterman Primary Academy,82,13,1,14
Greenwich,St Thomas More Catholic Comprehensive School,636,59,22,81
Hartlepool,West Park Primary School,344,25,0,25
Hillingdon,Ryefield Primary School,437,58,5,63
"Kingston upon Hull, City of",Newland St John's Church of England Academy,251,39,12,51
"Kingston upon Hull, City of",Stockwell Academy,387,72,14,86
Norfolk,St Peter and St Paul Church of England Primary Academy & Nursery,195,36,10,46
North Yorkshire,Richard Taylor Church of England Primary School,277,37,9,46
North Northamptonshire,Ringstead Church of England Primary School,130,17,5,22
West Northamptonshire,St James Church of England Primary School,448,79,10,89
West Northamptonshire,Milton Parochial Primary School,71,10,2,12
West Northamptonshire,Greenfields Specialist School for Communication,94,0,94,94
Oxfordshire,Meadowbrook College,8,5,1,6
Portsmouth,Gatcombe Park Primary School,209,9,6,15
Rotherham,Maltby Lilly Hall Academy,428,44,5,49
Rotherham,Dinnington High School,990,142,21,163
Rotherham,Ravenfield Primary Academy,198,25,1,26
Staffordshire,Castle Primary School,97,1,0,1
Surrey,Esher Church School,342,47,10,57
Waltham Forest,Lime Academy Larkswood,686,41,11,52
Dorset,The Sir John Colfox Academy,854,105,38,143
Suffolk,Dell Primary School,362,48,6,54
Birmingham,Ebn Academy  2,0,0,0,0
Somerset,Buckland St Mary Church of England Primary School,69,3,2,5
Southend-on-Sea,Chase High School,1224,126,33,159
"Bournemouth, Christchurch and Poole",Manorside Academy,399,54,16,70
Warwickshire,St Anne's Catholic Academy,237,36,10,46
Waltham Forest,Walthamstow Primary Academy,173,20,3,23
Devon,South Devon UTC,157,88,13,101
Hackney,Halley House School,222,15,8,23
Brent,Kilburn Grange School,223,23,11,34
Birmingham,Ark Victoria Academy,1584,209,8,217
Kent,Godinton Primary School,419,39,8,47
"Bournemouth, Christchurch and Poole",Ad Astra Infant School,266,61,4,65
Dorset,Allenbourn Middle School,555,63,16,79
Norfolk,Anthony Curton CofE Primary School,204,25,3,28
Tameside,Ashton West End Primary Academy,451,43,12,55
Nottinghamshire,The Sir Donald Bailey Academy,547,75,3,78
Devon,Brayford Academy,36,2,1,3
"Bournemouth, Christchurch and Poole",Canford Heath Infant School,359,55,8,63
"Bournemouth, Christchurch and Poole",Canford Heath Junior School,474,54,10,64
Kingston upon Thames,Castle Hill Primary School,514,90,15,105
Essex,Castledon School,223,0,223,223
Kent,Chilton Primary School,418,27,7,34
Bath and North East Somerset,Clutton Primary School,153,16,3,19
Dorset,Colehill First School,153,5,2,7
Wolverhampton,Corpus Christi Catholic Primary Academy,198,29,5,34
Staffordshire,Dilhorne Endowed CofE  Primary School,46,3,0,3
Rotherham,Dinnington Community Primary School,186,30,10,40
North East Lincolnshire,Elliston Primary Academy,360,56,10,66
Nottinghamshire,Ernehale Junior School,274,39,1,40
Wolverhampton,Field View Primary School,458,74,2,76
Dorset,Frome Valley CofE VA First School,164,44,3,47
Norfolk,Gillingham St Michael's Church of England Primary Academy,56,2,1,3
Staffordshire,Gnosall St Lawrence Coe Primary Academy,266,19,3,22
Norfolk,Gooderstone Church of England Primary Academy,50,9,1,10
Somerset,Hambridge Community Primary School,118,13,2,15
Staffordshire,Haughton St Giles CofE Primary Academy,104,6,0,6
Bromley,Hawes Down Primary School,452,22,48,70
Dorset,Hayeswood First School,149,10,4,14
"Bournemouth, Christchurch and Poole",Haymoor Junior School,361,61,7,68
Rotherham,Herringthorpe Junior School,353,80,7,87
Wolverhampton,Holy Rosary Catholic Primary Academy,205,25,2,27
Somerset,Huish Episcopi Primary School,193,14,4,18
North Northamptonshire,Isebrook School,253,0,253,253
Cheshire East,Ivy Bank Primary School,430,74,23,97
Lincolnshire,Keelby Primary Academy,182,20,3,23
"Bournemouth, Christchurch and Poole",Merley First School,302,16,3,19
Somerset,Middlezoy Primary School,20,2,2,4
Dorset,Milborne St Andrew First School,56,11,2,13
Leeds,Morley Newlands Academy,704,90,4,94
Dorset,Motcombe CofE Primary School,174,15,7,22
Wakefield,Normanton Common Primary Academy,344,39,14,53
Somerset,Oakhill Church School,122,14,2,16
Wolverhampton,Our Lady and St Chad Catholic Academy,1133,150,26,176
Dorset,Piddle Valley Church of England First School,64,4,4,8
Manchester,Piper Hill High School,260,2,258,260
Dorset,Puddletown Church of England First School,137,15,2,17
Wandsworth,Saint Cecilia's Church of England School,1036,202,48,250
Cheshire East,Sandbach Primary Academy,133,24,9,33
Dorset,Shaftesbury Church of England Primary School,354,66,7,73
Cheshire East,"St Alban's Catholic Primary School, A Voluntary Academy",316,35,12,47
Warwickshire,St Benedict's Catholic Primary Academy,187,19,3,22
Sandwell,Shireland Biomedical Utc,215,35,2,37
Northumberland,St Benet Biscop Catholic Academy,1117,140,14,154
Birmingham,St Brigid's Catholic Primary School,449,106,4,110
Oxfordshire,St Christopher's Church of England School,130,19,7,26
Warwickshire,St Francis Catholic  Academy,210,16,11,27
Windsor and Maidenhead,"St Francis Catholic Primary School, South Ascot",207,15,3,18
Suffolk,St Helen's Primary School,447,61,5,66
Birmingham,St James Catholic Primary School,210,17,3,20
Dorset,"St John's Church of England First School, Wimborne",144,25,2,27
Staffordshire,St John's Primary Academy,594,33,9,42
Warwickshire,Our Lady & St. Joseph Catholic Academy,564,66,13,79
Derbyshire,St Laurence CofE  Primary School,182,33,8,41
Wolverhampton,St Martin's Church of England Primary School,263,42,19,61
Cheshire East,Saint Mary's Catholic Primary School,211,7,5,12
Wolverhampton,"St Mary's Catholic Primary School, Wolverhampton",469,60,3,63
Northumberland,St Matthew's Catholic Primary School,145,10,1,11
Dorset,"St Michael's Church of England Middle School, Colehill",604,74,14,88
Birmingham,St Paul's Catholic Primary School,191,39,4,43
Cheshire East,"St Paul's Catholic Primary School, A Voluntary Academy",122,22,4,26
Northumberland,Ss Peter and Paul's Catholic Primary Academy,180,13,1,14
Oxfordshire,"St Peter's Church of England School, Alvescot",99,10,0,10
Birmingham,St Thomas Aquinas Catholic School,1168,146,9,155
Warwickshire,St Thomas More Catholic School and Sixth Form College,1045,69,31,100
Staffordshire,St Werburgh's CE (A) Primary School,153,16,4,20
Blackburn with Darwen,Sudell Primary School,160,39,4,43
Oxfordshire,The Blake Church of England Primary School,353,55,19,74
Essex,The FitzWimarc School,1772,199,26,225
Suffolk,The Oaks Primary School,456,66,7,73
Surrey,The Ridgeway School,110,5,105,110
Windsor and Maidenhead,The Windsor Boys' School,959,135,15,150
Norfolk,Tilney All Saints CofE Primary School,90,8,3,11
Derbyshire,Turnditch Church of England Primary School,82,10,1,11
Devon,Umberleigh Primary Academy,81,6,2,8
Staffordshire,The Valley Primary School,49,6,3,9
Suffolk,The Beeches Community Primary School,368,73,5,78
Derbyshire,William Gilbert Endowed Church of England Primary School,261,33,4,37
Hertfordshire,Windhill21,452,58,10,68
Windsor and Maidenhead,Windsor Girls' School,778,78,6,84
Rotherham,Winterhill School,873,177,13,190
Dorset,Witchampton Church of England First School,60,9,1,10
Warwickshire,Woodloes Primary School,413,65,12,77
Staffordshire,Woodseaves CE Primary Academy,80,15,0,15
Wolverhampton,Manor Primary School,673,84,18,102
Haringey,Footsteps Trust,26,10,5,15
Wakefield,Hall Cliffe School,99,6,93,99
Kingston upon Thames,The Kingston Academy,1176,102,51,153
Lancashire,Cambian Red Rose School,17,1,16,17
Newcastle upon Tyne,Trinity Academy Newcastle,191,1,190,191
Bexley,Lessness Heath Primary School,639,74,12,86
Blackpool,Marton Primary Academy and Nursery,319,89,45,134
East Sussex,St Leonards Church of England Primary Academy,403,53,5,58
Essex,Chigwell Primary Academy,211,18,2,20
Kent,Beaver Green Primary School,480,70,7,77
Leicestershire,Charnwood College,572,111,16,127
Portsmouth,Trafalgar School,971,167,38,205
Sutton,Green Wrythe Primary School,285,58,62,120
Thurrock,Stifford Clays Primary School,663,53,25,78
Wakefield,Normanton Junior Academy,351,53,12,65
Cambridgeshire,Cambian Home Tree School,17,6,11,17
North Yorkshire,Staynor Hall Primary Academy,312,38,8,46
Kent,Finberry Primary School,334,46,17,63
West Berkshire,Highwood Copse Primary School,56,4,0,4
Leeds,Temple Learning Academy,969,242,11,253
Manchester,Dean Trust Ardwick,1292,155,43,198
Reading,Maiden Erlegh School in Reading,892,168,20,188
Bexley,Fairford Academy Barnehurst,588,86,14,100
West Sussex,Blackthorns Community Primary Academy,210,23,5,28
Norfolk,Colkirk Church of England Primary Academy,64,11,3,14
Bromley,Cudham Church of England Primary School,61,15,2,17
Thurrock,Deneholm Primary School,416,38,15,53
Hertfordshire,Fair Field Junior School,228,31,3,34
North Northamptonshire,Finedon Infant School,135,16,1,17
North Northamptonshire,Finedon Mulso Church of England Junior School,178,29,3,32
Rotherham,Greasbrough Primary School,260,52,6,58
Hammersmith and Fulham,Greenside Primary School,229,3,9,12
Leicestershire,Greystoke Primary School,358,60,5,65
Kirklees,"Heaton Avenue, A Share Primary Academy",386,73,5,78
West Sussex,Holmbush Primary Academy,219,41,5,46
Bromley,Holy Innocents Catholic Primary School,215,20,8,28
York,Huntington Primary Academy,384,56,3,59
North Northamptonshire,Irthlingborough Nursery and Infant School,325,52,5,57
North Northamptonshire,Irthlingborough Junior School,381,64,9,73
Wiltshire,Oare Church of England Primary School,64,7,1,8
Wiltshire,Ogbourne CofE Primary School,90,13,0,13
York,Poppleton Ousebank Primary School,451,44,10,54
Bolton,Prestolee Primary School,258,13,7,20
Leicester,Rushey Mead Academy,1683,169,23,192
Barnsley,Sandhill Primary School,231,24,8,32
Norfolk,Sculthorpe Church of England Primary Academy,50,9,0,9
Wiltshire,Seend Church of England Primary School,102,19,5,24
West Northamptonshire,Simon de Senlis Primary School,432,38,29,67
Sandwell,St Francis Xavier Catholic Primary School,223,25,6,31
Sandwell,St Gregory's Catholic Primary School,258,21,10,31
Newham,St Helen's Catholic Primary School,474,41,19,60
Sandwell,Our Lady and St Hubert's Catholic Primary School,418,38,10,48
Newham,St Joachim's Catholic  Primary School,337,53,13,66
Sandwell,St Philip's Catholic Primary School,232,32,4,36
North Yorkshire,Stokesley School,1116,106,18,124
Kensington and Chelsea,The Cardinal Vaughan Memorial RC School,1033,99,39,138
East Riding of Yorkshire,Withernsea Primary School,496,63,23,86
Cheshire East,The Fermain Academy,7,0,2,2
Warwickshire,Rugby Free Primary School,421,67,8,75
Liverpool,Rice Lane Primary School and Nursery,646,86,21,107
Coventry,Sidney Stringer Primary Academy,419,73,17,90
Coventry,Finham Park 2,666,132,17,149
Leeds,Elliott Hudson College,1061,176,8,184
Bolton,University Collegiate School,491,69,6,75
Essex,Grove House School,118,0,118,118
Essex,The Ongar Academy,597,76,29,105
Norfolk,The Fen Rivers Academy,58,1,57,58
Cambridgeshire,Ermine Street Church Academy,243,23,10,33
Essex,Camulos Academy,412,29,4,33
Oxfordshire,Longford Park Primary School,236,48,11,59
Darlington,Oakwood Learning Centre,15,3,12,15
Devon,Trinity Church of England Voluntary Aided Primary and Nursery School,371,59,6,65
Kensington and Chelsea,Parkwood Hall Co-Operative Academy,119,0,119,119
Liverpool,Dovedale Community Primary School,825,141,12,153
Wakefield,"Fairburn View Primary School, Castleford",481,110,16,126
Richmond upon Thames,Turing House School,841,179,27,206
Rutland,Harington School,338,10,2,12
Manchester,Unity Community Primary,325,45,11,56
Manchester,West Didsbury CE Primary School,410,40,14,54
Salford,Manchester Senior Girls School,146,10,3,13
Birmingham,"Eden Boys' School, Birmingham",615,98,10,108
Slough,"Eden Girls' School, Slough",614,49,14,63
Lancashire,"Eden Boys' School, Preston",616,54,2,56
Barnsley,Elsecar Holy Trinity CofE Primary Academy,174,21,2,23
Barnsley,Hoyland Springwood Primary School,140,13,30,43
Barnsley,Laithes Primary School,327,49,14,63
Bexley,Burnt Oak Junior School,245,39,5,44
Birmingham,Manor Park Primary Academy,394,42,2,44
Cumbria,Ambleside CofE Primary School,80,7,3,10
Dudley,The Bromley-Pensnett Primary School,288,58,14,72
Halton,"St Augustine's Catholic Primary School, A Voluntary Academy",129,33,3,36
Lancashire,Great Marsden St John's Primary School A Church of England Academy,207,23,9,32
North Northamptonshire,Hazel Leys Academy,238,34,6,40
Suffolk,Phoenix St Peter Academy,143,34,5,39
Suffolk,St Margaret's Primary Academy,422,75,5,80
Suffolk,Sprites Primary Academy,333,37,5,42
Sunderland,Sandhill View Academy,733,153,12,165
Wiltshire,The Trinity Church of England Primary Academy,195,37,5,42
Wiltshire,Marden Vale CofE Academy,163,56,22,78
Bromley,Bromley Beacon Academy,163,0,163,163
Norfolk,Horsford CofE VA Primary School,320,44,11,55
Coventry,Cardinal Wiseman Catholic School,1357,196,10,206
Cumbria,George Hastwell School Special Academy,87,0,87,87
Derbyshire,Longdon Park School,65,0,65,65
Cumbria,Yewdale School,294,42,5,47
County Durham,Shield Row Primary School,153,28,0,28
County Durham,Dene House Primary School,263,46,6,52
County Durham,South Hetton Primary,217,27,4,31
Essex,Winter Gardens Academy,419,41,12,53
Essex,Iceni Academy,195,32,7,39
Essex,Cherry Tree Academy,141,29,4,33
Kirklees,Orchard Primary Academy,414,91,18,109
Leeds,Holy Name Catholic Voluntary Academy,201,19,1,20
Norfolk,Lingwood Primary Academy,221,46,6,52
South Gloucestershire,Mangotsfield School,1094,118,26,144
Surrey,Hoe Valley School,743,130,33,163
Worcestershire,Cotswold Spa Hospital School,6,0,0,0
Richmond upon Thames,Deer Park School,329,21,4,25
Staffordshire,Ivetsey Bank Hospital School,34,6,6,12
Staffordshire,Silkmore Primary Academy,199,36,2,38
Staffordshire,The Orme Academy,760,82,10,92
Suffolk,Northfield St Nicholas Primary Academy,359,62,9,71
Suffolk,Beccles Primary Academy,185,27,8,35
Suffolk,Martlesham Primary Academy,125,12,1,13
Surrey,Salfords Primary School,396,41,7,48
Warwickshire,St Michael's Church of England Academy,440,78,16,94
Warwickshire,St Oswald's CofE Academy,204,13,8,21
North Yorkshire,"St Stephen's Catholic Primary School and Nursery, A Voluntary Academy",158,27,1,28
Oxfordshire,The Bicester School,1283,181,10,191
Suffolk,St Christopher's CEVCP School,323,48,1,49
Suffolk,"Tudor Church of England Primary School, Sudbury",229,45,5,50
Suffolk,Great Heath Academy,583,97,15,112
Wigan,Canon Sharples Church of England Primary School and Nursery,340,67,11,78
Bolton,Bowness Primary School,123,26,2,28
Bradford,Beckfoot Upper Heaton,723,218,23,241
"Bristol, City of",Woodlands Academy,164,19,2,21
Bromley,Mead Road Infant School,77,15,3,18
Cambridgeshire,St Mary's Church of England Primary School St Neots,96,21,7,28
Cambridgeshire,The Netherhall School,1192,106,28,134
Central Bedfordshire,Lancot School,455,24,25,49
Cheshire East,Nantwich Primary Academy,182,40,11,51
Cornwall,Delaware Primary Academy,172,14,9,23
Coventry,Whittle Academy,244,44,6,50
Croydon,Orchard Park High School,633,91,16,107
Derby,Firs Primary School,443,69,5,74
Derbyshire,St Philip Howard Catholic Voluntary Academy,593,86,12,98
Derbyshire,Inkersall Spencer Academy,368,33,5,38
Devon,Brixington Primary Academy,364,57,19,76
Devon,St Peter's Church of England (VA) Junior School,124,13,5,18
Dorset,Loders CofE Primary Academy,67,11,3,14
Dudley,Beechwood Church of England Primary School,206,41,3,44
Essex,Takeley Primary School,349,44,8,52
Havering,Lime Academy Forest Approach,133,0,133,133
Hertfordshire,Haileybury Turnford,868,77,21,98
Kent,Istead Rise Primary School,243,21,5,26
Lancashire,Coal Clough Academy,100,38,9,47
Lancashire,Castercliff Primary School,382,43,6,49
Leeds,Bruntcliffe Academy,1273,153,11,164
Norfolk,Marshland St James Primary and Nursery School,104,16,3,19
Norfolk,Sewell Park Academy,716,131,26,157
Norfolk,Hewett Academy,317,59,22,81
North Northamptonshire,Danesholme Junior Academy,346,38,7,45
North Northamptonshire,Prince William School,1304,179,14,193
North Northamptonshire,St Brendan's Catholic Primary School,297,18,7,25
Windsor and Maidenhead,Forest Bridge School,107,0,107,107
Telford and Wrekin,Holy Trinity Academy,835,88,11,99
Wiltshire,Fountain House Education Suite,4,1,3,4
Buckinghamshire,The Chalfonts Independent Grammar School,143,33,1,34
Nottinghamshire,Beeston Fields Primary School and Nursery,356,45,0,45
Birmingham,The Edge Academy,2,0,2,2
Reading,Ranikhet Academy,238,43,10,53
Salford,Irlam and Cadishead Academy,682,175,16,191
Sheffield,Wisewood Community Primary School,160,36,5,41
Solihull,Lyndon School,1187,179,15,194
Southampton,Tanners Brook Primary School,408,55,9,64
Staffordshire,Knutton St Marys CofE Academy,195,50,0,50
South Gloucestershire,Digitech Studio School,583,150,27,177
Wolverhampton,The Khalsa Academy Wolverhampton,767,112,4,116
Surrey,The Weald CofE Primary School,131,21,11,32
Surrey,Brookwood Primary School,167,24,10,34
Telford and Wrekin,Kickstart Academy,34,21,0,21
Wolverhampton,Pine Green Academy,96,0,96,96
Blackburn with Darwen,Pleckgate High School,1335,155,17,172
West Sussex,The Burgess Hill Academy,1068,86,9,95
Southwark,The Belham Primary School,401,57,7,64
Nottinghamshire,Bilsthorpe Flying High Academy,214,34,1,35
Nottinghamshire,St Joseph's Catholic Primary and Nursery School,213,39,2,41
Staffordshire,Saxon Hill Academy,135,0,135,135
Staffordshire,The Howard Primary School,61,8,0,8
Staffordshire,The Richard Crosse CofE Primary School,111,12,2,14
Staffordshire,The St. Mary's CofE Primary School,92,8,3,11
"Bournemouth, Christchurch and Poole",Bethany Church of England Junior School,374,78,6,84
"Bournemouth, Christchurch and Poole",Heathlands Primary Academy,191,47,6,53
"Bournemouth, Christchurch and Poole",St Clement's and St John's Church of England Infant School,238,31,6,37
"Bournemouth, Christchurch and Poole",St Luke's Church of England Primary School,432,67,3,70
Oxfordshire,Matthew Arnold School,1314,177,24,201
Cumbria,Braithwaite CofE Primary School,34,5,4,9
Stockton-on-Tees,Wynyard Church of England Primary School,465,19,5,24
Derby,Akaal Primary School,211,28,5,33
Ealing,Ark Byron Primary Academy,415,47,9,56
Hackney,Hackney New Primary School,332,27,10,37
North Northamptonshire,Hayfield Cross CofE School,415,33,5,38
Barnet,Watling Park School,382,57,7,64
Birmingham,Oscott Academy,20,0,10,10
Kent,Ramsgate Arts Primary School,355,47,15,62
Somerset,The Mendip School,160,3,148,151
East Riding of Yorkshire,Hunsley Primary,209,24,8,32
Reading,The WREN School,994,118,22,140
Richmond upon Thames,Twickenham Primary Academy,396,48,7,55
Wolverhampton,Wolverhampton Vocational Training Centre,54,0,54,54
Devon,Atrium Studio School,0,0,0,0
Bath and North East Somerset,Somerset Studio School,133,32,14,46
Hounslow,Space Studio West London,199,29,6,35
Bath and North East Somerset,IKB Academy,146,26,4,30
North Lincolnshire,Engineering UTC Northern Lincolnshire,251,65,2,67
Barking and Dagenham,Riverside Primary School,290,27,6,33
Barking and Dagenham,Riverside Bridge School,162,0,162,162
East Riding of Yorkshire,The Hub School,122,13,85,98
Lincolnshire,Aegir - A Specialist Academy,129,0,129,129
Medway,All Saints Church of England Primary School,353,65,3,68
North Yorkshire,All Saints Church of England School,70,9,2,11
Rotherham,Springwood Junior Academy,229,34,4,38
Oxfordshire,Bampton CofE Primary School,199,49,3,52
West Sussex,Barnham Primary School,295,47,19,66
Shropshire,Bitterley CofE Primary School (Aided),107,11,3,14
East Sussex,College Central,47,33,7,40
Cornwall,Connor Downs Academy,207,27,2,29
Dorset,Corfe Castle Church of England Primary School,64,6,4,10
East Sussex,Cuckmere House School,88,0,88,88
North Yorkshire,St Peter's Church of England Primary School,272,33,7,40
Warwickshire,Leamington Hastings Church of England Academy,31,5,2,7
"Kingston upon Hull, City of",Malet Lambert,1633,220,32,252
East Sussex,New Horizons School (Part of the Sabden Multi Academy Trust),94,0,94,94
Oxfordshire,North Leigh Church of England School,181,12,3,15
Shropshire,Oldbury Wells School,791,89,11,100
St. Helens,St Ann's Church of England Primary School,415,37,5,42
Wakefield,St Austin's Catholic Primary School,316,24,4,28
Kent,"St John's Catholic Primary School, Gravesend",886,67,5,72
Medway,St John's Church of England Infant School,46,11,0,11
Nottinghamshire,"St. Joseph's Catholic Primary School, a Voluntary Academy",212,16,4,20
North Yorkshire,"St Joseph's Catholic Primary School, Harrogate, A Voluntary Academy",201,9,2,11
Medway,St Margaret's Church of England Junior School,364,61,2,63
St. Helens,St Mary & St Thomas' CofE Primary School,224,84,9,93
Kent,"St Mary's Catholic Primary School, Whitstable",374,25,9,34
East Sussex,St Mary's School,82,0,82,82
Devon,St Rumon's Church of England (VC) Infants School,82,11,1,12
Dorset,Swanage St Mark's Church of England Primary School,155,35,6,41
Wokingham,Waingels,1376,80,25,105
Dorset,Wareham St Mary Church of England Primary School,182,29,7,36
Lincolnshire,Warren Wood - A Specialist Academy,115,0,115,115
Staffordshire,Cicely Haughton School,58,0,58,58
Staffordshire,Loxley Hall School,99,1,98,99
Slough,The Langley Academy Primary,684,75,11,86
Darlington,Polam Hall School,787,116,22,138
Blackpool,Blackpool Gateway Academy,358,100,9,109
North Yorkshire,"St Mary's Primary School Knaresborough, A Voluntary Catholic Academy",189,18,7,25
Sutton,Avenue Primary Academy,1047,69,65,134
Southwark,The Charter School East Dulwich,1156,124,39,163
Wokingham,Bohunt School Wokingham,1222,137,27,164
Wokingham,Floreat Montague Park Primary School,464,64,10,74
Devon,St Andrew's Primary School,365,64,22,86
North Northamptonshire,Danesholme Infant Academy,220,19,3,22
Stoke-on-Trent,Ormiston Meridian Academy,1041,159,25,184
Suffolk,Gunton Primary Academy,330,27,2,29
Kent,Langley Park Primary Academy,451,25,27,52
North Yorkshire,Askwith Community Primary School,104,5,2,7
Oxfordshire,Bishop Carpenter Church of England Primary School,89,8,1,9
Staffordshire,Blessed Mother Teresa's Catholic Primary School,152,17,1,18
Staffordshire,Blessed William Howard Catholic School,900,119,12,131
Staffordshire,Sun Academy Bradwell,182,30,2,32
Coventry,Corpus Christi Catholic School,442,60,8,68
Cumbria,Fairfield Primary School,438,39,11,50
Coventry,Good Shepherd Catholic School,236,43,4,47
North Yorkshire,"Harrogate, Bilton Grange Primary School",315,57,4,61
Oxfordshire,Hornton Primary School,100,10,2,12
North Yorkshire,Lothersdale Primary School,112,7,3,10
Warwickshire,North Leamington School,1447,162,31,193
Birmingham,Northfield Manor Primary Academy,412,53,13,66
North Yorkshire,Oatlands Community Junior School,356,34,3,37
Coventry,Sacred Heart Catholic Primary School,452,80,8,88
Oxfordshire,Sibford Gower Endowed Primary School,110,13,2,15
Stoke-on-Trent,Smallthorne Primary Academy,220,36,6,42
Staffordshire,St Anne's Catholic Primary School,197,18,1,19
Staffordshire,St Austin's Catholic Primary School and Nursery,184,18,0,18
Staffordshire,St Dominic's Catholic Primary School,204,19,2,21
Coventry,St Gregory's Catholic Primary School,220,27,1,28
Coventry,St John Fisher Catholic Primary School,456,58,4,62
Staffordshire,St John's Catholic Primary School,51,5,0,5
Staffordshire,St Mary's Catholic Primary School,98,10,0,10
Coventry,St Patrick's Catholic Primary School,235,43,6,49
Staffordshire,St Patrick's Catholic Primary School,203,13,2,15
Coventry,SS Peter and Paul Catholic Primary School,207,36,2,38
Oxfordshire,The Warriner School,1546,175,45,220
Birmingham,Waverley School,1750,233,68,301
North Yorkshire,Western Primary School,499,46,14,60
Hertfordshire,Watford St John's Church of England Primary School,346,30,3,33
Nottingham,Fernwood Primary School,1117,80,8,88
Manchester,Manchester Vocational and Learning Academy,27,0,3,3
Stockport,Broadstones School,18,0,18,18
Croydon,St. Mary's Catholic Junior School,232,24,7,31
Bath and North East Somerset,St John's Church of England Primary School,210,14,7,21
Bexley,Old Bexley Church of England School,754,24,22,46
Bexley,Holy Trinity Lamorbey Church of England School,305,37,7,44
Birmingham,Prince Albert Junior and Infant School,691,122,10,132
Birmingham,Heathfield Primary School,472,129,6,135
Bolton,Sharples School,1198,85,36,121
Bromley,Ravensworth Primary School,286,92,13,105
Bromley,Oaklands Primary Academy,525,74,6,80
Cheshire East,The Berkeley Academy,474,25,11,36
Cheshire East,Willaston Primary Academy,264,33,9,42
Cheshire East,Shavington Academy,857,66,26,92
Cornwall,Pensans Community Primary School,177,42,8,50
Cornwall,Fowey Primary School,152,19,2,21
Cornwall,Alverton Primary School,416,39,4,43
Cornwall,Lostwithiel School,175,22,1,23
Cornwall,St Agnes Academy,359,37,5,42
Cornwall,Newlyn School,129,26,3,29
Coventry,Walsgrave Church of England Academy,455,38,8,46
Coventry,Clifford Bridge Academy,443,44,5,49
Croydon,St Mary's Catholic Infant School,212,25,3,28
Cumbria,Victoria Academy,203,25,6,31
Cumbria,Yarlside Academy,246,14,5,19
Cumbria,Parkside Academy,296,63,11,74
Devon,Membury Primary Academy,11,4,0,4
Devon,All Saints Marsh CofE Academy,98,20,2,22
Essex,Latchingdon Church of England Voluntary Controlled Primary School,136,24,2,26
Essex,Henry Moore Primary School,557,55,8,63
Essex,Maylandsea Primary School,244,21,11,32
Hackney,Mossbourne Parkside Academy,405,67,15,82
Hammersmith and Fulham,Thomas's Academy,219,20,14,34
Hertfordshire,Hailey Hall School,78,0,78,78
"Kingston upon Hull, City of",The Sullivan Centre,24,3,20,23
"Kingston upon Hull, City of",Whitehouse Pupil Referral Unit,4,3,0,3
"Kingston upon Hull, City of",Bridgeview Special School,62,0,62,62
Leicestershire,Little Hill Primary,414,48,10,58
Lincolnshire,King Edward VI Grammar School,960,73,7,80
Luton,St Margaret of Scotland Catholic Primary School,415,59,5,64
Luton,St Martin De Porres Catholic Primary School,421,42,12,54
Manchester,Didsbury CofE Primary School,238,19,11,30
Medway,Danecourt School,238,0,238,238
Newham,Upton Cross Primary School,725,75,20,95
North East Lincolnshire,Springfield Primary Academy,350,7,4,11
North East Lincolnshire,Enfield Academy of New Waltham,170,28,5,33
North Northamptonshire,Pytchley Endowed Church of England Primary School,74,14,0,14
Oldham,East Crompton St George's CofE School,178,23,6,29
Redcar and Cleveland,St Benedict's Catholic Primary School,397,41,2,43
Redcar and Cleveland,Sacred Heart Catholic Secondary,716,84,20,104
Sheffield,Nether Edge Primary School,458,46,10,56
Staffordshire,Manifold Church of England Primary School,50,6,1,7
Staffordshire,Hollinsclough Church of England Academy,30,6,0,6
Staffordshire,Newcastle Academy,384,42,7,49
Staffordshire,Clayton Hall Academy,832,68,7,75
Stockton-on-Tees,"Christ The King Roman Catholic Primary School, A Voluntary Catholic Academy",363,49,5,54
Stockton-on-Tees,"St Therese of Lisieux Catholic Primary School, A Voluntary Catholic Academy",241,12,2,14
Stockton-on-Tees,"St Patrick's Catholic College, A Voluntary Catholic Academy",513,43,14,57
Stockton-on-Tees,"St. Patrick's Roman Catholic Primary School, A Voluntary Catholic Academy",414,51,12,63
Suffolk,One Sixth Form College,2117,382,115,497
Surrey,The Bishop David Brown School,748,143,25,168
Telford and Wrekin,The Telford Priory School,1067,199,23,222
Tameside,Manor Green Primary Academy,366,65,6,71
Torbay,Warberry CofE Academy,465,25,8,33
Trafford,Manor Academy Sale,203,0,203,203
Trafford,Pictor Academy,127,12,115,127
West Sussex,Pound Hill Infant Academy,261,45,3,48
West Sussex,Lindfield Primary Academy,658,101,9,110
Wiltshire,Somerfords' Walter Powell CofE Academy,56,16,0,16
Wiltshire,Lydiard Millicent CofE Primary School,181,18,4,22
Bexley,St Paulinus Church of England Primary School,210,28,6,34
Bexley,Hillsgrove Primary School,372,16,18,34
Bolton,Little Lever School,1049,169,29,198
Bromley,Oak Lodge Primary School,575,59,13,72
Bromley,Marian Vian Primary School,606,51,6,57
Bromley,Unicorn Primary School,428,36,18,54
Bromley,Wickham Common Primary School,418,55,11,66
Cheshire West and Chester,The Russett School,124,0,124,124
Cornwall,Shortlanesend School,162,23,3,26
Cornwall,Mithian School,99,11,4,15
Cornwall,Blackwater Community Primary School,126,20,4,24
Cumbria,Cockermouth School,1322,150,60,210
"Kingston upon Hull, City of",Thorpepark Academy,563,91,10,101
Lincolnshire,St Lawrence School,180,0,180,180
Lincolnshire,St Bernard's School,95,0,95,95
Luton,Cardinal Newman Catholic School A Specialist Science College,1649,154,50,204
Sheffield,Hallam Primary School,631,66,11,77
Shropshire,Stottesdon CofE Primary School,121,7,2,9
Staffordshire,Kingsmead School,1365,154,10,164
Surrey,Heathside School,1269,128,19,147
Surrey,Oxted School,1714,217,49,266
Wiltshire,Bradon Forest School,909,123,19,142
Wolverhampton,Highfields School,1690,259,46,305
Wiltshire,Seagry Church of England Primary School,69,11,2,13
Bracknell Forest,"St Margaret Clitherow Catholic Primary School, Bracknell",204,28,7,35
Barnsley,Park House School,18,0,18,18
Wiltshire,Ridgeway Farm CofE Academy,215,21,7,28
Milton Keynes,Cambian Bletchley Park School,49,0,49,49
Buckinghamshire,Dagnall VA Church of England School,57,12,1,13
Calderdale,Stafford Hall School,11,0,11,11
Windsor and Maidenhead,Taplow Manor School,34,4,10,14
Somerset,Kingfisher Primary School,260,14,7,21
Somerset,Primrose Lane Primary School,243,16,4,20
Brent,Lycee International De Londres,840,165,1,166
Kirklees,Cambridge Street School,109,0,0,0
Cheshire West and Chester,Jefferson House,6,5,1,6
Lancashire,Austen House,1,0,1,1
Barking and Dagenham,Northstar New School,24,0,24,24
Wiltshire,Marlborough St Mary's CE Primary School,389,43,22,65
Westminster,Wetherby Senior School,419,115,1,116
Birmingham,Riverside Education,98,23,69,92
Coventry,Barr's Hill School and Community College,928,199,18,217
Bolton,Bolton Muslim Girls School,687,35,10,45
Oxfordshire,Burford Primary School,144,20,2,22
South Gloucestershire,Callicroft Primary School,404,72,12,84
Manchester,Chorlton Park Primary,688,95,17,112
Middlesbrough,Corpus Christi RC Primary School,271,48,2,50
Surrey,Cross Farm Infant Academy,133,14,5,19
Kent,Culverstone Green Primary School,212,29,5,34
Kent,Dymchurch Primary School,159,25,4,29
Nottinghamshire,Edwalton Primary School,413,23,3,26
Wolverhampton,Elston Hall Primary School,705,75,9,84
Oxfordshire,Finstock Church of England Primary School,33,6,0,6
Barnsley,High View Primary Learning Centre,456,94,21,115
"Bournemouth, Christchurch and Poole",Hill View Primary School,599,48,7,55
Birmingham,Jervoise School,200,42,3,45
"Bournemouth, Christchurch and Poole",Malmesbury Park Primary School,697,78,25,103
Dudley,Manor Way Primary Academy,209,32,4,36
Surrey,Mytchett Primary & Nursery Academy,252,18,3,21
Windsor and Maidenhead,Newlands Girls' School,1156,54,18,72
Birmingham,Nonsuch Primary School,195,39,3,42
Wakefield,Lee Brigg Infant and Nursery School,163,15,0,15
Manchester,Old Moat Primary School,393,46,23,69
Torbay,Oldway Primary School,687,85,26,111
Oxfordshire,Queen Emma's Primary School,220,25,9,34
Kent,Riverview Infant School,330,36,4,40
Torbay,Roselands Primary School,330,30,11,41
Middlesbrough,Sacred Heart Primary School,332,19,4,23
Surrey,Sandringham Infant & Nursery Academy,226,19,5,24
Middlesbrough,St Alphonsus' Catholic Primary School,236,22,1,23
Middlesbrough,St Augustine's Catholic Primary School,230,29,2,31
Middlesbrough,St Bernadette's Catholic Primary School,228,13,4,17
Middlesbrough,St Clare's RC Primary School,234,15,1,16
Middlesbrough,St Edward's Catholic Primary School,425,36,4,40
Kent,St Georges CofE (Aided) Primary School,393,45,8,53
Middlesbrough,St Gerard's RC Primary School,158,28,4,32
Middlesbrough,St Joseph's Catholic Primary School,376,30,4,34
Birmingham,St Thomas CofE Academy,236,27,4,31
Middlesbrough,St Thomas More RC Primary School,200,20,7,27
Oxfordshire,The Batt Church of England Primary School,326,32,13,45
Cambridgeshire,Olive Ap Academy - Cambridge,1,0,0,0
Croydon,The Crescent Primary School,402,59,9,68
Surrey,The Grove Primary Academy,424,34,27,61
West Sussex,Orchards Junior School,509,164,32,196
Middlesbrough,Trinity Catholic College,1355,198,21,219
Wolverhampton,Westcroft School,188,0,188,188
Oxfordshire,Wolvercote Primary School,337,49,10,59
Barnsley,Wombwell Park Street Primary School,342,41,12,53
Birmingham,Wychall Primary School,367,97,4,101
Bedford,Kempston Academy,733,69,40,109
Birmingham,Cockshut Hill School,962,182,6,188
Cornwall,St Stephen Churchtown Academy,292,79,15,94
Devon,Westcliff Primary Academy,374,36,15,51
"Kingston upon Hull, City of",The Marvell College,1236,164,36,200
Lincolnshire,Somercotes Academy,467,91,21,112
Medway,Twydall Primary School and Nursery,304,82,10,92
Medway,Temple Mill Primary School,247,19,7,26
Norfolk,Dereham Church of England Junior Academy,413,49,13,62
Norfolk,Marshland High School,806,130,27,157
Peterborough,Eyrescroft Primary School,285,46,8,54
Sutton,Cheam Common Junior Academy,504,47,6,53
Medway,Byron Primary School,520,88,6,94
North Northamptonshire,Ecton Village Primary School,70,12,1,13
Rutland,Cottesmore Academy,138,26,2,28
Somerset,Bishops Lydeard Church School,139,15,4,19
Bromley,Worsley Bridge Primary School,367,58,8,66
Derbyshire,David Nieper Academy,765,146,27,173
Kirklees,Upper Batley High School,770,157,13,170
Camden,Ecole Jeannine Manuel,596,29,0,29
Oxfordshire,William Morris Primary School,202,40,11,51
Leicestershire,Fossebrook Primary School,205,16,3,19
Medway,Manorway Independent School,19,0,19,19
Oldham,Northmoor Academy,407,67,7,74
Surrey,Lakeside Nursery & Primary Academy,390,61,12,73
Surrey,Wemms Education Centre,99,2,97,99
Kirklees,Oak CofE Primary School,490,104,12,116
Kirklees,Castle Hill: A Specialist College for Communication and Interaction,127,1,126,127
Staffordshire,Christ Church CofE First School,139,13,3,16
Staffordshire,Colwich CofE Primary School,119,6,2,8
Leeds,East Ardsley Primary Academy,469,56,1,57
Cambridgeshire,Elm Road Primary School,208,23,3,26
Oldham,Freehold Community Academy,475,65,14,79
Surrey,Hammond School,302,39,14,53
Leeds,Hill Top Primary Academy,233,21,3,24
"Bournemouth, Christchurch and Poole",Kingsleigh Primary School,838,149,22,171
Kent,Kingsnorth Church of England Primary School,420,70,5,75
Buckinghamshire,Lent Rise School,446,54,8,62
Surrey,Lightwater Village School,147,8,4,12
Gloucestershire,Longney Church of England Primary Academy,92,17,1,18
"Bournemouth, Christchurch and Poole",Moordown St John's Church of England Primary School,420,75,11,86
"Bournemouth, Christchurch and Poole",Muscliff Primary School,594,90,15,105
Manchester,Newall Green Primary School,644,126,31,157
Gloucestershire,North Cerney Church of England Primary Academy,56,13,1,14
Staffordshire,Oulton CofE First School,81,3,0,3
"Kingston upon Hull, City of",Pearson Primary School,222,32,6,38
Cheshire East,Shavington Primary School,437,45,20,65
Staffordshire,St Andrew's CofE Primary School,158,12,1,13
Plymouth,St Edward's CofE Primary School,224,53,5,58
Cornwall,St Just Primary School,187,16,3,19
"Bournemouth, Christchurch and Poole",St Mark's Church of England Primary School,418,53,10,63
"Bournemouth, Christchurch and Poole",St Michael's Church of England Primary School,627,97,13,110
Staffordshire,St Peter's CofE Primary School,184,12,2,14
Worcestershire,Tenbury CofE Primary School,243,22,2,24
Oxfordshire,Tower Hill Community Primary School,216,41,9,50
Leeds,Victoria Primary Academy,411,128,1,129
Gloucestershire,Whiteshill Primary School,102,15,2,17
Leeds,Westerton Primary Academy,703,83,8,91
"Bournemouth, Christchurch and Poole",Winton Primary School,839,99,11,110
Redbridge,Al-Noor Voluntary Aided Muslim Primary School,360,22,5,27
Lewisham,St Winifred's RC Primary School,401,73,10,83
Nottinghamshire,Haddon Primary and Nursery School,216,19,2,21
Darlington,Northwood Primary School,394,56,7,63
Doncaster,Morley Place Academy,296,49,5,54
Norfolk,Sporle Church of England Primary Academy,71,17,2,19
Norfolk,Narborough Church of England Primary Academy,87,10,2,12
Norfolk,Castle Acre Church of England Primary Academy,61,15,5,20
Norfolk,Southery Academy,90,20,5,25
Blackpool,Highfield Leadership Academy,563,106,10,116
Oldham,Lyndhurst Primary and Nursery School,468,63,14,77
County Durham,Delta Independent School,57,13,5,18
West Northamptonshire,Northampton International Academy,2056,232,22,254
Middlesbrough,River Tees High Academy,52,1,6,7
Redbridge,Avanti Court Primary School,657,26,10,36
Surrey,"Christ's College, Guildford",669,113,19,132
North Somerset,Court-De-Wyck Church School,139,10,2,12
Wakefield,Crofton Infant School,203,24,3,27
Cornwall,Gunnislake Primary Academy,13,3,2,5
North Yorkshire,New Park Primary Academy,185,23,3,26
Cambridgeshire,Millfield Primary School,353,68,7,75
Tameside,Moorside Primary School,442,65,5,70
Dorset,Oakhurst Community First School,179,29,1,30
Manchester,Old Hall Drive Academy,471,71,14,85
Middlesbrough,River Tees Middle Academy,49,4,7,11
Dorset,Sixpenny Handley First School and Nursery,97,17,1,18
Dorset,St Ives Primary & Nursery School,258,30,4,34
Dorset,"St James' Church of England First School and Nursery, Alderholt",97,10,2,12
Nottinghamshire,St John's CofE Academy,454,41,0,41
Oxfordshire,St Mary's Church of England Infant School,80,7,1,8
Stockport,The Kingsway School,1332,126,56,182
Lincolnshire,Woodlands Academy,63,0,63,63
Middlesbrough,River Tees Primary Academy,4,1,1,2
Dorset,Three Legged Cross First and Nursery School,110,18,2,20
Cheshire East,Upton Priory School,333,33,12,45
Dorset,"West Moors, St Mary's Church of England Voluntary Controlled First School",162,13,2,15
Staffordshire,The Haven School,38,0,38,38
Kent,Cherry Orchard Primary Academy,446,28,22,50
Liverpool,St Oswald's Catholic Primary School,633,115,7,122
Stockport,North West Hospital School,40,15,10,25
Norfolk,Hilgay Riverside Academy,54,14,2,16
Norfolk,Ten Mile Bank Riverside Academy,28,3,1,4
Blackburn with Darwen,Lower Pastures,3,0,1,1
Enfield,North London Hospital School,6,1,1,2
Bolton,TLG Bolton,7,5,2,7
Stockport,Reddish Hall School,112,0,112,112
Essex,Chelmsford Hospital School,11,10,1,11
Nottinghamshire,REAL Alternative Provision School,54,0,54,54
Swindon,Ruskin Junior School,331,47,18,65
Devon,Bideford College,1430,299,57,356
Worcestershire,Abbeywood First School,306,45,2,47
Sheffield,Beck Primary School,734,127,19,146
Worcestershire,Church Hill Middle School,404,77,10,87
Rutland,Edith Weston Academy,84,14,10,24
Plymouth,Ernesettle Community School,555,97,6,103
Swindon,Ferndale Primary School & Nursery,489,51,18,69
Suffolk,Great Barton Church of England Primary Academy,201,19,2,21
Nottinghamshire,Greythorn Primary School,311,23,3,26
Cornwall,Kehelland Village School,82,7,0,7
Oldham,Mayfield Primary School,331,64,8,72
Cornwall,North Petherwin School,72,8,1,9
Knowsley,Park View Academy,372,46,7,53
Cornwall,Perranporth Community Primary School,211,20,0,20
Suffolk,Rattlesden Church of England Primary Academy,120,15,0,15
Medway,Rivermead School,181,0,181,181
Barnsley,Royston St John Baptist CE Primary,190,8,3,11
Cambridgeshire,Spring Common Academy,207,0,207,207
Harrow,St Bernadette's Catholic Primary School,451,48,13,61
Devon,St David's CofE Primary School,100,13,8,21
Brent,St Gregory's Catholic Science College,1168,115,33,148
Cheshire East,Marlborough Primary School,386,35,21,56
Suffolk,Thurston Church of England Primary Academy,306,52,3,55
North Somerset,Trinity Anglican-Methodist Primary School,439,40,6,46
Cornwall,Werrington Community Primary School,57,14,1,15
Suffolk,Woolpit Primary Academy,117,16,5,21
Medway,The GFC School,28,12,16,28
"Bristol, City of",Snowdon Village,57,36,21,57
Birmingham,Highfield Junior and Infant School,715,207,4,211
Hackney,Talmud Torah London,105,44,6,50
Kirklees,"Woodside Green, A Share Primary Academy",138,31,3,34
Shropshire,Buildwas Academy,94,16,3,19
Windsor and Maidenhead,Eton Porny CofE First School,148,10,2,12
Bracknell Forest,The Brakenhale School,1164,188,40,228
Somerset,Nunney First School,74,7,2,9
Suffolk,Elm Tree Primary School,305,44,12,56
Warwickshire,Stratford-Upon-Avon Primary School,215,27,6,33
Bradford,High Crags Primary Leadership Academy,390,49,15,64
Bromley,Burnt Ash Primary School,430,82,27,109
Leeds,Cockburn School,1273,202,16,218
Bexley,Eastcote Primary Academy,234,21,3,24
Croydon,Good Shepherd Catholic Primary and Nursery School,212,33,2,35
Norfolk,Great Witchingham Church of England Primary Academy,70,8,2,10
Norfolk,Hockering Church of England Primary Academy,44,8,0,8
Bradford,Immanuel College,1668,242,29,271
Kent,Manor Community Primary School,670,48,12,60
North Yorkshire,Oatlands Infant School,253,23,1,24
North Yorkshire,Pannal Primary School,434,32,13,45
Walsall,Pool Hayes Academy,1064,49,23,72
Suffolk,Sproughton Church of England Primary School,103,14,1,15
Devon,St Leonard's (CofE) Primary School (VC),603,48,11,59
Suffolk,"St Mary's Church of England Primary School, Hadleigh",168,29,6,35
Suffolk,"St Mary's Church of England Primary School, Woodbridge",198,21,1,22
Norfolk,"St Peter's CofE Primary Academy, Easton",183,16,3,19
Sheffield,"St Thomas More Catholic Primary, A Voluntary Academy",208,28,1,29
South Tyneside,St Wilfrid's RC College,1328,164,14,178
Portsmouth,Westover Primary School,220,21,6,27
Wolverhampton,Bow Street School,10,0,10,10
Leeds,University Technical College Leeds,425,37,6,43
Sheffield,UTC Sheffield Olympic Legacy Park,436,45,6,51
Slough,Haybrook College,137,45,92,137
Buckinghamshire,Beechview Academy,174,36,8,44
Croydon,John Wood School & Nursery,292,29,9,38
East Sussex,Sir Henry Fermor Church of England Primary School,386,63,6,69
Essex,Ramsden Hall Academy,95,0,95,95
Kent,Westgate Primary School,210,23,0,23
Croydon,The Write Time,42,0,42,42
Birmingham,Woodbourne Hospital School,10,9,1,10
Cambridgeshire,Glebe House,11,1,10,11
Barnet,Menorah High School for Girls,389,61,8,69
Leeds,Ebor Gardens Primary Academy,421,82,3,85
Leeds,Springwell Leeds Academy,304,0,304,304
Leicester,Humberstone Infant Academy,306,21,2,23
Newham,Portway Primary School,536,35,9,44
Norfolk,The Bishop's Church of England Primary Academy,378,68,9,77
Norfolk,Henderson Green Primary School,190,59,10,69
Rutland,The Shires at Oakham,14,0,14,14
Barnet,Claremont Primary School,327,32,27,59
York,Scarcroft Primary School,387,47,4,51
Cambridgeshire,Gamlingay Village Primary,390,40,23,63
Devon,Stoke Gabriel Primary School,106,11,4,15
Stoke-on-Trent,Kingsland CofE Academy,476,101,5,106
Devon,Landscove Church of England Primary School,88,4,2,6
Stoke-on-Trent,New Ford Academy,467,33,10,43
Stoke-on-Trent,Packmoor Ormiston Academy,440,51,8,59
Newham,Sarah Bonnell School,1323,97,28,125
Oxfordshire,Brize Norton Primary School,135,16,1,17
York,Millthorpe School,1078,168,21,189
Devon,Bearnes Voluntary Primary School,95,34,4,38
West Northamptonshire,Towcester Church of England Primary School,364,74,7,81
North Northamptonshire,Weldon Church of England Primary School,203,24,0,24
Devon,Diptford Parochial Church of England Primary School,78,7,0,7
Ealing,Ealing Fields High School,705,48,22,70
Staffordshire,Evergreen,7,3,4,7
Leicestershire,Wolfdale School,44,0,44,44
North Northamptonshire,Cottingham CofE Primary School Academy Trust,135,8,2,10
Cornwall,Gerrans School,70,4,1,5
Sheffield,Hucklow Primary School,521,94,21,115
Oxfordshire,"St James Church of England Primary School, Hanney",211,24,6,30
Lincolnshire,Boston Endeavour Academy,128,0,128,128
Lincolnshire,Tulip Academy,210,1,209,210
Cornwall,Tregony Community Primary School,180,17,0,17
Torbay,Upton St James CofE Primary School,95,25,3,28
Devon,Kingsteignton School,201,27,7,34
"Bournemouth, Christchurch and Poole",Twynham Primary School,219,30,5,35
Luton,Active Support Education Centre,71,47,24,71
Wakefield,Hall Cliffe Primary School,34,0,34,34
Bury,Excel and Exceed Centre,26,13,13,26
Leicestershire,Wigston Menphys Nursery School,54,45,8,53
Leicestershire,"Sketchley Hill Menphys Nursery School, Burbage",56,51,5,56
Wolverhampton,Dunstall Hill Primary School,475,48,9,57
Wolverhampton,Grove Primary Academy,451,47,5,52
Bradford,Laisterdyke Leadership Academy,881,202,10,212
Reading,New Town Primary School,423,64,13,77
Southend-on-Sea,Porters Grange Primary School and Nursery,415,70,6,76
Wolverhampton,Palmers Cross Primary School,229,11,20,31
Birmingham,Aston Tower Community Primary School,397,97,3,100
Kingston upon Thames,Bedelsford School,129,9,120,129
Plymouth,Boringdon Primary School,403,33,5,38
Kent,Brenchley and Matfield Church of England Primary School,196,16,3,19
Dorset,Bridport Primary School,324,63,14,77
Dorset,"Bridport, St Mary's Church of England Primary School",209,70,27,97
Dorset,Burton Bradstock Church of England Voluntary Controlled School,91,16,1,17
Cumbria,Castle Park School,305,47,5,52
Bromley,Chelsfield Primary School,96,22,3,25
Buckinghamshire,Chiltern Way Academy,230,0,230,230
Staffordshire,Churnet View Middle School,470,64,18,82
Bromley,Darrick Wood Junior School,380,78,15,93
Kingston upon Thames,Dysart School,161,2,159,161
Barking and Dagenham,Eastbury Primary School,802,138,22,160
Coventry,Finham Primary School,453,33,4,37
Tameside,Flowery Field Primary School,661,96,10,106
Bolton,Forwards Centre,30,6,22,28
Brent,Furness Primary School,340,65,8,73
Tameside,Godley Community Primary Academy,235,32,4,36
Telford and Wrekin,Grange Park Primary School,480,155,8,163
Worcestershire,Great Witley CofE Primary School,192,18,6,24
Devon,Harbertonford Church of England Primary School,108,9,3,12
Newham,Hartley Primary School,664,49,12,61
Devon,Hennock Community Primary School,70,11,0,11
Derbyshire,John Flamsteed Community School,863,32,12,44
Staffordshire,Leek High School,317,30,8,38
Cornwall,Luxulyan School,103,9,2,11
Waltham Forest,Mayville Primary School,354,40,15,55
Cheshire East,Monks Coppenhall Academy,598,92,22,114
Bath and North East Somerset,Moorlands Infant School,180,21,2,23
Bath and North East Somerset,Moorlands Junior School,210,29,8,37
Tameside,Oakfield Primary and Moderate Learning Difficulties Resource Provision,245,52,31,83
Brent,Oakington Manor Primary School,671,100,51,151
Bolton,Park School Teaching Service,6,2,4,6
Bromley,Pratts Bottom Primary School,77,9,3,12
Havering,Lime Academy Ravensbourne,75,4,71,75
Bexley,Royal Park Primary Academy,375,47,21,68
Leicestershire,"Saint Peter's Catholic Primary School, A Voluntary Academy",200,15,4,19
Nottinghamshire,Selston High School,863,110,16,126
Newham,Selwyn Primary School,473,71,23,94
Enfield,Southgate School,1451,108,28,136
Oxfordshire,Southwold Primary School,343,55,30,85
Croydon,St Aidan's Catholic Primary School,219,12,1,13
Norfolk,"St Augustine's Catholic Primary School, Costessey",337,56,4,60
Croydon,St Chad's Catholic Primary School,299,66,7,73
Norfolk,St Francis of Assisi Catholic Primary School,419,75,9,84
West Northamptonshire,St Gregory's Catholic Primary School,258,42,1,43
Stockton-on-Tees,St John the Evangelist Catholic Primary School,166,24,2,26
Reading,St John's Church of England Primary School,437,76,9,85
Stockton-on-Tees,St Joseph's Catholic Primary School,194,19,6,25
Norfolk,St Mary and St Peter Catholic Primary School,223,36,7,43
West Northamptonshire,St Mary's Catholic Primary School,199,11,7,18
Stockton-on-Tees,St Paul's Catholic Primary School,227,17,3,20
Kingston upon Thames,St Philip's School,178,0,178,178
Derbyshire,Swanwick Hall School,1131,175,22,197
West Northamptonshire,The Good Shepherd Catholic Primary School,296,17,5,22
Bromley,The Highway Primary School,216,29,8,37
East Sussex,The Lindfield School,111,0,111,111
East Sussex,The South Downs School,144,12,132,144
West Northamptonshire,Thomas Becket Catholic School,872,92,11,103
Staffordshire,Thomas Russell Infants School,181,14,3,17
Sheffield,Tinsley Meadows Primary School,659,96,8,104
Sutton,Victor Seymour Infants' School,327,17,2,19
Norfolk,Walpole Cross Keys Primary School,53,5,3,8
Derby,Walter Evans Church of England Aided Primary School,457,21,7,28
Southend-on-Sea,West Leigh Junior School,525,32,6,38
Bath and North East Somerset,Weston All Saints CofE Primary School,519,33,12,45
Staffordshire,Westwood College,779,48,10,58
Cheshire East,Wheelock Primary School,337,40,9,49
Nottinghamshire,Worksop Priory Church of England Primary Academy,225,30,2,32
Bolton,Youth Challenge Pru,67,35,10,45
Suffolk,Benjamin Britten Academy of Music and Mathematics,1250,246,23,269
York,Knavesmire Primary School,471,31,10,41
Bradford,Tong Leadership Academy,853,163,13,176
Manchester,Co-op Academy North Manchester,1182,197,51,248
Devon,Highgate Hill House School,40,0,40,40
Lincolnshire,Spilsby Primary School,224,27,9,36
Walsall,Lodge Farm Primary School,411,40,7,47
Bolton,Lever Park School,88,0,88,88
Rotherham,Abbey School,212,0,212,212
Staffordshire,Horninglow Primary: A de Ferrers Trust Academy,206,36,4,40
Suffolk,St Edmund's Catholic Primary School,89,14,0,14
Essex,Magna Carta Primary Academy,205,12,4,16
Barnet,Ashmole Primary School,422,30,18,48
Kirklees,Beaumont Primary Academy,682,119,13,132
Essex,St Osyth Church of England Primary School,304,46,6,52
Cambridgeshire,Landmark International School,100,21,3,24
Leicestershire,ASPIRE: Lifeskills,23,0,23,23
"Bristol, City of",Venturers' Academy,242,1,241,242
Hounslow,Logic Studio School,276,31,9,40
Trafford,The Orchards,125,14,111,125
West Northamptonshire,Daventry Hill School,205,0,205,205
Bradford,Broadbeck Learning Centre,14,0,12,12
Telford and Wrekin,Dawley Church of England Primary Academy,233,30,3,33
Suffolk,St Benet's Catholic Primary School,78,15,2,17
Leicester,Uplands Junior L.E.A.D Academy,479,36,8,44
Plymouth,Woodford Primary School,420,35,3,38
Cornwall,Chacewater Community Primary School,187,24,3,27
Windsor and Maidenhead,Dedworth Green First School,173,19,4,23
Windsor and Maidenhead,Dedworth Middle School,521,99,18,117
Staffordshire,Eton Park Junior: A de Ferrers Trust Academy,215,42,10,52
Cambridgeshire,Olive Ap Academy - Nene Valley,1,1,0,1
Birmingham,Gossey Lane Academy,199,41,1,42
Rotherham,Hilltop School,134,0,134,134
Rotherham,Kelford School,135,0,135,135
Knowsley,The Prescot School,855,161,22,183
Staffordshire,Lansdowne: A de Ferrers Trust Academy,152,24,2,26
Somerset,Minehead First School,298,23,8,31
Suffolk,Parkside Academy,0,0,0,0
Devon,St Gabriel's CofE Primary School,165,34,7,41
Devon,Shaldon Primary School,211,18,2,20
Cornwall,St Catherine's CofE Primary School,233,28,4,32
Devon,St James School,986,226,45,271
Suffolk,St Mary's Roman Catholic Primary School,192,20,2,22
Cornwall,Threemilestone School,429,65,6,71
Suffolk,Westbridge Academy,0,0,0,0
Staffordshire,Yoxall St Peter's CofE Primary School,130,9,0,9
Cambridgeshire,Wisbech St Mary CofE Academy,181,33,2,35
Cambridgeshire,Guilden Morden CofE Primary Academy,73,8,3,11
Derbyshire,Somercotes Infant and Nursery School,132,18,2,20
Essex,Templars Academy,401,73,5,78
Kent,St Nicholas Church of England Primary Academy,396,64,6,70
Medway,Cedar Children's Academy,668,80,11,91
Norfolk,Valley Primary Academy,176,64,12,76
Somerset,St Michael's Church of England First School,148,25,3,28
Suffolk,Olive Ap - Academy Suffolk,11,1,10,11
Telford and Wrekin,Charlton School,1216,150,14,164
West Berkshire,John O'Gaunt School,429,51,17,68
Wolverhampton,Bushbury Lane Academy,227,33,5,38
Bradford,Westminster Church of England Primary Academy,538,59,12,71
Bradford,Buttershaw Business & Enterprise College Academy,1461,231,51,282
Derbyshire,St Joseph's Catholic Voluntary Academy,126,28,2,30
North East Lincolnshire,Best Futures,9,0,9,9
Brent,New Level Academy,14,5,2,7
Worcestershire,Bridge School Malvern,60,0,60,60
Kent,Woodlands Primary School,643,42,11,53
Plymouth,ACE Schools Plymouth,221,21,106,127
Bradford,Barkerend Primary Leadership Academy,587,96,7,103
Norfolk,Cawston Church of England Primary Academy,157,24,1,25
York,Badger Hill Primary Academy,191,11,5,16
Derbyshire,Darley Churchtown Church of England Primary School,61,13,1,14
Norfolk,Firside Junior School,357,30,7,37
North East Lincolnshire,Great Coates Primary School,318,20,3,23
Norfolk,Heacham Junior School,107,19,5,24
Staffordshire,Hempstalls Primary School,416,45,9,54
York,Hempland Primary School,425,21,9,30
York,Heworth Church of England Primary School,141,15,4,19
Windsor and Maidenhead,Holyport CofE Primary School,229,32,7,39
Buckinghamshire,Ickford School,137,12,0,12
Leicester,Knighton Mead Primary Academy,235,38,11,49
Plymouth,Montpelier Primary School,654,61,9,70
Cornwall,Mount Charles School,363,65,10,75
North Yorkshire,North Rigton Church of England Primary School,99,14,1,15
Norfolk,Rudham CofE Primary Academy,86,17,2,19
North Somerset,St Katherine's School,1000,159,22,181
Norfolk,Weasenham Church of England Primary Academy,41,12,1,13
Lancashire,West Craven High School,678,90,9,99
Leicester,Willowbrook Mead Primary Academy,457,57,8,65
Birmingham,Yew Tree Community Junior and Infant School (NC),485,112,4,116
Kent,The Llewellyn School and Nursery,20,0,20,20
Croydon,Krishna Avanti Primary School,195,10,4,14
Hertfordshire,Yavneh Primary School,422,49,5,54
Harrow,Pinner High School,1100,94,61,155
Lancashire,"The Olive School, Preston",422,39,10,49
West Northamptonshire,Wootton Park School,1366,202,24,226
Norfolk,Charles Darwin Primary School,409,52,8,60
Enfield,One Degree Academy,282,32,7,39
Southwark,Galleywall Primary School,380,58,10,68
Tower Hamlets,Canary Wharf College 3,454,60,32,92
Warwickshire,Rugby Free Secondary School,976,164,24,188
Sunderland,Beacon of Light School,0,0,0,0
Norfolk,Great Yarmouth Charter Academy,894,63,19,82
North Yorkshire,Scarborough University Technical College,190,24,5,29
Havering,Concordia Academy,415,30,9,39
Devon,Westclyst Community Primary School,522,71,6,77
Hillingdon,Global Academy,380,52,12,64
Birmingham,"The Olive School, Birmingham",632,80,4,84
Hounslow,Edison Primary School,407,40,4,44
Cheshire East,Crewe Engineering and Design UTC,218,28,2,30
Liverpool,LIPA Sixth Form College,371,83,10,93
Manchester,Pioneer House High School,129,0,129,129
County Durham,UTC South Durham,429,98,9,107
Redbridge,Atam Academy,945,74,10,84
Bromley,Langley Park Primary School,399,28,10,38
Bolton,"The Olive School, Bolton",420,32,7,39
Warrington,UTC Warrington,249,56,7,63
Solihull,WMG Academy for Young Engineers (Solihull),439,102,9,111
Peterborough,Greater Peterborough UTC,437,49,6,55
Newham,London Design and Engineering UTC,730,36,7,43
Harrow,Saint Jerome Church of England Bilingual School,390,56,6,62
Lambeth,South Bank UTC,204,13,5,18
Hampshire,The Eaglewood School,24,1,23,24
Milton Keynes,Whitehouse Primary School,628,78,16,94
Barking and Dagenham,Greatfields School,967,146,11,157
North Yorkshire,Cambian Spring Hill,27,0,27,27
Sheffield,Phoenix School of Therapeutic Education,30,24,6,30
Bolton,Bishop Bridgeman CofE Primary School,461,69,8,77
Kent,Barming Primary School,467,45,4,49
West Northamptonshire,The Spires Academy,43,27,14,41
Lambeth,Vanguard School,59,0,59,59
Nottingham,FUEL,29,14,2,16
Blackburn with Darwen,Dar Ul Madinah,24,0,0,0
Cambridgeshire,Riverside Meadows Academy,77,0,77,77
Doncaster,Edenthorpe Hall Primary Academy,204,37,2,39
Essex,Shalford Primary School,64,7,2,9
Manchester,St Wilfrid's CofE Aided Primary School Northenden,339,33,11,44
Sheffield,Lower Meadow Primary School,297,78,21,99
Southend-on-Sea,Victory Park Academy,43,41,0,41
Leicestershire,The Place Independent School,31,0,31,31
Southend-on-Sea,Sutton House Academy,64,0,64,64
Bath and North East Somerset,Welton Primary School,179,23,8,31
Bath and North East Somerset,Longvernal Primary School,192,35,9,44
Bath and North East Somerset,Combe Down CofE Primary School,409,37,20,57
Bolton,"St James CofE Primary School, Farnworth",358,49,12,61
Bradford,St John the Evangelist Catholic Primary School,197,35,4,39
Bradford,Oxenhope CofE Primary School,201,13,3,16
Bradford,"St Walburga's Catholic Primary School, A Voluntary Academy",237,29,10,39
Bradford,Oakworth Primary School,442,34,1,35
Bradford,Haworth Primary School,310,18,14,32
Bradford,Lees Primary School,227,23,5,28
Bradford,"St Winefride's Catholic Primary School, A Voluntary Academy",415,43,10,53
Cornwall,Roche Community Primary School,205,59,4,63
Cornwall,Polperro Primary Academy,118,17,2,19
Cornwall,Lanlivery Primary Academy,58,10,3,13
Cornwall,Pelynt Primary Academy,107,13,5,18
Cornwall,Darite Primary Academy,63,3,1,4
Cornwall,St Erth Community Primary School,106,17,1,18
Cornwall,Beacon ACE Academy,426,101,26,127
Cornwall,Polruan Primary Academy,24,7,0,7
Coventry,Lyng Hall School,908,151,13,164
Darlington,High Coniscliffe CofE Primary School,101,9,1,10
Darlington,St Mary's Cockerton Church of England Primary School,191,39,3,42
Dorset,Trent Young's CofE Primary School,142,25,1,26
Dudley,Colley Lane Primary Academy,525,68,11,79
Hartlepool,Brougham Primary School,319,61,7,68
Havering,Drapers' Brookside Infant School,225,40,5,45
Leicester,Thurnby Mead Primary Academy,251,23,19,42
Norfolk,Greenpark Academy,311,37,15,52
North East Lincolnshire,Littlecoates Primary Academy,189,53,2,55
"Bournemouth, Christchurch and Poole",Lilliput Church of England Infant School,347,17,1,18
"Bournemouth, Christchurch and Poole",Old Town Infant School and Nursery,201,22,3,25
"Bournemouth, Christchurch and Poole",Courthill Infant School,346,44,5,49
"Bournemouth, Christchurch and Poole",Longfleet Church of England Primary School,623,90,4,94
"Bournemouth, Christchurch and Poole",Baden-Powell and St Peter's Church of England Junior School,720,46,9,55
"Bournemouth, Christchurch and Poole",Oakdale Junior School,437,49,6,55
Rotherham,High Greave Junior School,190,58,6,64
Rotherham,High Greave Infant School,110,50,1,51
Rotherham,Catcliffe Primary School,139,32,7,39
Solihull,Streetsbrook Infant and Early Years Academy,221,22,9,31
Staffordshire,Codsall Middle School,509,43,9,52
Staffordshire,Barnfields Primary School,402,49,2,51
Staffordshire,St Peter's Church of England Primary Academy,147,5,3,8
Staffordshire,Sir Graham Balfour High School,962,168,21,189
Staffordshire,Ellison Primary Academy,365,47,4,51
Staffordshire,Leasowes Primary School,428,30,4,34
Staffordshire,St Nicholas Church of England First School,311,31,7,38
Staffordshire,Walton High School,1312,98,16,114
Stoke-on-Trent,Summerbank Primary Academy,448,109,6,115
Stoke-on-Trent,Park Hall Academy,477,43,6,49
Stoke-on-Trent,Ash Green Primary Academy,460,25,10,35
Stoke-on-Trent,Gladstone Primary Academy,465,64,10,74
Stoke-on-Trent,Goldenhill Primary Academy,224,21,6,27
Suffolk,Laureate Community Academy,248,35,4,39
Suffolk,Nacton Church of England Primary School,94,13,2,15
Suffolk,Wickhambrook Primary Academy,198,22,2,24
Sunderland,Burnside Academy Inspires,139,47,4,51
Sunderland,Fatfield Academy,214,36,5,41
Surrey,Eastwick Infant School,212,12,27,39
Surrey,Eastwick Junior School,375,37,32,69
Surrey,Cuddington Community Primary School,206,27,19,46
Surrey,Wallace Fields Infant School and Nursery,244,23,6,29
Wakefield,Sharlston Community School,302,70,10,80
Wiltshire,Durrington All Saints Church of England Voluntary Controlled Infants' School,142,19,0,19
Wiltshire,Avon Valley Academy,441,62,15,77
Wiltshire,St Michael's Church of England Primary School,444,85,10,95
Wiltshire,Bulford St Leonard's C of E (VA) Primary School,176,41,3,44
Wiltshire,Keevil CofE Primary School,86,15,0,15
Bath and North East Somerset,Widcombe Infant School,181,14,2,16
Cheshire East,Gorsey Bank Primary School,414,52,10,62
Stoke-on-Trent,Greenways Primary Academy,231,13,1,14
Swindon,Brimble Hill Special School,114,0,114,114
Swindon,Uplands School,155,0,155,155
Nottingham,Bulwell St Mary's Primary and Nursery School,235,21,1,22
Cornwall,Nancledra School,106,11,1,12
Gloucestershire,Wotton House International School Gloucestershire,86,8,12,20
Islington,"City of London Primary Academy, Islington",265,16,2,18
North Somerset,St John the Evangelist Church School,272,20,6,26
Richmond upon Thames,The Richmond upon Thames School,748,108,20,128
North Northamptonshire,Compass Primary Academy,423,88,9,97
Bolton,Raise Education and Wellbeing School,53,17,30,47
Bolton,Red Lane Primary School,480,102,14,116
Bolton,Masefield Primary School,260,46,8,54
Bradford,St Joseph's Catholic Primary School,323,38,14,52
Bromley,Clare House Primary School,417,33,13,46
East Sussex,St Paul's Church of England Academy,654,111,3,114
East Sussex,St Catherine's College,1077,88,10,98
Enfield,Alternative Centre of Education,37,4,13,17
Barnet,St Anthony's School for Girls,94,11,0,11
Sandwell,Sandwell Valley School,79,17,12,29
Birmingham,Blackwater Academy,22,0,3,3
Birmingham,Imedia School,9,0,0,0
Lancashire,Hope School,2,0,1,1
Oxfordshire,Cherwell College Oxford,63,0,12,12
Brighton and Hove,Kings Brighton,141,5,3,8
Hammersmith and Fulham,Azbuka Russian-English Bilingual School,49,2,0,2
North Tyneside,Hopespring Newcastle,7,2,5,7
Suffolk,Bramfield Church of England Primary School,90,9,3,12
Solihull,Damson Wood Nursery and Infant School,190,21,5,26
Sheffield,Abbeyfield Primary Academy,442,86,11,97
Norfolk,Reepham Primary School,213,28,8,36
Rotherham,Aston Hall Junior and Infant School,302,24,6,30
Rotherham,Aston Lodge Primary School,182,30,2,32
Suffolk,Bardwell Church of England Primary School,63,13,1,14
Rotherham,Brinsworth Whitehill Primary School,278,54,15,69
Warrington,Bruche Primary School Academy,248,18,1,19
Salford,Buile Hill Academy,926,175,35,210
Nottingham,Burford Primary and Nursery School,234,34,1,35
Sheffield,Byron Wood Primary Academy,428,84,8,92
Salford,Chatsworth High School and Community College,169,4,165,169
Stockton-on-Tees,Egglescliffe School,1525,184,30,214
Warrington,Evelyn Street Primary Academy and Nursery,345,28,3,31
Suffolk,Gislingham Church of England Primary School,150,17,1,18
Norfolk,Glebeland Community Primary School,65,7,2,9
Plymouth,Glen Park Primary School,407,56,0,56
Stockton-on-Tees,Junction Farm Primary School,378,28,16,44
Suffolk,Mendham Primary School,72,9,1,10
Suffolk,Old Newton Church of England  Primary School,86,16,1,17
Suffolk,Palgrave Church of England Primary School,86,8,0,8
Warrington,Penketh Primary School,213,27,2,29
Kent,Priory Fields School,365,120,4,124
Suffolk,St Edmund's Primary School,71,11,4,15
Kent,St Martin's School,194,32,1,33
North Northamptonshire,Stanwick Academy,197,15,2,17
Stockton-on-Tees,The Links Primary School,189,15,7,22
Wakefield,Towngate Primary Academy,274,47,7,54
Greenwich,Windrush Primary School,811,159,23,182
Barnet,Bishop Douglass School Finchley,1020,127,7,134
Bath and North East Somerset,Saltford CofE Primary School,430,40,18,58
Bedford,Harrold Primary Academy,116,4,3,7
Bexley,Chatsworth Infant School,207,7,3,10
Birmingham,Conway Primary School,435,59,8,67
Birmingham,The Oval School,655,95,6,101
Birmingham,Cedars Academy,338,62,5,67
Birmingham,Firs Primary School,347,53,7,60
Birmingham,Greet Primary School,845,141,12,153
Birmingham,Topcliffe Primary School,256,34,57,91
Bradford,Beckfoot Allerton Primary School and Nursery,425,80,8,88
Bradford,Horton Grange Primary School,729,133,9,142
Bradford,Beckfoot Heaton Primary,789,204,12,216
Bradford,Horton Park Primary School,432,125,18,143
Bradford,Copthorne Primary School,526,82,10,92
Bromley,"St George's, Bickley, Church of England Primary School",396,46,7,53
Cornwall,St Uny CofE Academy,230,28,1,29
North Somerset,St Mark's Ecumenical Anglican/Methodist Primary School,414,25,3,28
Wolverhampton,"The Royal School, Wolverhampton",1468,184,49,233
Wakefield,TLG Wakefield,8,0,2,2
Hackney,The Boxing Academy AP Free School,9,0,9,9
Trafford,North Cestrian School,757,51,33,84
Coventry,The National Mathematics and Science College,110,6,0,6
Worcestershire,Gloverspiece School,25,0,25,25
Barnsley,Oakwell Rise Primary Academy,230,47,13,60
Bath and North East Somerset,St Martin's Garden Primary School,201,44,40,84
Bromley,Red Hill Primary School,686,94,18,112
Cambridgeshire,Highfield Ely Academy,135,0,135,135
Bradford,Beckfoot Oakbank,1560,260,29,289
Bradford,Beckfoot Thornton,1344,205,44,249
Calderdale,Park Lane Academy,436,147,29,176
Cumbria,Longtown Primary School,188,18,3,21
Ealing,Woodlands Academy,194,19,15,34
East Sussex,Hawkes Farm Academy,372,28,5,33
East Sussex,Breakwater Academy,164,30,3,33
Essex,Sir Martin Frobisher Academy,172,54,5,59
Essex,Maldon Primary School,186,40,4,44
Essex,Lubbins Park Primary Academy,201,25,5,30
Essex,Larkrise Primary School,198,36,5,41
Essex,Northlands Primary School and Nursery,704,101,20,121
Essex,Whitmore Primary School and Nursery,653,81,14,95
Essex,Ryedene Primary and Nursery School,363,83,4,87
Essex,The Phoenix Primary School,695,73,22,95
Hammersmith and Fulham,Phoenix Academy,532,69,16,85
Havering,Olive Ap Academy - Havering,11,9,0,9
Hertfordshire,Robert Barclay Academy,707,106,24,130
Lincolnshire,Theddlethorpe Academy,92,15,4,19
Merton,Beecholme Primary School,178,19,4,23
Norfolk,Old Buckenham Primary School and Nursery,205,34,5,39
North Somerset,St Georges Church School,242,37,7,44
North Somerset,Worle Community School,1348,134,26,160
North Yorkshire,Brayton Academy,778,109,10,119
North Yorkshire,Camblesforth Community Primary Academy,100,11,1,12
Nottinghamshire,The Parkgate Academy,371,36,4,40
Rotherham,Swinton Academy,978,144,30,174
Shropshire,St Martins School (3-16 Learning Community),682,138,11,149
Somerset,Minerva Primary School,133,27,9,36
Southend-on-Sea,Southchurch High School,794,111,18,129
Stockton-on-Tees,Rosebrook Primary School,468,65,22,87
Stockton-on-Tees,Outwood Academy Bishopsgarth,562,126,40,166
Suffolk,Long Melford Church of England Primary School,227,19,3,22
Thurrock,Chadwell St Mary Primary School,208,21,9,30
Wolverhampton,Evergreen Academy,22,19,3,22
Wolverhampton,Hill Avenue Academy,354,32,6,38
Wolverhampton,East Park Academy,697,65,12,77
Cheshire East,Underwood West Academy,415,86,15,101
Cheshire East,Adlington Primary School,87,5,1,6
Cheshire East,Bunbury Aldersey CofE Primary School,193,20,2,22
Cheshire East,The Wilmslow Academy,374,27,14,41
Cheshire East,Calveley Primary Academy,92,7,4,11
Cheshire East,St Oswald's Worleston CofE Primary School,114,10,6,16
Cheshire East,Acton Church of England Primary Academy,171,15,3,18
Cheshire East,Highfields Academy,254,16,9,25
Cheshire West and Chester,Victoria Road Primary School,144,30,5,35
Cornwall,Bugle School,181,30,5,35
Cornwall,Curnow School,100,0,100,100
Cornwall,Nancealverne School,94,0,94,94
Cornwall,Constantine Primary School,193,21,7,28
Cornwall,Trevisker Primary School,174,19,2,21
Cornwall,Mabe Community Primary School,185,26,2,28
Cornwall,Probus Primary School,207,34,6,40
Cornwall,The Bishops CofE Learning Academy,372,62,7,69
Cornwall,Doubletrees School,97,2,95,97
Birmingham,Newbury Independent School,14,2,12,14
Wandsworth,Nightingale Community Academy,120,0,120,120
Cornwall,Biscovey Nursery and Infants' Academy,182,26,3,29
Coventry,Stanton Bridge Primary School,431,66,3,69
Croydon,Woodside Primary School,541,59,11,70
Derbyshire,Barrow Hill Primary Academy,94,16,5,21
Derbyshire,Christ Church CofE Primary School,172,26,1,27
Devon,Musbury Primary School,42,8,5,13
Devon,Sidmouth Church of England (VA) Primary School,557,100,25,125
Devon,Tidcombe Primary School,196,22,5,27
Devon,Lady Modiford's Church of England Primary School,45,8,1,9
Devon,All Saints Church of England Primary School,109,15,1,16
Devon,Hawkchurch Church of England School,28,4,0,4
Devon,Alphington Primary School,472,60,13,73
Devon,Ide Primary School,152,17,2,19
Devon,Beer Church of England Primary School,98,14,2,16
Devon,St Thomas Primary School,198,32,8,40
Devon,Meavy Church of England Primary School,89,5,1,6
Devon,Bowhill Primary School,494,87,17,104
Doncaster,Hexthorpe Primary School,429,64,4,68
Dudley,Tenterfields Primary Academy,230,36,4,40
Dudley,Hob Green Primary School,242,32,25,57
Enfield,Edmonton County School,1816,215,46,261
Enfield,Hazelbury Primary School,1097,188,31,219
Enfield,Lavender Primary School,500,39,28,67
Enfield,Chesterfield Primary School,551,80,31,111
Enfield,Bowes Primary School,502,54,22,76
Enfield,Brimsdown Primary School,548,39,45,84
Essex,Bardfield Academy,467,53,12,65
Essex,Richard de Clare Community Academy,359,49,7,56
Essex,Merrylands Primary School,514,20,15,35
Essex,The Willows Primary School,684,34,15,49
Gloucestershire,Berkeley Primary School,229,24,5,29
Gloucestershire,Lakefield CofE Primary School,198,35,4,39
Greenwich,Timbercroft Primary School,430,55,10,65
Greenwich,Brooklands Primary School,211,16,4,20
Greenwich,Millennium Primary School,438,28,17,45
Hammersmith and Fulham,Queen's Manor School and Special Needs Unit,229,29,28,57
Hammersmith and Fulham,Fulham Primary School,265,36,8,44
Hammersmith and Fulham,Sulivan Primary School,191,35,13,48
Hartlepool,Jesmond Gardens Primary School,381,46,9,55
Havering,Benhurst Primary School,416,32,9,41
Islington,The Bridge School,236,0,236,236
Kent,Oakfield Primary Academy,719,85,34,119
Kent,Temple Hill Primary Academy,891,178,35,213
Kent,Upton Junior School,513,57,12,69
"Kingston upon Hull, City of",Kelvin Hall School,1580,207,51,258
"Kingston upon Hull, City of",The Venn Boulevard Centre,49,15,33,48
"Kingston upon Hull, City of",Stepney Primary School,226,54,6,60
"Kingston upon Hull, City of",Ings Primary School,280,55,16,71
"Kingston upon Hull, City of",Chiltern Primary School,474,93,11,104
"Kingston upon Hull, City of",St George's Primary School,237,28,6,34
Kirklees,Joseph Norton Academy,63,0,63,63
Kirklees,St Aidan's Church of England Academy,173,20,2,22
Kirklees,Skelmanthorpe Academy,157,22,0,22
Kirklees,Thornhill Junior and Infant School,362,34,12,46
Kirklees,Scissett Church of England Academy,171,21,0,21
Leeds,Brigshaw High School,1406,193,34,227
Leeds,Swillington Primary School,206,32,0,32
Leeds,Kippax Ash Tree Primary School,371,58,4,62
Leeds,Kippax Greenfield Primary School,144,28,2,30
Leeds,Allerton Bywater Primary School,429,63,6,69
Leeds,Kippax North Primary School,245,24,2,26
Leicester,Merrydale Junior School,353,61,4,65
Leicester,Braunstone Community Primary School,434,58,21,79
Leicester,Woodstock Primary Academy,379,56,5,61
Leicester,Babington Academy,1344,217,52,269
Leicestershire,Fernvale Primary School,317,30,4,34
Leicestershire,Seagrave Village Primary School,95,16,2,18
Leicestershire,Newcroft Primary Academy,391,28,5,33
Leicestershire,Ashby Willesley Primary School,409,33,5,38
Leicestershire,Husbands Bosworth Church of England Primary School,83,6,4,10
Leicestershire,Newtown Linford Primary School,104,12,1,13
Leicestershire,"St Andrew's Church of England Primary School, North Kilworth",81,10,2,12
Lincolnshire,The Morton Church of England (Controlled) Primary School,215,14,7,21
Lincolnshire,Gosberton House Academy,103,0,103,103
Lincolnshire,"Brown's Church of England Primary School, Horbling",86,18,2,20
Lincolnshire,The Edenham Church of England School,106,6,2,8
Manchester,Parrs Wood High School,1923,185,39,224
Medway,Walderslade Primary School,235,35,2,37
Medway,Hoo St Werburgh Primary School and Marlborough Centre,573,70,88,158
Milton Keynes,Olney Middle School,380,40,5,45
Milton Keynes,Chestnuts Primary School,433,81,21,102
Newcastle upon Tyne,Stocksfield Avenue Primary School,446,48,6,54
Newcastle upon Tyne,Kenton Bar Primary School,322,43,15,58
Newcastle upon Tyne,North Fawdon Primary School,174,36,12,48
Newcastle upon Tyne,Mountfield Primary School,202,37,10,47
Newcastle upon Tyne,Kingston Park Primary School,432,47,21,68
Newcastle upon Tyne,Cheviot Primary School,229,41,6,47
Newcastle upon Tyne,Farne Primary School,240,32,3,35
Newcastle upon Tyne,Wyndham Primary School,207,15,5,20
Newham,Forest Gate Community School,1311,81,23,104
Newham,Eko Pathways,72,8,64,72
Newham,Gainsborough Primary School,236,46,20,66
Newham,Kaizen Primary School,438,80,5,85
Norfolk,Thorpe St Andrew School and Sixth Form,1839,212,19,231
Norfolk,Dussindale Primary School,345,45,12,57
Norfolk,"Hillside Avenue Primary and Nursery School, Thorpe",420,24,3,27
North East Lincolnshire,St Peter's CofE Primary School,180,31,7,38
North Somerset,Portishead Primary School,415,39,7,46
North Somerset,"St Mary's Church of England Primary School, Portbury",93,9,0,9
North Somerset,High Down Infant School,280,9,2,11
North Somerset,St Peter's Church of England Primary School,622,47,8,55
North Somerset,High Down Junior School,342,32,3,35
North Yorkshire,Hookstone Chase Primary School,299,43,6,49
North Yorkshire,Scalby School,981,120,35,155
North Yorkshire,Forest of Galtres Anglican/Methodist Primary School,112,11,0,11
North Yorkshire,East Whitby Primary Academy,225,26,16,42
Northumberland,Queen Elizabeth High School,1298,71,25,96
Northumberland,Hexham Middle School,549,72,7,79
Nottinghamshire,Robert Miles Junior School,251,27,2,29
Nottinghamshire,St Peter's Crosskeys CofE Academy,198,21,1,22
Nottinghamshire,Greenwood Primary and Nursery School,462,62,1,63
Nottinghamshire,Heymann Primary and Nursery School,680,35,1,36
Nottinghamshire,Burntstump Seely CofE Primary Academy,77,4,0,4
Nottinghamshire,Keyworth Primary and Nursery School,170,14,6,20
Nottinghamshire,Burton Joyce Primary School,307,36,0,36
Nottinghamshire,Crossdale Primary School,191,19,1,20
Nottinghamshire,Kirkby Woodhouse School,425,34,4,38
Nottinghamshire,Tollerton Primary School,209,9,3,12
Nottinghamshire,Cropwell Bishop Primary School,197,14,1,15
Oldham,Kingfisher Special School,214,0,214,214
Plymouth,Oakwood Primary Academy,339,46,9,55
Plymouth,Thornbury Primary School,268,45,18,63
Plymouth,Manadon Vale Primary School,414,50,6,56
Plymouth,Leigham Primary School,411,59,5,64
Plymouth,Widey Court Primary School,603,84,11,95
Plymouth,Weston Mill Community Primary Academy,242,55,5,60
Plymouth,Beechwood Primary Academy,344,58,21,79
Plymouth,Eggbuckland Vale Primary School,388,65,30,95
"Bournemouth, Christchurch and Poole",Twin Sails Infant and Nursery School,391,50,2,52
"Bournemouth, Christchurch and Poole",Hamworthy Park Junior School,460,51,11,62
Portsmouth,Court Lane Infant Academy,342,48,8,56
Portsmouth,Court Lane Junior Academy,479,98,18,116
Richmond upon Thames,Clarendon School,166,1,164,165
Richmond upon Thames,Strathmore School,113,2,111,113
Rochdale,Middleton Technology School,1346,144,24,168
Rotherham,Brinsworth Manor Junior School,234,41,7,48
Rotherham,Swinton Queen Primary School,347,60,10,70
Sandwell,Summerhill Primary Academy,798,121,12,133
Shropshire,Prees CofE Primary School,205,13,1,14
Shropshire,Whixall CofE Primary School,150,12,4,16
Shropshire,Ellesmere Primary School,373,55,8,63
Slough,Beechwood School,870,128,15,143
Somerset,Hugh Sexey Church of England Middle School,625,59,8,67
Somerset,Lympsham Church of England Academy,139,3,2,5
Somerset,East Brent Church of England First School,84,6,1,7
Somerset,Mark First and Pre-School CE Academy,160,18,2,20
Southend-on-Sea,Hinguar Community Primary School,246,27,1,28
Southend-on-Sea,Friars Primary School and Nursery,436,53,4,57
Southend-on-Sea,Hamstel Junior School,581,79,17,96
Southend-on-Sea,Thorpedene Primary School,536,79,10,89
Southend-on-Sea,Blenheim Primary School,657,41,29,70
Southend-on-Sea,Greenways Primary School,929,78,24,102
Southend-on-Sea,Bournes Green Infant School,180,14,4,18
Southend-on-Sea,Hamstel Infant School and Nursery,462,85,14,99
Staffordshire,Chesterton Primary School,175,30,1,31
Staffordshire,The Meadows School,127,0,127,127
Staffordshire,St James Church of England Primary Academy,102,8,4,12
Staffordshire,St John's CofE Primary Academy,380,53,3,56
Staffordshire,Crackley Bank Primary School,196,31,2,33
Staffordshire,Meir Heath Academy,329,21,1,22
Staffordshire,Bishop Lonsdale Church of England Primary Academy,242,25,4,29
Staffordshire,St Wulstan's Catholic Primary School,386,36,5,41
Staffordshire,Perton Primary Academy,242,31,4,35
Staffordshire,Springfield School,69,0,69,69
Staffordshire,Parkside Primary School,382,24,13,37
Stoke-on-Trent,Weston Junior Academy,208,27,1,28
Stoke-on-Trent,Weston Infant Academy,142,26,1,27
Suffolk,Bacton Primary School,133,21,1,22
Suffolk,Cedars Park Community Primary School,368,26,7,33
Suffolk,Mendlesham Primary School,115,15,15,30
Suffolk,Stowupland High School,1003,80,36,116
Sunderland,Diamond Hall Junior Academy,333,58,5,63
Surrey,Cardinal Newman Catholic Primary School,404,45,3,48
Surrey,St Anne's Catholic Primary School,429,65,7,72
Surrey,St Alban's Catholic Primary School,409,36,5,41
Surrey,"Salesian School, Chertsey",1822,119,54,173
Surrey,Holy Family Catholic Primary School,221,22,4,26
Surrey,"St John the Baptist Catholic Comprehensive School, Woking",1498,229,41,270
Surrey,St Hugh of Lincoln Catholic Primary School,210,25,5,30
Surrey,Riverbridge Primary School,704,79,15,94
Surrey,"St Charles Borromeo Catholic Primary School, Weybridge",243,26,9,35
Surrey,Guildford Grove Primary School,416,83,30,113
Surrey,St Augustine's Catholic Primary School,434,44,5,49
Sutton,Cheam Fields Primary Academy,489,22,16,38
Tameside,Bradley Green Primary Academy,222,18,5,23
Tameside,Dowson Primary Academy,471,50,7,57
Thurrock,Arthur Bugler Primary School,417,44,18,62
Tower Hamlets,St Paul's Way Trust School,1868,172,122,294
Trafford,Partington Central Academy,346,70,4,74
Wakefield,South Kirkby Academy,214,36,6,42
Walsall,Phoenix Academy,39,0,39,39
Waltham Forest,Selwyn Primary School,685,70,19,89
Waltham Forest,Davies Lane Primary School,940,60,46,106
Waltham Forest,Norlington School and 6th Form,821,63,17,80
West Sussex,"The Laurels Primary School, Worthing",184,36,4,40
West Sussex,Seaside Primary School,615,64,15,79
Wigan,Orrell Lamberhead Green Academy,411,69,14,83
Wigan,Orrell Holgate Academy,213,22,0,22
Windsor and Maidenhead,Trevelyan Middle School,547,89,6,95
Wirral,Town Lane Infant School,346,35,4,39
Wolverhampton,St Bartholomew's Church of England Primary School,399,36,12,48
Worcestershire,Cranham Primary School,430,64,21,85
Worcestershire,Bredon Hill Academy,484,52,6,58
Worcestershire,Northwick Manor Primary School,620,43,7,50
Worcestershire,St Peter's Droitwich CofE Academy,441,37,7,44
York,Burton Green Primary School,150,15,3,18
West Sussex,New Barn School,75,0,46,46
"Bristol, City of",Hareclive E-ACT Academy,362,71,9,80
Cambridgeshire,Ely College,1556,103,44,147
Redbridge,Oak House School,3,1,2,3
Devon,Chances Educational Support Services,23,8,2,10
South Gloucestershire,Filton Hill Primary School,208,24,3,27
Hertfordshire,Roselands Primary School,297,52,5,57
Hertfordshire,The Cranbourne Primary School,438,87,10,97
Sutton,Tweeddale Primary School,428,110,9,119
Devon,Woodlands Park Primary School,370,24,4,28
Birmingham,Erdington Academy,953,122,7,129
Sunderland,New Silksworth Academy Infant,217,19,6,25
Sunderland,New Silksworth Academy Junior,193,35,4,39
Worcestershire,Carnforth School,197,30,4,34
Walsall,Fibbersley Park Academy,628,104,13,117
Birmingham,Birmingham Independent College,10,0,10,10
Richmond upon Thames,Hampton High,886,133,41,174
Richmond upon Thames,Twickenham School,591,75,14,89
West Northamptonshire,Elizabeth Woodville School,1156,120,13,133
Thurrock,Ortu Hassenbrook Academy,629,80,14,94
Bromley,Harris Primary Academy Orpington,315,51,32,83
Bromley,Harris Academy Orpington,609,93,23,116
Havering,Harris Academy Rainham,896,93,27,120
Redcar and Cleveland,Old Farm School,28,0,28,28
Portsmouth,UTC Portsmouth,456,25,6,31
Barnsley,Ward Green Primary School,419,53,16,69
Bexley,Upland Primary School,471,28,9,37
Birmingham,Stirchley Primary School,218,44,4,48
Birmingham,St Francis Church of England Aided Primary School and Nursery,222,26,2,28
Birmingham,Fortis Academy,1434,184,3,187
Birmingham,Princethorpe Infant School,193,45,1,46
Birmingham,Audley Primary School,847,147,16,163
Birmingham,Dame Elizabeth Cadbury School,783,107,12,119
Birmingham,Quinton Church Primary School,211,30,0,30
Cambridgeshire,Babraham CofE (VC) Primary School,90,8,1,9
Cornwall,Portreath Community Primary School,152,19,2,21
Cornwall,Mousehole School,104,3,2,5
Cornwall,Treloweth Community Primary School,453,78,18,96
Cornwall,Rosemellin Community Primary School,396,66,12,78
Cornwall,Pencoys Primary School,203,28,5,33
Cornwall,Roskear School,492,67,10,77
Cornwall,Weeth Community Primary School,199,25,3,28
Cornwall,Illogan School,207,15,2,17
Darlington,Mount Pleasant Primary School,272,53,30,83
Derbyshire,Holbrook Church of England Primary School,137,14,5,19
Doncaster,Woodfield Primary School,380,54,5,59
Essex,Cherry Tree Primary School,445,99,9,108
Essex,"St Margaret's Church of England Academy, Bowers Gifford",217,38,5,43
"Herefordshire, County of",Burley Gate CofE Primary School,61,15,1,16
"Herefordshire, County of",St Michael's CofE Primary School,115,10,2,12
Knowsley,Cronton Church of England Primary Academy,235,26,7,33
Knowsley,Halewood Church of England Primary Academy,235,20,2,22
Medway,Deanwood Primary School,207,37,1,38
Norfolk,Bunwell Primary School,88,15,3,18
Norfolk,Garrick Green Infant School,147,17,3,20
Norfolk,Wroughton Infant Academy,214,16,3,19
Norfolk,Heacham Infant and Nursery School,112,22,1,23
Norfolk,Banham Primary School,97,11,2,13
North Somerset,Crockerne Church of England Primary School,325,27,11,38
North Yorkshire,Hampsthwaite Church of England Primary School,163,8,3,11
West Northamptonshire,St Luke's Church of England Primary School,398,37,6,43
West Northamptonshire,Byfield School,102,19,2,21
Northumberland,Ponteland Community Primary School,230,17,3,20
Nottinghamshire,Killisick Junior School,207,31,2,33
Nottinghamshire,Horsendale Primary School,210,23,0,23
Oldham,Spring Brook Academy,101,0,101,101
Plymouth,Plympton St Maurice Primary School,179,19,2,21
Plymouth,Chaddlewood Primary School,378,19,3,22
Plymouth,Woodfield Primary School,228,47,7,54
Plymouth,Prince Rock Primary School,396,53,8,61
"Bournemouth, Christchurch and Poole",Bearwood Primary and Nursery School,213,24,2,26
Redcar and Cleveland,Zetland Primary School,224,27,0,27
Redcar and Cleveland,Ormesby Primary School,289,46,6,52
Rotherham,Wath Church of England Primary School,445,64,9,73
Rotherham,Crags Community School,432,97,12,109
Rotherham,Aughton Junior Academy,152,24,1,25
Staffordshire,Ankermoor Primary Academy,138,21,2,23
Stoke-on-Trent,Hamilton Academy,130,26,4,30
Stoke-on-Trent,Alexandra Junior School,209,44,4,48
Stoke-on-Trent,Northwood Broom Academy,189,38,2,40
Stoke-on-Trent,Jackfield Infant School,223,35,1,36
Stoke-on-Trent,Moorpark Junior School,238,61,4,65
Stoke-on-Trent,Alexandra Infants' School,169,18,6,24
Suffolk,St Christopher's Academy,0,0,0,0
Suffolk,Ravensmere Infant School,47,10,1,11
Suffolk,The Albert Pye Community Primary School,398,84,12,96
Sunderland,Gillas Lane Primary Academy,136,29,1,30
Swindon,South Marston Church of England Primary School,101,11,0,11
Tameside,Endeavour Primary Academy,260,26,5,31
Warwickshire,Stockton Primary School,135,8,2,10
Wigan,Marus Bridge Primary School,408,53,10,63
Wiltshire,Southbroom Infants' School,135,28,2,30
Wiltshire,Forest and Sandridge Church of England Primary School,462,69,11,80
Wirral,Great Meols Primary School,475,55,9,64
Wirral,Egremont Primary School,272,74,33,107
Wirral,Poulton Lancelyn Primary School,472,40,6,46
Wirral,Stanton Road Primary School,280,49,0,49
Wirral,Church Drive Primary School,333,66,2,68
Wolverhampton,Broadmeadow Special School,75,0,75,75
Worcestershire,Alvechurch CofE Middle School,439,45,15,60
Worcestershire,Stourport Primary Academy,289,61,4,65
York,Tang Hall Primary Academy,245,49,5,54
Bradford,Worth Valley Primary School,257,20,13,33
Bradford,Reevy Hill Primary School,232,35,2,37
Darlington,Corporation Road Community Primary School,256,45,3,48
Derbyshire,St Edward's Catholic Academy,233,27,5,32
Doncaster,Denaby Main Primary Academy,155,24,6,30
County Durham,St Joseph's Catholic Primary School,98,18,1,19
Essex,St James' Church of England Primary School,437,77,5,82
Kent,Brenzett Church of England Primary School,83,18,2,20
Lincolnshire,South Witham Academy,102,9,1,10
Middlesbrough,Hollis Academy,83,0,83,83
Norfolk,Smithdon High School,612,113,21,134
Norfolk,Wroughton Junior Academy,327,38,13,51
North Yorkshire,Hawes Primary School,73,4,1,5
Sunderland,Dubmire Primary,462,62,5,67
Westminster,Southbank International School Westminster,510,0,98,98
Cheshire East,Eden School,15,0,15,15
Sunderland,Ashbrooke School,109,2,107,109
Bradford,High Park School,117,0,117,117
Buckinghamshire,Princes Risborough Primary School,253,20,22,42
Coventry,Hearsall Community Academy,459,79,9,88
Cumbria,Northside Primary School,64,9,5,14
Dudley,Hurst Hill Primary School,241,39,10,49
Essex,John Ray Junior School,408,84,16,100
Devon,Running Deer School,13,0,13,13
Isle of Wight,St Francis Catholic and Church of England Primary Academy,202,19,10,29
West Northamptonshire,Rectory Farm Primary School,196,45,5,50
Northumberland,Adderlane Academy,99,26,4,30
Rotherham,Wath Central Primary School,424,79,7,86
Rotherham,Clifton Community School,1027,263,24,287
Sheffield,Acres Hill Community Primary School,225,32,5,37
Staffordshire,Thursfield Primary School,285,38,2,40
Shropshire,Alveley Primary School,107,12,4,16
Suffolk,Eyke Church of England Primary School,107,15,1,16
Suffolk,Murrayfield Primary - A Paradigm Academy,431,24,25,49
Tameside,"St Paul's CofE Primary School, Stalybridge",224,22,4,26
Torbay,The Brunel Academy,55,1,54,55
West Sussex,St. Joseph's CofE Junior School,151,31,2,33
Wirral,"St Mary's Catholic College, A Voluntary Academy",1098,178,18,196
Barnsley,Wellgate Primary School,419,50,13,63
Barnsley,Kexborough Primary School,212,25,3,28
Bath and North East Somerset,Oldfield Park Infant School,171,21,5,26
Bath and North East Somerset,Oldfield Park Junior School,247,33,14,47
Bath and North East Somerset,Widcombe CofE Junior School,239,21,6,27
Bath and North East Somerset,St Philip's CofE Primary School,275,40,9,49
Bedford,Oakley Primary Academy,286,31,4,35
Birmingham,King Edward VI Handsworth Grammar School for Boys,1065,19,2,21
Birmingham,Cromwell Junior and Infant School,232,35,3,38
Bradford,Lapage Primary School and Nursery,704,101,19,120
Bradford,Atlas Community Primary School,194,49,9,58
Bradford,Westbourne Primary School,435,88,8,96
Bradford,Denholme Primary School,210,29,9,38
Bradford,Margaret McMillan Primary School,635,132,14,146
Bradford,Parkwood Primary School,223,41,14,55
Bradford,Victoria Primary School,332,38,4,42
Bradford,Lilycroft Primary School,413,47,9,56
Bradford,Green Lane Primary School,623,86,42,128
Buckinghamshire,Aspire,72,30,41,71
Cambridgeshire,Sawtry Junior Academy,275,45,7,52
Cambridgeshire,Linton Heights Junior School,236,26,6,32
Derbyshire,Mary Swanwick Primary School,253,61,4,65
Derbyshire,Brimington Manor Infant and Nursery School,80,5,0,5
Derbyshire,Brimington Junior School,316,63,2,65
Doncaster,Mexborough St John the Baptist CofE Primary School,235,50,7,57
Dudley,Leasowes High School,1003,194,17,211
County Durham,St Leonard's Catholic School,1408,62,15,77
County Durham,South Stanley Infant and Nursery School,129,30,1,31
County Durham,Greenland Community Primary School,331,37,11,48
East Riding of Yorkshire,Stamford Bridge Primary School,311,18,11,29
East Riding of Yorkshire,Pocklington Junior School,286,31,14,45
East Riding of Yorkshire,Woldgate School and Sixth Form College,1261,148,32,180
Essex,Market Field School,446,0,446,446
Essex,North East Essex Co-operative Academy,48,45,3,48
Essex,Mid Essex Co-Operative Academy,56,54,2,56
Greenwich,Foxfield Primary School,686,91,24,115
Greenwich,Rockliffe Manor Primary School,215,48,8,56
Greenwich,Woodhill Primary School,480,58,11,69
Greenwich,Willow Dene School,272,3,269,272
Greenwich,South Rise Primary School,625,128,17,145
Greenwich,Halstow Primary School,410,37,12,49
Greenwich,Horn Park Primary School,357,69,14,83
Greenwich,Deansfield Primary School,463,50,8,58
Greenwich,Alderwood Primary School,205,26,19,45
Halton,Daresbury Primary School,197,32,2,34
Hertfordshire,Laurance Haines School,463,55,10,65
Hertfordshire,Larwood School,93,2,91,93
Kent,Halfway Houses Primary School,591,97,15,112
Kent,Minster in Sheppey Primary School,579,89,9,98
Leicester,Heatherbrook Primary Academy,179,42,4,46
Leicestershire,Albert Village Primary School,201,18,2,20
Leicestershire,Hallbrook Primary School,189,20,6,26
Leicestershire,Viscount Beaumont's Church of England Primary School,72,7,1,8
Leicestershire,Oakthorpe Primary School,98,23,0,23
North Yorkshire,Stokesley Primary Academy,280,26,10,36
North Yorkshire,Rossett Acre Primary School,406,41,13,54
West Northamptonshire,Silverstone Church of England Primary School,249,27,1,28
Plymouth,Salisbury Road Primary School,401,43,10,53
"Bournemouth, Christchurch and Poole",Springdale First School,302,8,3,11
Redbridge,Winston Way Academy,665,85,11,96
Redcar and Cleveland,Badger Hill Academy,157,26,0,26
Redcar and Cleveland,Whitecliffe Academy,113,25,2,27
Sheffield,Wybourn Community Primary & Nursery School,553,109,14,123
Somerset,Holy Trinity Church School,407,45,6,51
Staffordshire,Waterhouses CofE Primary Academy,87,6,1,7
Stockton-on-Tees,Bader Primary School,354,41,6,47
Suffolk,"St Felix Roman Catholic Primary School, Haverhill",261,15,4,19
Surrey,Loseley Fields Primary School,358,51,26,77
Surrey,St Andrew's CofE Primary School,216,33,4,37
Surrey,Waverley Abbey CofE Junior School,480,56,11,67
Sutton,Brookfield Primary Academy,446,34,10,44
Tower Hamlets,Mulberry School for Girls,1616,126,39,165
Tower Hamlets,Ian Mikardo School,55,0,55,55
Warwickshire,St Mary's Catholic Primary School,103,7,0,7
Warwickshire,Our Lady's Catholic Primary School,88,15,3,18
Warwickshire,St Gregory's Catholic Primary School,204,17,1,18
Warwickshire,St Benedict's Catholic High School,579,96,6,102
West Sussex,Gossops Green Primary,582,50,10,60
Worcestershire,St Mary's Catholic Primary School,150,21,2,23
Worcestershire,St Mary's Catholic Primary School,80,9,0,9
Essex,The Deanes,507,79,43,122
Brent,Advance Education,140,0,1,1
Peterborough,Hampton Gardens Secondary School,1157,81,35,116
Dorset,Arbour House School,19,0,19,19
Buckinghamshire,East Claydon Church of England School,91,14,2,16
Hertfordshire,Harpenden Academy,213,33,2,35
Cornwall,Callington Community College,866,125,19,144
Calderdale,Trinity Academy Akroydon,285,35,4,39
Rotherham,Swinton Fitzwilliam Primary School,330,39,2,41
Stoke-on-Trent,PEAK EDUCATION - STOKE,56,34,22,56
Gloucestershire,Longford Park Primary Academy,237,25,5,30
Islington,"City of London Academy, Highgate Hill",675,103,16,119
Staffordshire,Henhurst Ridge Primary Academy,162,23,3,26
Newham,Royal Wharf Primary School,279,29,8,37
Surrey,Heathside Walton-on-Thames,124,18,11,29
Suffolk,The Limes Primary Academy,259,25,4,29
Swindon,Kingfisher  CE Academy,58,4,1,5
Leicester,Avanti Fields School,950,60,8,68
Greenwich,Woolwich Polytechnic school for Girls,943,78,13,91
Essex,Sir Frederick Gibberd College,652,54,20,74
Hampshire,Deer Park School,278,30,19,49
Essex,The Trinity School,239,42,7,49
Islington,The Bridge Satellite Provision,29,1,28,29
Bradford,Dixons Free Sixth Form,1091,27,2,29
Sutton,Harris Academy Sutton,1036,106,32,138
Warwickshire,Houlton School,358,47,7,54
Gloucestershire,Clearwater Church of England Primary Academy,188,12,9,21
Hillingdon,The PRIDE Academy,64,0,64,64
Brent,North Brent School,220,6,1,7
Cumbria,Cumbria Academy for Autism,56,0,56,56
Manchester,Didsbury High School,846,151,42,193
Brent,The Avenue School,73,0,73,73
Derby,Derby Cathedral School,877,112,12,124
Wandsworth,Anglo Portuguese School of London,70,5,1,6
Southwark,Spa School Camberwell,76,0,76,76
Liverpool,"ASPIRE Centre, Kings Leadership Academy Liverpool",3,1,1,2
Cumbria,Queen Elizabeth Studio School,368,95,4,99
Walsall,The Ladder School,16,12,4,16
Hackney,"City of London Academy, Shoreditch Park",729,69,35,104
Leeds,The Stephen Longfellow Academy,0,0,0,0
Oldham,Halcyon Way School,75,0,75,75
Manchester,Gorton Primary School,268,27,22,49
Milton Keynes,Fairfields Primary School,490,25,12,37
Halton,Palace Fields Primary Academy,166,29,10,39
Bedford,Great Barford Church of England Primary Academy,228,34,4,38
Blackpool,Mereside Primary Academy,301,55,5,60
Bolton,Harper Green School,1224,107,14,121
Bolton,Rivington and Blackrod High School,1507,136,42,178
Bromley,James Dixon Primary School,430,59,15,74
Cambridgeshire,Ramsey Spinning Infant School,197,34,5,39
Cambridgeshire,Milton Church of England Primary School,340,28,16,44
Cambridgeshire,Ramsey Junior School,267,45,13,58
Cornwall,St Mawes Primary School,38,5,1,6
Coventry,Parkgate Primary School,684,127,8,135
Coventry,Keresley Grange Primary School,284,60,1,61
Cumbria,Lorton School,48,7,1,8
Dudley,Lapal Primary School,380,24,3,27
Dudley,Lutley Primary School,617,41,6,47
Essex,Perryfields Junior School,301,28,5,33
Hertfordshire,Fairlands Primary School,679,183,22,205
Hertfordshire,Camps Hill Primary School,498,91,9,100
Kent,Tenterden Infant School,151,15,2,17
Kent,St Michael's Church of England Primary School,160,21,0,21
Kent,Tenterden Church of England Junior School,194,30,6,36
Kirklees,Birdsedge First School,41,7,2,9
Kirklees,Kirkburton Middle School,496,50,11,61
Kirklees,Scissett Middle School,616,108,21,129
Kirklees,Shelley First School,178,16,6,22
Lancashire,Southlands High School,953,132,20,152
Leicestershire,Richmond Primary School,520,75,15,90
Nottingham,Scotholme Primary and Nursery School,449,75,3,78
Nottinghamshire,Ranskill Primary School,143,13,2,15
Sheffield,Phillimore Community Primary School,441,73,7,80
Sheffield,Manor Lodge Community Primary and Nursery School,375,54,16,70
Shropshire,Ludlow Primary School,446,62,3,65
Slough,St Ethelbert's Catholic Primary School,424,34,11,45
Slough,St Joseph's Catholic High School,940,107,31,138
Slough,St Anthony's Catholic Primary School,496,57,18,75
Staffordshire,St Edward's CofE Academy Cheddleton,197,21,2,23
Suffolk,Middleton Community Primary School,25,2,1,3
Suffolk,Mellis Church of England Primary School,166,16,0,16
Surrey,de Stafford School,831,134,35,169
Surrey,Holly Lodge Primary Academy,421,36,6,42
Wakefield,Middlestown Primary Academy,185,37,4,41
Wakefield,Horbury Primary Academy,466,54,10,64
Wigan,Standish Community High School,1286,186,19,205
Wolverhampton,Edward the Elder Primary School,255,39,5,44
Worcestershire,Offenham Church of England First School,115,12,1,13
Worcestershire,The Littletons Church of England Academy,127,26,2,28
Cheshire West and Chester,Queen's Park High School,722,118,20,138
Dudley,Thorns Collegiate Academy,916,124,17,141
Dudley,Woodside Primary School and Nursery,459,120,17,137
Dudley,Ham Dingle Primary Academy,369,53,5,58
East Riding of Yorkshire,Sigglesthorne Church of England Primary Academy,55,10,1,11
Norfolk,Edward Worlledge Ormiston Academy,323,53,22,75
Nottinghamshire,The King's Church of England Primary Academy,272,54,2,56
Plymouth,Goosewell Primary Academy,434,45,15,60
Plymouth,High Street Primary Academy,115,21,4,25
Portsmouth,Redwood Park Academy,162,0,162,162
Staffordshire,St Benedict Biscop CofE Primary School,201,23,1,24
Suffolk,Yoxford & Peasenhall Primary Academy,94,10,3,13
Medway,The Pilgrim School (A Church of England Primary With Nursery),229,40,1,41
Worcestershire,St Bartholomew's CofE VC Primary School,229,52,3,55
Cambridgeshire,Elm CofE Primary School,241,28,7,35
Cambridgeshire,Orchards Church of England Academy,418,71,24,95
Lewisham,Urban Mission School,13,5,5,10
Staffordshire,Aurora Hanley School,85,0,84,84
Calderdale,Nightingale House School,0,0,0,0
Leicestershire,The Winstanley School,622,115,40,155
Darlington,Wyvern Academy,453,70,11,81
Croydon,Meridian High School,539,145,35,180
Bradford,The Academy At St. James,309,42,10,52
Bury,Unsworth Academy,946,101,30,131
Cambridgeshire,Hartford Junior School,227,24,16,40
Central Bedfordshire,Thomas Whitehead CofE Academy,205,39,10,49
Derby,Noel-Baker Academy,1120,163,26,189
East Riding of Yorkshire,Driffield School and Sixth Form,1406,171,38,209
Essex,Debden Church of England Voluntary Controlled Primary Academy,132,17,3,20
Hertfordshire,Churchfield CofE Academy,311,21,13,34
Leicester,Lancaster Academy,944,117,4,121
Lancashire,Lincoln House School,6,0,4,4
Peterborough,Gladstone Primary Academy,555,69,5,74
Suffolk,Woodhall Primary School,399,46,11,57
Suffolk,Houldsworth Valley Primary Academy,337,45,15,60
York,St Lawrence's Church of England Primary School,159,30,7,37
York,Vale of York Academy,684,62,10,72
Barnet,Oak Lodge School,207,0,207,207
Bexley,Bedonwell Infant and Nursery School,406,64,13,77
Bexley,Bedonwell Junior School,452,114,36,150
Bexley,Barrington Primary School,215,35,14,49
Birmingham,Hodge Hill Primary School,722,103,10,113
Cambridgeshire,Hartford Infant and Preschool,202,16,7,23
Cambridgeshire,Cavalry Primary School,411,53,14,67
Cheshire East,Warmingham CofE Primary School,71,11,3,14
Cornwall,Kennall Vale School,135,12,2,14
Cornwall,Leedstown Community Primary School,84,11,0,11
Derby,Hardwick Primary School,593,65,17,82
Doncaster,Kingfisher Primary Academy,408,51,8,59
Havering,The Royal Liberty School,736,84,20,104
Knowsley,Sylvester Primary Academy,251,46,9,55
Lancashire,Tor View School,233,1,232,233
Medway,Balfour Junior School,480,65,4,69
Newham,Tollgate Primary School,437,48,27,75
Newham,Cleves Primary School,495,69,23,92
Newham,Drew Primary School,418,34,18,52
North East Lincolnshire,William Barcroft Junior School,305,73,7,80
Nottinghamshire,The Forest View Academy,224,24,5,29
Nottinghamshire,Porchester Junior School,176,19,3,22
Oxfordshire,Dr South's Church of England Primary School,96,27,5,32
Oxfordshire,Tackley Church of England Primary School,105,16,1,17
Oxfordshire,Larkmead School,866,131,25,156
Plymouth,Marlborough Primary Academy,112,22,7,29
Plymouth,Morice Town Primary Academy,180,21,3,24
Plymouth,Pomphlett Primary School,408,62,9,71
Rotherham,Kilnhurst Primary School,176,28,4,32
Solihull,Smith's Wood Academy,899,186,15,201
Staffordshire,Tynsel Parkes Primary Academy,166,16,2,18
Staffordshire,Merryfields School,108,1,107,108
Staffordshire,Littleton Green Community School,481,105,3,108
Staffordshire,Chase Terrace Academy,1309,181,22,203
Staffordshire,Boney Hay Primary Academy,189,45,1,46
Surrey,The Ashcombe School,1478,192,26,218
Surrey,Therfield School,1043,143,47,190
Surrey,Carrington School,972,200,25,225
Walsall,Caldmore Primary Academy,451,33,9,42
Warwickshire,Southam College,1672,238,29,267
Warwickshire,Southam Primary School,386,33,3,36
Barnsley,Netherwood Academy,1204,196,30,226
Birmingham,Chandos Primary School,469,82,5,87
Medway,Wayfield Primary School,392,48,5,53
Suffolk,The Ryes College,23,0,23,23
Liverpool,Progress Schools - Toxteth,16,1,15,16
Bath and North East Somerset,Norton Hill Primary School,156,28,7,35
Doncaster,XP East,290,51,34,85
Solihull,Solihull Alternative Provision Academy,72,30,20,50
Newcastle upon Tyne,Great Park Academy,120,9,1,10
Enfield,Wren Academy Enfield,549,51,20,71
Harrow,Hujjat Primary School,177,20,0,20
Bedford,Wixams Tree Primary School,476,57,4,61
Greenwich,Royal Greenwich Trust School,798,128,10,138
Cheshire East,Cheshire Alterntive Provision School,21,17,4,21
Staffordshire,Bluebell School Ltd,111,0,111,111
Lewisham,Education-My Life Matters,9,1,5,6
Derby,Lees Brook Academy,1115,160,64,224
West Sussex,Reflections Nursery and Forest School,16,0,0,0
Lancashire,Wood Edge Independent School,1,0,1,1
Doncaster,Outwood Academy Danum,1153,177,12,189
Barnsley,Outwood Primary Academy Littleworth Grange,419,32,12,44
Barnsley,Outwood Primary Academy Darfield,217,27,1,28
Cambridgeshire,The Weatheralls Primary School,426,56,28,84
Birmingham,Canterbury Cross Primary School,484,82,3,85
Birmingham,Westminster Primary School,473,62,7,69
Bradford,Thornton Primary School,533,55,17,72
Nottinghamshire,Leamington Primary and Nursery Academy,472,37,5,42
Havering,Hornchurch High School,787,20,20,40
Devon,Totnes Progressive School,104,40,10,50
Essex,Barling Magna Primary Academy,176,19,4,23
Norfolk,Bawdeswell Community Primary School,86,15,1,16
North Northamptonshire,Mears Ashby Church of England Primary School,81,8,5,13
Oxfordshire,New Marston Primary School,293,35,15,50
Staffordshire,Picknalls First School,288,39,7,46
Derbyshire,Springfield Junior School,197,57,22,79
Kent,The Lenham School,779,81,21,102
Cambridgeshire,Thomas Eaton Primary Academy,145,20,9,29
Norfolk,Watton Westfield Infant and Nursery School,290,27,10,37
Wiltshire,West Ashton Church of England Primary School,77,15,1,16
Somerset,All Saints Church School,212,14,8,22
Staffordshire,All Saints' CofE First School,39,2,1,3
Wakefield,Featherstone All Saints CofE Academy,225,30,5,35
Norfolk,Aslacton Primary School,86,15,0,15
Doncaster,Balby Central Primary Academy,458,91,5,96
Sheffield,The Birley Academy,1083,217,56,273
Sheffield,Birley Primary Academy,576,83,5,88
Sheffield,Birley Spa Primary Academy,384,78,14,92
Southend-on-Sea,Bournemouth Park Academy,591,90,12,102
Cornwall,Breage Church of England School,63,8,1,9
Derbyshire,Castle View Primary School,158,51,1,52
Oxfordshire,Chalgrove Community Primary School,202,25,3,28
Sheffield,Charnock Hall Primary Academy,406,56,0,56
West Sussex,Desmond Anderson Primary Academy,450,84,28,112
"Herefordshire, County of",Eastnor Parochial Primary School,107,8,0,8
Cornwall,Garras Community Primary School,65,6,2,8
Cambridgeshire,Glebelands Primary Academy,398,58,10,68
Cornwall,Godolphin Primary School,74,4,1,5
Essex,Great Wakering Primary Academy,418,37,17,54
West Northamptonshire,Greens Norton Church of England Primary School,172,18,2,20
Cornwall,Halwin School,68,9,0,9
Cornwall,Helston Community College,1293,211,24,235
Bradford,Holycroft Primary School,359,58,7,65
Staffordshire,Hutchinson Memorial CofE First School,68,7,0,7
Oxfordshire,Icknield Community College,743,162,25,187
Oxfordshire,Leafield Church of England Primary School,95,5,4,9
Kent,"Leybourne, St Peter and St Paul Church of England Primary Academy",216,14,5,19
Norfolk,Lodge Lane Infant School,179,16,3,19
Surrey,Lorraine Infant School,124,9,3,12
Norfolk,Manor Field Infant and Nursery School,139,18,1,19
North Somerset,Mary Elton Primary School,373,27,8,35
Cornwall,Mullion Community Primary School,157,28,4,32
Cornwall,Mullion School,555,110,19,129
Cornwall,Parc Eglos School,456,57,5,62
Surrey,Pine Ridge Infant School,104,19,0,19
Cornwall,Porthleven School,215,36,2,38
Sheffield,Rainbow Forge Primary Academy,361,62,11,73
Cornwall,Sithney Community Primary School,79,4,4,8
West Berkshire,Speenhamland School,283,22,17,39
Oldham,St Anne's CofE Lydgate Primary School,207,13,4,17
Surrey,Stanwell Fields CofE Primary School,439,52,12,64
Staffordshire,Thomas Alleyne's High School,993,146,9,155
Cornwall,Trannack Primary School,66,10,2,12
Kent,Westcourt Primary School,358,46,3,49
Bradford,Wilsden Primary School,281,9,4,13
Staffordshire,Windsor Park CE Middle School,368,68,3,71
Oxfordshire,Wood Green School,1225,164,41,205
Plymouth,Courtlands School,100,0,100,100
Central Bedfordshire,Caldecote Church of England Academy,52,15,3,18
Derbyshire,New Whittington Community Primary School,260,50,14,64
Gloucestershire,Five Acres High School,789,94,26,120
Hampshire,Brune Park Community School,1360,234,51,285
Kent,The Charles Dickens School,1111,204,26,230
Norfolk,Upwell Academy,202,30,2,32
Norfolk,Long Stratton High School,682,149,13,162
Norfolk,Seething and Mundham Primary School,100,18,1,19
Norfolk,North Wootton Academy,324,28,4,32
Norfolk,Blenheim Park Academy,77,12,2,14
Nottingham,Denewood Academy,95,79,6,85
Nottingham,Unity Academy,122,114,4,118
Nottinghamshire,Redgate Primary Academy,55,0,55,55
Oldham,Woodlands Primary Academy,349,74,7,81
Torbay,The Burton Academy,43,23,0,23
West Berkshire,New Barn School,69,0,69,69
Barking and Dagenham,St Margarets CofE Primary School,364,49,3,52
Barnsley,Worsbrough Bank End Primary School,220,42,5,47
Barnsley,Hunningley Primary School,405,47,7,54
Bath and North East Somerset,Chandag Junior School,258,28,11,39
Bedford,Elstow School,416,54,8,62
Bexley,Shenstone School,174,0,174,174
Birmingham,Brays School,104,0,104,104
Birmingham,The Bridge School,89,0,89,89
Bolton,Canon Slade School,1759,108,30,138
Bolton,St Catherine's CofE Primary School,243,25,5,30
Bolton,St James's Church of England High School,1046,99,56,155
"Bournemouth, Christchurch and Poole",Stourfield Junior School,456,77,16,93
Bracknell Forest,Crown Wood Primary School,616,74,21,95
Bradford,Byron Primary School,688,106,7,113
Brent,Manor School,215,0,215,215
Cambridgeshire,Ditton Lodge Primary School,197,17,9,26
Cambridgeshire,Meadowgate Academy,176,0,176,176
Cheshire East,Offley Primary Academy,448,29,9,38
Cheshire West and Chester,Barnton Community Nursery and Primary School,492,56,21,77
Cornwall,St Francis CofE Primary School,424,54,4,58
Cornwall,Pennoweth Primary School,340,42,11,53
Cornwall,King Charles Church of England Primary School,413,43,3,46
Cornwall,Warbstow Primary Academy,68,5,2,7
Cornwall,Marhamchurch CofE Academy,119,16,0,16
Coventry,Courthouse Green Primary School,700,260,28,288
Croydon,St Peter's Primary School,422,42,11,53
Derby,Da Vinci Academy,698,96,25,121
Derbyshire,All Saints CofE Junior School,233,24,2,26
Derbyshire,All Saints CofE Infant School,162,14,0,14
Derbyshire,The Pingle Academy,1427,273,85,358
Devon,West Alvington Church of England Academy,42,9,3,12
Warwickshire,St Gabriel's CofE Academy,274,24,3,27
Devon,Exwick Heights Primary School,562,77,11,88
Devon,Charleton Church of England Academy,60,10,1,11
Devon,Thurlestone All Saints Church of England Academy,155,12,1,13
Doncaster,Bentley High Street Primary School,453,85,16,101
Doncaster,Hill Top Academy,394,74,8,82
Dudley,Dudley Wood Primary School,438,66,13,79
Dudley,Netherbrook Primary School,467,88,13,101
Dudley,Kates Hill Primary School,437,80,10,90
East Riding of Yorkshire,Sproatley Endowed Church of England Academy,119,20,4,24
East Sussex,Ark Castledown Primary Academy,387,92,6,98
Enfield,The Lea Valley Academy,855,105,16,121
Essex,Noak Bridge Primary School,210,18,4,22
Gloucestershire,St James' Church of England Primary School,417,35,6,41
Greenwich,St Mary's Catholic Primary School,454,49,6,55
Hampshire,Gomer Junior School,241,35,8,43
Havering,Marshalls Park Academy,1182,76,20,96
Havering,Gaynes School,288,45,1,46
Hounslow,Berkeley Academy,460,180,3,183
Kent,Stone St Mary's CofE Primary School,645,27,10,37
Kent,Horton Kirby Church of England Primary School,236,34,5,39
Kent,Dartford Grammar School for Girls,1248,56,4,60
"Kingston upon Hull, City of",St Thomas More Voluntary Catholic Academy,208,32,8,40
"Kingston upon Hull, City of",St Anthony's Voluntary Catholic Academy,236,34,4,38
"Kingston upon Hull, City of",St Charles Voluntary Catholic Academy,160,17,2,19
"Kingston upon Hull, City of","St Mary's College, Voluntary Catholic Academy",2508,276,58,334
Knowsley,Halsnead Primary School,310,51,6,57
Leicester,Rowlatts Mead Primary Academy,365,70,3,73
Leicestershire,Dunton Bassett Primary School,76,5,2,7
Leicestershire,"Thurnby, St Luke's Church of England Primary School",214,18,5,23
Leicestershire,Sharnford Church of England Primary School,106,18,4,22
Leicestershire,John Wycliffe Primary School,294,53,6,59
Leicestershire,"St Margaret's Church of England Primary School, Stoke Golding",220,24,5,29
Leicestershire,"All Saints Church of England Primary School, Sapcote",297,63,9,72
Leicestershire,Ullesthorpe Church of England Primary School,111,27,3,30
Leicestershire,Claybrooke Primary School,69,4,0,4
Leicestershire,"St Mary's Church of England Primary School, Bitteswell",102,26,4,30
Leicestershire,South Kilworth Church of England Primary School,68,12,2,14
Leicestershire,Swinford Church of England Primary School,103,7,0,7
Lincolnshire,Whaplode Church of England Primary School,191,9,5,14
Lincolnshire,Branston Church of England Infant Academy,136,13,2,15
Manchester,Barlow Hall Primary School,283,74,21,95
Manchester,Brookburn Community School,448,42,11,53
Medway,Thames View Primary School,449,76,4,80
Medway,St Margaret's Infant School,300,45,3,48
Medway,The Rowans,26,26,0,26
Medway,Riverside Primary School,406,95,22,117
Middlesbrough,Pallister Park Primary School,627,77,0,77
Milton Keynes,Monkston Primary School,421,47,4,51
Newham,Ranelagh Primary School,326,41,28,69
Newham,Ravenscroft Primary School,556,55,31,86
Newham,Kensington Primary School,659,57,10,67
Newham,Curwen Primary School,893,84,34,118
Norfolk,Heather Avenue Infant School,132,16,5,21
Norfolk,Lionwood Infant and Nursery School,200,47,1,48
Norfolk,George White Junior School,291,57,4,61
Norfolk,Lionwood Junior School,277,66,11,77
Norfolk,Thompson Primary School,93,7,2,9
North East Lincolnshire,Pilgrim Academy,277,35,5,40
North Yorkshire,Barton Church of England Primary School,31,11,2,13
North Yorkshire,Croft Church of England Primary School,109,11,3,14
North Yorkshire,East Cowton Church of England Primary School,28,5,0,5
North Yorkshire,Leyburn Primary School,180,18,4,22
North Yorkshire,Ravensworth Church of England Primary School,43,12,0,12
North Yorkshire,South Otterington Church of England Primary School,115,21,3,24
North Yorkshire,Aspin Park Academy,421,63,14,77
North Yorkshire,Trinity Academy Eppleby Forcett,39,2,0,2
North Yorkshire,Ainderby Steeple Church of England Primary School,83,14,4,18
North Yorkshire,Kirkby Fleetham Church of England Primary School,16,8,0,8
North Yorkshire,Trinity Academy Middleton Tyas,120,9,1,10
North Yorkshire,Meadowside Academy,212,43,9,52
North Northamptonshire,Wollaston Primary School,298,47,7,54
West Northamptonshire,Falconer's Hill Infant School,169,18,5,23
West Northamptonshire,The Abbey Primary School,348,46,5,51
North Northamptonshire,Kettering Park Infant Academy,243,17,9,26
West Northamptonshire,Standens Barn Primary School,376,47,3,50
West Northamptonshire,St James Infant School,199,28,5,33
Northumberland,Prudhoe West Academy,263,31,8,39
Northumberland,Abbeyfields First School,334,40,5,45
Nottinghamshire,Colonel Frank Seely Academy,785,83,11,94
Nottinghamshire,Robert Miles Infant School,146,10,2,12
Nottinghamshire,Sir John Sherbrooke Junior School,206,24,4,28
Oxfordshire,Edith Moorhouse Primary School,370,38,9,47
Oxfordshire,Dr Radcliffe's Church of England Primary School,192,17,5,22
Oxfordshire,Wroxton Church of England Primary School,94,16,3,19
Plymouth,Pilgrim Primary Academy,396,91,17,108
Portsmouth,Solent Infant School,267,28,4,32
Portsmouth,Highbury Primary School,406,70,8,78
Portsmouth,Springfield School,1075,159,15,174
Portsmouth,Solent Junior School,363,36,11,47
Portsmouth,Arundel Court Primary Academy and Nursery,617,141,18,159
Rotherham,Roughwood Primary School,294,61,2,63
Rotherham,Milton School,142,0,142,142
Rotherham,Brampton Ellis CofE Primary School,478,71,2,73
Rotherham,Wentworth CofE Junior and Infant School,111,9,0,9
Salford,Moorside High School,1141,148,37,185
Salford,Ellesmere Park High School,795,147,47,194
Shropshire,Burford CofE Primary School,153,19,4,23
Shropshire,Greenfields Primary School,383,42,6,48
Shropshire,Radbrook Primary School,331,39,2,41
South Tyneside,Harton Academy,1631,366,43,409
Southampton,Great Oaks School,322,2,320,322
Staffordshire,Penkridge Middle School,492,73,11,84
Staffordshire,Co-op Academy Friarswood,205,16,1,17
Staffordshire,Cherry Trees School,54,2,52,54
Staffordshire,Wightwick Hall School,104,1,103,104
Stoke-on-Trent,St Mary's Church of England Primary School,489,58,9,67
Suffolk,Aldeburgh Primary School,84,12,3,15
Suffolk,Handford Hall Primary School,374,120,5,125
Suffolk,Springfield Infant School and Nursery,304,41,2,43
Suffolk,Claydon High School,774,108,22,130
Suffolk,Hartest Church of England Primary School,49,7,3,10
Suffolk,The Willows Primary School,356,85,13,98
Suffolk,Halifax Primary School,415,40,6,46
Suffolk,Wells Hall Primary School,482,64,7,71
Sunderland,Highfield Academy,422,92,5,97
Sunderland,George Washington Primary School,397,83,3,86
Sunderland,Valley Road Academy,386,92,11,103
Sunderland,Hill View Infant Academy,457,25,2,27
Sunderland,John F Kennedy Primary School,441,86,29,115
Sunderland,Hill View Junior Academy,448,71,4,75
Sunderland,Hetton Lyons Primary School,435,53,9,62
Surrey,West Hill School,149,0,149,149
Surrey,Bletchingley Village Primary School,249,54,37,91
Surrey,Hamsey Green Primary,365,39,7,46
Surrey,Tatsfield Primary School,207,26,6,32
Surrey,Woodlea Primary School,195,17,4,21
Surrey,Linden Bridge School,140,0,140,140
Thurrock,Treetops School,313,0,313,313
Tower Hamlets,Stebon Primary School,689,157,39,196
Tower Hamlets,Bygrove Primary School,248,40,18,58
Wakefield,Wrenthorpe Academy,315,37,3,40
Waltham Forest,St Mary's CofE Primary School,566,33,15,48
Waltham Forest,St Saviour's Church of England Primary School,331,43,5,48
Warrington,Kassia Academy and Support Services,9,4,5,9
Warrington,Oakwood Avenue Community Primary School,706,119,39,158
Warwickshire,Bishops Itchington Primary School,203,18,5,23
West Sussex,St Philip Howard Catholic School,1177,163,39,202
West Sussex,East Preston Junior School,308,40,6,46
Windsor and Maidenhead,St Edmund Campion Catholic Primary School,421,36,9,45
Windsor and Maidenhead,Bisham Church of England Academy,91,18,3,21
Wolverhampton,St Stephen's Church of England Primary School,251,31,2,33
Wolverhampton,Goldthorn Park Primary School,434,45,2,47
Wolverhampton,Parkfield Primary School,211,33,1,34
Worcestershire,Kempsey Primary School,361,41,10,51
Worcestershire,St Nicholas' CofE Middle School,212,37,3,40
Worcestershire,Malvern Parish CofE Primary School,209,25,5,30
Worcestershire,Madresfield CofE Primary School,102,29,2,31
Worcestershire,Pinvin CofE First School,118,34,6,40
Worcestershire,Hartlebury CofE Primary School,170,40,6,46
Worcestershire,Hanley Swan St Gabriel's with St Mary's CofE Primary School,115,15,2,17
York,Clifton With Rawcliffe Primary School,631,61,14,75
York,Acomb Primary School,330,12,10,22
York,Park Grove Primary Academy,273,25,8,33
York,Woodthorpe Primary School,467,51,7,58
Newcastle upon Tyne,West Walker Primary School,223,42,7,49
Newcastle upon Tyne,Central Walker Church of England Primary School,458,96,10,106
Newcastle upon Tyne,Benfield School,979,105,57,162
Newcastle upon Tyne,Tyneview Primary School,289,34,9,43
Newcastle upon Tyne,Walkergate Community School,659,76,24,100
North Yorkshire,Filey Church of England Nursery and Infants Academy,231,35,2,37
Suffolk,Beck Row Primary Academy,232,31,4,35
Suffolk,Clements Primary Academy,264,46,21,67
Wiltshire,Shrewton CofE Primary Academy,111,13,6,19
Wolverhampton,Moreton School,1020,240,25,265
North Tyneside,North Gosforth Academy,554,60,16,76
Barking and Dagenham,The James Cambell Primary School,575,121,7,128
Bath and North East Somerset,Farrington Gurney Church of England Primary School,104,9,0,9
Bath and North East Somerset,Marksbury CofE Primary School,84,8,1,9
Bath and North East Somerset,Chandag Infant School,212,21,2,23
"Bristol, City of",Lansdown Park Academy,16,7,1,8
"Bristol, City of",St Matthias Academy,18,16,2,18
"Bristol, City of",Notton House Academy,49,0,49,49
Bromley,Harris Primary Academy Beckenham Green,193,29,3,32
Cambridgeshire,Guyhirn CofE VC Primary School,71,6,3,9
Cambridgeshire,St John's CofE Primary School,358,37,15,52
Cornwall,Dobwalls Community Primary School,184,36,4,40
Cornwall,Liskeard School and Community College,1192,134,48,182
Cornwall,Trewidland Primary School,46,6,1,7
Derbyshire,Eckington Junior School,144,24,1,25
Dorset,Beechcroft St Pauls CofE Primary School,220,35,16,51
Dorset,"St Mary's Church of England Primary School, Bradford Abbas",96,20,3,23
Dudley,Olive Hill Primary Academy,451,61,2,63
East Sussex,Jarvis Brook Primary School,158,28,1,29
Essex,Lawford Mead Primary & Nursery,432,73,8,81
Essex,Kings Road Primary School,419,89,7,96
"Kingston upon Hull, City of",Paisley Primary School,356,53,2,55
Birmingham,Tile Cross Academy,595,86,8,94
"Kingston upon Hull, City of",Newland School for Girls,650,98,3,101
Lambeth,Rosendale Primary School,638,27,6,33
Lambeth,The Elmgreen School,1113,115,49,164
Leicestershire,Swannington Church of England Primary School,80,8,4,12
Luton,Putteridge High School,1134,107,19,126
Luton,Challney High School for Girls,1049,103,13,116
Norfolk,"King's Park Infant School, Dereham",56,3,2,5
Norfolk,Grove House Infant and Nursery School,92,11,1,12
Norfolk,Garvestone Community Primary School,72,22,1,23
Norfolk,Dereham Neatherd High School,1189,241,53,294
Norfolk,Beeston Primary School,57,3,1,4
North Northamptonshire,Hall Meadow Primary School,203,9,2,11
West Northamptonshire,Welford Sibbertoft and Sulby Endowed School,75,9,1,10
Nottingham,Westbury Academy,104,0,104,104
Nottingham,Woodlands Academy,87,0,87,87
Nottinghamshire,Mapplewells Primary and Nursery School,345,35,9,44
Rotherham,Woodsetts Primary School,212,26,2,28
Rotherham,Brampton Cortonwood Infant School,166,29,1,30
Rotherham,Anston Brook Primary School,184,16,1,17
St. Helens,Rainhill High School,1830,219,49,268
St. Helens,Rainford High School,1652,273,77,350
Suffolk,Springfield Junior School,346,42,4,46
Surrey,St Andrew's Church of England Infant School,88,6,0,6
Wakefield,Ackton Pastures Primary Academy,353,49,7,56
Wakefield,Half Acres Primary Academy,406,68,8,76
Wiltshire,Heytesbury Church of England Primary School,68,14,1,15
Worcestershire,St Barnabas CofE First and Middle School,189,37,4,41
Worcestershire,Crowle CofE First School,58,15,1,16
Birmingham,Hallmoor School,256,0,256,256
Birmingham,Bordesley Village Primary School,347,52,1,53
Buckinghamshire,West Wycombe School,134,17,4,21
Buckinghamshire,Dorney School,201,18,5,23
Wigan,St Mark's CofE Primary School,234,85,8,93
Central Bedfordshire,Manshead CofE Academy,1095,153,41,194
Derby,Derwent Primary School,284,33,5,38
Derbyshire,Temple Normanton Junior Academy,104,14,1,15
Doncaster,Rossington St Michael's CofE Primary School,345,78,7,85
Doncaster,Pennine View School,125,0,125,125
Doncaster,Edlington Victoria Academy,266,55,10,65
Doncaster,Rosedale Primary School,180,17,4,21
Essex,Maple Grove Primary School,303,22,10,32
Essex,Leigh Beck Junior School,316,40,3,43
Essex,Janet Duke Primary School,668,127,20,147
Gateshead,River Tyne Academy Gateshead,90,42,4,46
Kent,The Whitstable School,1080,78,34,112
Knowsley,Blacklow Brow School,233,10,1,11
Lancashire,The Hyndburn Academy,581,98,6,104
Milton Keynes,Knowles Primary School,311,40,9,49
Newcastle upon Tyne,Mary Astell Academy,64,43,9,52
Norfolk,Sprowston Community Academy,1579,220,41,261
Norfolk,Mattishall Primary School,187,34,1,35
Norfolk,Emneth Academy,197,22,4,26
Barnet,Lubavitch Senior Boys School,19,0,0,0
Doncaster,Sir Thomas Wharton Academy,1045,97,13,110
North East Lincolnshire,The Orchard Independent Special School,83,1,82,83
Worcestershire,Baxter College,827,141,25,166
Wigan,Atherton St George's CofE Primary School,361,160,8,168
Salford,St Augustine's CofE Primary School,195,14,3,17
Dudley,The Rowan School,34,0,34,34
Lancashire,Maple House School,6,2,4,6
North Northamptonshire,Youth Works Community College,6,0,5,5
Essex,The Belsteads School,24,0,24,24
Cheshire East,Wybunbury Delves CofE Primary School,199,24,8,32
Croydon,Park Hill Junior School,369,46,9,55
Derbyshire,St Giles CofE Primary School,324,27,13,40
Devon,Lew Trenchard Church of England Primary School,102,19,4,23
Plymouth,Drake Primary Academy,178,30,5,35
Staffordshire,Churchfield CofE Primary Academy,138,16,4,20
Surrey,Auriol Junior School,342,36,16,52
Wiltshire,Wyvern St Edmund's,1328,213,41,254
Wiltshire,The Trafalgar School at Downton,770,68,45,113
Birmingham,Turves Green Primary School,380,43,7,50
Derbyshire,Heritage High School,973,213,21,234
Devon,Axe Valley Academy,643,149,32,181
North Northamptonshire,Kettering Park Junior Academy,329,46,4,50
West Northamptonshire,Bracken Leas Primary School,417,51,6,57
West Northamptonshire,Collingtree Church of England Primary School,90,19,0,19
Nottingham,Springfield Academy,217,48,4,52
Nottinghamshire,"St Peter's CofE Primary Academy, Mansfield",214,31,5,36
Oxfordshire,West Kidlington Primary and Nursery School,338,25,12,37
Suffolk,Clare Community Primary School,195,27,3,30
Wakefield,Cherry Tree Academy,257,53,13,66
West Sussex,St Mary's Catholic Primary School,246,36,10,46
Hertfordshire,Croxley Danes School,993,135,31,166
Telford and Wrekin,The Retreat,4,4,0,4
Bexley,Endeavour Academy Bexley,79,0,79,79
Bexley,Aspire Academy,44,0,44,44
Bexley,Horizons Academy Bexley,21,17,0,17
Bury,Christ Church CofE Primary School,244,32,4,36
Doncaster,Southfield Primary,278,44,4,48
Doncaster,Tranmoor Primary,412,72,7,79
Doncaster,Bessacarr Primary,462,29,12,41
Dorset,Buckland Newton Church of England Primary School,118,17,2,19
Dorset,Sherborne Abbey Church of England Primary School,360,57,6,63
Dorset,Thornford CofE Primary School,100,9,0,9
Dorset,St Andrew's Church of England Primary School,118,17,5,22
Dorset,Sherborne Primary School,299,44,9,53
Dudley,Netherton CofE Primary School,401,64,9,73
Hertfordshire,Roebuck Academy,458,107,19,126
Kent,St Teresa's Catholic Primary School,213,25,4,29
"Kingston upon Hull, City of",Alderman Cogan's Church of England Primary Academy,440,30,11,41
"Kingston upon Hull, City of",Rise Academy,119,14,70,84
Medway,Barnsole Primary School,671,61,6,67
Milton Keynes,New Bradwell Primary School,616,59,31,90
Norfolk,Spooner Row Primary School,101,13,4,17
Norfolk,Tivetshall Community Primary School,27,12,1,13
Norfolk,Burston Community Primary School,42,15,0,15
Norfolk,Foulsham Primary School Academy,85,9,0,9
North Yorkshire,Knayton Church of England Academy,146,22,3,25
West Northamptonshire,Guilsborough Church of England  Primary School,109,12,0,12
Nottinghamshire,Westdale Junior School,228,13,1,14
Oxfordshire,Horspath Church of England Primary School,142,19,7,26
Oxfordshire,Garsington Church of England Primary School,211,31,1,32
Shropshire,Mount Pleasant Primary,363,31,7,38
Shropshire,Ludlow Church of England School,584,88,7,95
Somerset,Puriton Primary School,201,17,4,21
Somerset,Westover Green Community School and Autism Centre,406,57,25,82
Staffordshire,Seabridge Primary School,440,43,10,53
Stoke-on-Trent,Milton Primary Academy,400,48,3,51
Suffolk,Holton St Peter Community Primary School,110,10,2,12
Suffolk,Bungay Primary School,174,34,7,41
Suffolk,Edgar Sewter Community Primary School,322,60,7,67
Suffolk,Ilketshall St Lawrence School,103,15,3,18
Suffolk,Wenhaston Primary School,89,16,0,16
Sunderland,South Hylton Primary Academy,277,34,1,35
Thurrock,Somers Heath Primary School,434,35,14,49
Wakefield,Fitzwilliam Primary School,232,30,3,33
West Sussex,Northlands Wood Primary Academy,415,53,4,57
Wiltshire,St Katharine's CofE Primary School,95,11,0,11
Wokingham,St Teresa's Catholic Academy,341,20,3,23
Worcestershire,St Oswald's CofE Primary School,156,36,3,39
Worcestershire,Orchard Primary School,198,45,0,45
Central Bedfordshire,Kensworth Church of England Academy,81,8,6,14
Salford,Barton Moss Community Primary School,232,25,7,32
Shropshire,Holy Trinity Church of England Primary Academy and Nursery,274,48,3,51
Nottingham,Robert Shaw Primary and Nursery School,469,51,6,57
Nottingham,William Booth Primary and Nursery School,233,24,3,27
Birmingham,Small Heath Leadership Academy,1153,103,8,111
Bromley,Eden Park High School,1190,228,36,264
Derby,Pear Tree Community Junior School,356,37,2,39
Derbyshire,Scargill CofE Primary School,340,53,6,59
Derbyshire,St George's CofE Primary School,102,15,1,16
Doncaster,Our Lady of Sorrows Catholic Voluntary Academy,190,32,3,35
Dorset,St Andrew's Church of England Primary School,294,65,7,72
East Riding of Yorkshire,Gilberdyke Primary School,214,10,3,13
Gloucestershire,Moat Primary School,137,38,6,44
Hillingdon,William Byrd Primary Academy,575,58,7,65
Lancashire,Newchurch-In-Pendle St Mary's Church of England Primary School,54,6,0,6
Kent,Parkview Academy,15,0,15,15
Northumberland,Whitfield CofE Primary School,23,9,1,10
Leicester,"Tudor Grange Samworth Academy, A church of England School",961,180,8,188
Sheffield,Hatfield Academy,376,74,4,78
Sheffield,Hartley Brook Primary School,624,145,14,159
Doncaster,Castle Academy,160,34,2,36
Barnsley,Oakhill Primary Academy,328,54,11,65
Nottinghamshire,Wainwright Primary Academy,381,79,4,83
Nottinghamshire,Queen Elizabeth's Academy,772,121,12,133
Nottingham,Park Vale Academy,879,135,5,140
Lincolnshire,Spalding Academy,1382,179,40,219
Nottinghamshire,The Newark Academy,1122,71,9,80
Rotherham,Rawmarsh Sandhill Primary School,247,49,3,52
Lincolnshire,Gosberton Academy,136,26,3,29
Bradford,Woodside Academy,423,56,10,66
Liverpool,The Academy of St Francis of Assisi,890,233,33,266
Manchester,The East Manchester Academy,1012,233,22,255
County Durham,Teesdale School and Sixth Form,720,94,10,104
Staffordshire,Chadsmead Primary Academy,248,35,2,37
Walsall,North Walsall Primary Academy,236,34,5,39
Swindon,Gorse Hill Primary School,461,68,10,78
Slough,The Godolphin Junior Academy,445,43,14,57
Barnet,The Totteridge Academy,899,136,32,168
Surrey,Three Rivers Academy,1447,242,59,301
Bromley,Green Street Green Primary School,407,63,38,101
East Sussex,King's Academy Ringmer,565,115,14,129
Portsmouth,King's Academy College Park (Junior),455,79,2,81
Oldham,Willowpark Primary Academy,236,36,4,40
Oldham,Waterhead Academy,1261,212,17,229
"Bristol, City of",The City Academy Bristol,1033,194,39,233
Newham,"Newham Collegiate Sixth Form Centre, City of London Academy",657,1,0,1
Wiltshire,The WASP Centre,22,13,9,22
Hounslow,The Green School for Boys,741,158,18,176
Kensington and Chelsea,Wetherby Kensington,152,55,1,56
Wigan,Dean Trust Wigan,791,179,17,196
Surrey,Farnham Heath End,1073,142,38,180
East Sussex,Christ Church CofE Primary and Nursery Academy,440,144,7,151
Cornwall,St Kew ACE Academy,83,13,1,14
Cornwall,Upton Cross ACE Academy,95,18,2,20
Newcastle upon Tyne,Beech Hill Primary School,456,67,10,77
Oxfordshire,Bishop Loveday Church of England Primary School,391,37,8,45
Nottinghamshire,Bracken Lane Primary Academy,236,20,3,23
Newham,Britannia Village Primary School,459,45,11,56
Bedford,Cauldwell School,419,66,19,85
Cheshire West and Chester,Childer Thornton Primary School,241,25,7,32
Oxfordshire,Deddington Church of England Primary School,198,15,8,23
Kent,Valley Invicta Primary School At East Borough,471,37,22,59
Norfolk,Gaywood Primary School,388,51,5,56
Derbyshire,Granville Academy,830,139,20,159
Nottinghamshire,Gunthorpe CofE Primary School,95,3,1,4
Devon,High Bickington Church of England Primary Academy,102,9,2,11
Doncaster,Hooton Pagnell All Saints Church of England Primary School,83,15,5,20
Cambridgeshire,Jeavons Wood Primary School,424,75,14,89
Leicestershire,Kingsway Primary School,305,19,12,31
Doncaster,Highwoods Academy,211,32,1,33
Bexley,Northwood Primary School,178,23,6,29
Cheshire West and Chester,Parklands Community Primary and Nursery School,199,44,11,55
Stockton-on-Tees,Pentland Primary School,335,46,31,77
Sutton,Rushy Meadow Primary Academy,387,51,15,66
Bedford,Shackleton Primary School,509,70,19,89
Bedford,Shortstown Primary School,475,116,17,133
Oxfordshire,South Moreton Primary School,124,18,2,20
Nottingham,South Wilford Endowed CofE Primary School,382,26,0,26
Bromley,St Anthony's Roman Catholic Primary School,137,18,4,22
Dorset,St John's Church of England Primary School,229,40,10,50
Stockton-on-Tees,St Mark's Church of England Primary School,458,38,18,56
Suffolk,Stoke-by-Nayland Church of England Primary School,46,19,2,21
"Bournemouth, Christchurch and Poole",Livingstone Road Infant School,262,24,5,29
Nottinghamshire,Thrumpton Primary Academy,238,31,2,33
Rotherham,Treeton Church of England Primary School,295,48,0,48
Stoke-on-Trent,Trentham Academy,762,117,14,131
Newcastle upon Tyne,Walbottle Village Primary School,172,21,4,25
Devon,Witheridge Church of England Primary Academy,125,11,4,15
East Riding of Yorkshire,Wolfreton School and Sixth Form College,1518,110,38,148
Cheshire West and Chester,Wolverham Primary and Nursery School,298,45,16,61
Wakefield,Ackworth Mill Dam School,222,15,7,22
Norfolk,Astley Primary School,214,27,5,32
Medway,Bligh Primary School (Juniors),328,75,5,80
Oxfordshire,Brightwell-Cum-Sotwell Church of England Primary School,157,12,7,19
Tameside,Oasis Academy Broadoak,397,99,14,113
Cornwall,Duloe CofE VA Primary Academy,95,12,2,14
Wokingham,Earley St Peter's Church of England Primary School,494,37,8,45
Bury,East Ward Community Primary School,455,49,12,61
Wakefield,Featherstone Girnhill Infant School,177,24,6,30
Norfolk,Hemblington Primary School,143,27,5,32
Bury,Higher Lane Primary School,456,31,13,44
Oxfordshire,Kidmore End Church of England Primary School,163,23,5,28
Worcestershire,The Lyppard Grange Primary School,418,59,12,71
Portsmouth,Meon Junior School,343,42,6,48
Portsmouth,Moorings Way Infant School,149,9,4,13
"Kingston upon Hull, City of",Mountbatten Primary School,314,40,4,44
Oxfordshire,North Hinksey Church of England Primary School,203,24,3,27
Worcestershire,Norton Juxta Kempsey CofE Primary School,199,26,2,28
Thurrock,Orsett Church of England Primary School,201,22,9,31
Leeds,Co-op Academy Priesthorpe,1091,146,37,183
Havering,Scargill Infant School,258,26,8,34
Havering,Scargill Junior School,328,38,8,46
Staffordshire,St Saviour's CofE Academy,186,19,5,24
Stoke-on-Trent,Stoke Minster CofE Primary Academy,404,70,10,80
Bury,Sunny Bank Primary School,218,19,6,25
Lincolnshire,Caythorpe Primary School,88,13,3,16
Bedford,Wixams Academy,802,86,27,113
Havering,Whybridge Junior School,328,44,9,53
Peterborough,Lime Academy Abbotsmede,459,39,7,46
Peterborough,Lime Academy Parnwell,362,39,1,40
West Sussex,Southgate Primary,330,45,2,47
Peterborough,Lime Academy Watergall,355,56,7,63
Northumberland,Ashington Academy,955,136,12,148
"Bournemouth, Christchurch and Poole",Livingstone Road Junior School,231,28,7,35
Thurrock,Bulphan Church of England Academy,67,3,0,3
Staffordshire,Gentleshaw Primary Academy,204,20,3,23
"Kingston upon Hull, City of",Griffin Primary School,439,79,0,79
Barnsley,Holy Trinity Catholic and Church of England School,1109,135,36,171
Derbyshire,Ironville and Codnor Park Primary School,119,43,1,44
Bracknell Forest,Jennett's Park CofE Primary School,418,57,19,76
Wigan,Leigh CofE Primary School,313,76,10,86
Reading,Reading Girls' School,795,100,9,109
Nottinghamshire,Samuel Barlow Primary Academy,263,65,7,72
Derbyshire,Cloudside Academy,269,94,0,94
Kent,Royal Rise Primary School,203,21,2,23
Halton,The Grange School,1130,227,55,282
Sefton,Stanley High School,814,110,16,126
Leicestershire,Clovelly House School,13,0,13,13
Wandsworth,Belleville Wix Academy,289,29,5,34
Hertfordshire,Barclay Academy,814,140,22,162
Derby,Breadsall Hill Top Primary School,423,73,5,78
Suffolk,Chelmondiston Church of England Primary School,115,14,3,17
Croydon,Cypress Primary School,668,92,7,99
Oldham,Co-op Academy Failsworth,1453,234,25,259
Bracknell Forest,Great Hollands Primary School,282,68,22,90
Leicester,Orchard Mead Academy,1121,150,35,185
Sandwell,Holyhead Primary Academy,208,24,2,26
Essex,Milwards Primary School and Nursery,202,28,8,36
Wirral,Co-op Academy Portland,193,77,0,77
Warwickshire,Venture Academy,45,0,45,45
Kent,Bishop Chavasse Primary School,311,36,5,41
Sandwell,Rounds Green Primary School,390,50,14,64
Wokingham,The Coombes Church of England Primary School,406,36,7,43
Isles of Scilly,The Five Islands Academy,263,14,9,23
Medway,Miers Court Primary School,394,79,5,84
Norfolk,Bignold Primary School and Nursery,462,75,7,82
Nottinghamshire,Yeoman Park Academy,111,0,111,111
Nottinghamshire,"St. Mary's Church of England Primary School, Edwinstowe",110,9,0,9
Essex,Ridgewell Church of England Primary School,61,10,0,10
Lancashire,Bay Leadership Academy,699,156,26,182
North Yorkshire,Trinity Academy Richmond,162,30,5,35
Warwickshire,Heathcote Primary School,336,42,12,54
Trafford,Barton Clough Primary School,173,30,26,56
Worcestershire,Birchen Coppice Academy,205,65,8,73
York,New Earswick Primary School,222,22,6,28
York,York High School,720,102,18,120
Barnet,Summerside Primary Academy,432,82,26,108
"Bristol, City of",Knowle DGE Academy,165,0,165,165
Doncaster,Green Top,464,71,6,77
Dudley,St James Academy,816,98,13,111
County Durham,Ouston Primary School,258,31,6,37
East Sussex,Parkland Infant School,178,24,1,25
East Sussex,Parkland Junior School,251,33,5,38
East Sussex,Peacehaven Community School,888,145,47,192
East Sussex,Shinewater Primary School,418,77,6,83
Essex,Fawbert and Barnard's Primary School,210,17,2,19
Essex,Harlowbury Primary School,201,26,19,45
Essex,Tany's Dell Primary School and Nursery,442,73,15,88
Kent,West Hill Primary Academy,534,71,7,78
"Kingston upon Hull, City of",Broadacre Primary School,578,53,14,67
"Kingston upon Hull, City of",Parkstone Primary School,333,32,7,39
"Kingston upon Hull, City of",Marfleet Primary Academy,208,42,4,46
"Kingston upon Hull, City of",Adelaide Primary School,465,108,17,125
"Kingston upon Hull, City of",Victoria Dock Primary School,301,58,7,65
"Kingston upon Hull, City of",Thanet Primary School,428,52,11,63
"Kingston upon Hull, City of",Woodland Primary School,200,49,4,53
"Kingston upon Hull, City of",Clifton Primary School,381,70,7,77
North Yorkshire,Glaisdale Primary School,28,4,0,4
North Yorkshire,Airy Hill Primary School,201,19,10,29
North Yorkshire,Castleton Primary School,54,7,3,10
North Yorkshire,West Cliff Primary School,211,22,11,33
North Yorkshire,Lealholm Primary School,31,5,1,6
West Northamptonshire,Kingsley Primary School,398,18,9,27
North Northamptonshire,Wren Spinney Community School,87,0,87,87
West Northamptonshire,Hospital and Outreach Education,6,5,1,6
Nottingham,Stanstead Nursery and Primary School,193,29,1,30
Nottinghamshire,The Garibaldi School,952,82,8,90
Oxfordshire,Northbourne Church of England Primary School,346,60,9,69
Rochdale,St James' Church of England Primary School,208,14,4,18
Rochdale,St Andrew's Church of England Primary School and Nursery,451,31,7,38
Southend-on-Sea,St Nicholas School,90,1,89,90
Southend-on-Sea,Kingsdown School,124,0,124,124
Southend-on-Sea,Lancaster School,126,0,126,126
Southend-on-Sea,Temple Sutton Primary School,779,91,37,128
Stoke-on-Trent,Grove Academy,391,98,10,108
Surrey,Merstham Primary School,218,31,6,37
Tameside,Waterloo Primary School,331,30,7,37
Tower Hamlets,The Clara Grant Primary School,449,67,26,93
Tower Hamlets,Mulberry Stepney Green Mathematics and Computing College,1302,81,34,115
Wiltshire,Aloeric Primary School,387,71,16,87
Wiltshire,Ivy Lane Primary School,442,60,11,71
York,Hob Moor Community Primary Academy,297,31,15,46
York,Hob Moor Oaks Academy,115,0,115,115
York,Lakeside Primary Academy,217,15,5,20
York,Fulford School,1650,143,27,170
York,Wheldrake with Thorganby Church of England Primary School,196,27,4,31
York,Dunnington Church of England Primary School,204,11,0,11
Kent,School of Science and Technology Maidstone,576,83,20,103
"Herefordshire, County of",Hidelow Grange School,7,3,4,7
Birmingham,Holy Trinity Catholic School,708,84,10,94
Birmingham,John Willmott School,924,182,6,188
Birmingham,Springfield Primary Academy,499,51,2,53
"Bristol, City of",St Mary Redcliffe Church of England Primary School,412,65,3,68
Hertfordshire,Rhodes Wood Hospital School,37,36,1,37
Barnet,Lubavitch Yeshiva Ketanah of London,35,0,0,0
Surrey,Aurora Redehall School,71,0,71,71
Nottinghamshire,The Lanes Primary School,602,56,1,57
Kirklees,"Honley CofE (VC) Junior, Infant and Nursery School",433,59,15,74
Bath and North East Somerset,Abbot Alphege Academy,64,17,6,23
Harrow,Gesher School,49,0,49,49
Newham,Bobby Moore Academy,1037,130,22,152
Surrey,Chertsey High School,846,134,31,165
Cheshire West and Chester,Chester International School,253,16,16,32
Leeds,Dixons Trinity Chapeltown,886,169,8,177
Manchester,"Eden Boys' Leadership Academy, Manchester",627,106,26,132
Manchester,"Eden Girls' Leadership Academy , Manchester",625,53,11,64
Bedford,Great Ouse Primary Academy,383,53,6,59
Buckinghamshire,Green Ridge Primary Academy,478,53,15,68
Slough,Grove Academy,948,114,23,137
Leicestershire,"Hallam Fields, Birstall",168,23,6,29
Thurrock,Harris Academy Riverside,1016,92,38,130
Southampton,Hope Community School Southampton,188,22,10,32
Barnet,Kisharon School,70,0,70,70
Haringey,London Academy of Excellence Tottenham,607,47,1,48
North Somerset,Parklands Educate Together Primary,253,26,7,33
Manchester,Manchester Enterprise Academy Central,1050,125,40,165
Tower Hamlets,Mulberry UTC,384,25,9,34
Somerset,Northgate Primary School,256,39,8,47
West Northamptonshire,Pineham Barns Primary School,340,11,1,12
West Northamptonshire,Purple Oaks Academy,116,0,116,116
Plymouth,Scott Medical and Healthcare College,277,42,4,46
Gloucestershire,SGS Berkeley Green UTC,294,64,4,68
Bath and North East Somerset,Somerdale Educate Together Primary Academy,239,27,5,32
Lincolnshire,Springwell Alternative Academy Spalding,35,25,10,35
Warwickshire,Quest Academy,100,0,100,100
"Kingston upon Hull, City of",Ron Dearing UTC,665,22,10,32
Nottinghamshire,The Suthers School,484,45,5,50
Norfolk,The Wherry School,110,0,110,110
Cambridgeshire,Trumpington Park Primary School,385,61,12,73
Swindon,Lawn Manor Academy,864,168,24,192
Sutton,Brookways School,68,0,68,68
"Bristol, City of",Badocks Wood E-ACT Academy,227,50,5,55
Barnet,Oak Hill School,47,0,47,47
Brent,East Lane Primary School,631,25,7,32
Westminster,Eaton Square Senior School,165,39,3,42
Brent,Edith Kay Independent School,20,0,20,20
Warrington,Great Sankey Primary School,354,29,3,32
Warrington,Sir Thomas Boteler Church of England High School,797,129,43,172
Worcestershire,Wilden All Saints CofE Primary School,210,43,1,44
County Durham,The Independent Grammar School:Durham,83,1,2,3
Barking and Dagenham,Alamiyah School,37,4,0,4
Derbyshire,Watchorn Christian School,27,3,1,4
Bedford,E-Spired Centre of Excellence,3,0,3,3
Hampshire,Releasing Potential School,39,0,39,39
Leeds,Bishop Young Church of England Academy,744,90,17,107
Kirklees,Rida Girls High School,117,0,0,0
Lancashire,Olive High,248,0,0,0
Essex,Open Box Education Centre,15,2,13,15
Derby,Cavendish Close Junior Academy,314,70,14,84
Essex,Katherines Primary Academy and Nursery,294,24,3,27
Leeds,"Christ The King Catholic Primary School, A Voluntary Academy",161,37,1,38
Norfolk,Burnham Market Primary School,99,28,2,30
Suffolk,Southwold Primary School,70,7,0,7
Suffolk,Brampton Church of England Primary School,82,16,1,17
Suffolk,Barnby and North Cove Community Primary School,83,7,0,7
Bath and North East Somerset,Midsomer Norton Primary School,267,36,2,38
Cheshire East,Brereton CofE Primary School,208,14,7,21
Cheshire East,Gawsworth Primary School,201,22,7,29
Essex,Hilltop Infant School,219,7,4,11
Kent,Charing Church of England Primary School,165,17,5,22
Kent,St Augustine's Catholic Primary School,287,38,8,46
Leicestershire,Old Mill Primary School,373,37,5,42
Merton,Aragon Primary School,594,91,7,98
Norfolk,Gresham Village School,178,9,2,11
North Yorkshire,Topcliffe CofE Academy,131,31,4,35
North Northamptonshire,Cranford CofE Primary School,100,11,2,13
Nottingham,Whitegate Primary and Nursery School,428,40,7,47
Plymouth,Stoke Damerel Primary School,398,18,10,28
Plymouth,Stuart Road Primary School,187,21,4,25
Portsmouth,Langstone Infant School,250,17,7,24
Portsmouth,Langstone Junior Academy,357,41,9,50
Rutland,Exton and Greetham CofE Primary School,64,10,2,12
Shropshire,Coleham Primary School,420,42,10,52
Suffolk,Ringsfield Church of England Primary School,112,10,2,12
Suffolk,Henley Primary School,101,8,3,11
Sutton,The Link School,146,0,146,146
Telford and Wrekin,Hadley Learning Community - Secondary Phase,1175,217,46,263
Wiltshire,St John's CofE School,104,12,3,15
Wirral,Progress Schools - Wirral,27,18,1,19
Kirklees,Pivot Acadmey,96,17,52,69
North Northamptonshire,Isham Church of England Primary School,103,9,2,11
Worcestershire,Inkberrow Primary School,186,25,2,27
Bradford,Hollingwood Primary School,469,64,20,84
Bradford,Laycock Primary School,93,7,3,10
Bradford,Farnham Primary School,473,39,7,46
"Bristol, City of",Victoria Park Primary School,416,60,6,66
"Bristol, City of",Headley Park Primary School,455,62,6,68
Calderdale,Lightcliffe C of E Primary School,413,20,6,26
Essex,Belchamp St Paul Church of England Primary School,64,6,0,6
Kent,Borden Church of England Primary School,123,11,6,17
Kent,Bredgar Church of England Primary School,108,7,1,8
Kent,Minterne Junior School,374,57,41,98
Kent,The Oaks Infant School,324,52,12,64
Oxfordshire,Thameside Primary School,189,54,5,59
Oxfordshire,"St Mary's Church of England Primary School, Banbury",215,48,6,54
"Bournemouth, Christchurch and Poole",Bishop Aldhelm's Church of England Primary School,643,85,16,101
"Bournemouth, Christchurch and Poole",Talbot Primary School,611,65,9,74
Redbridge,Newbridge School,159,5,154,159
Southend-on-Sea,Bournes Green Junior School,263,18,8,26
Southend-on-Sea,Richmond Avenue Primary and Nursery School,434,58,7,65
Suffolk,Alderwood Academy,0,0,0,0
"Bristol, City of",Perry Court E-ACT Academy,462,97,8,105
Essex,Stapleford Abbotts Primary School,158,13,6,19
Hampshire,Sun Hill Junior School,200,20,6,26
Harrow,Earlsmead Primary School,327,16,16,32
Norfolk,Reffley Academy,370,29,7,36
Nottinghamshire,The West Park Academy,235,23,2,25
Bexley,St Michael's East Wickham Church of England  Primary School,157,12,3,15
Bradford,Beckfoot Priestthorpe Primary School & Nursery,201,26,4,30
Bradford,Beckfoot Phoenix,109,0,109,109
"Bristol, City of",Fonthill Primary Academy,215,52,4,56
Bromley,Glebe School,261,1,260,261
Cornwall,Sennen Community Primary Academy,89,17,0,17
Cornwall,Egloskerry Primary School,99,13,3,16
Devon,Wembury Primary School,187,21,4,25
Essex,Kingswode Hoe School,151,1,150,151
Gloucestershire,Rowanfield Infant School,248,46,6,52
Hampshire,Farnborough Grange Nursery & Infant Community School,223,26,9,35
Haringey,Duke's Aldridge,1066,105,35,140
Hartlepool,Holy Trinity Church of England Primary School,239,40,1,41
Hartlepool,St Aidan's Church of England Memorial Primary School,346,60,2,62
Hertfordshire,Wilbury Junior School,269,56,5,61
Hertfordshire,The Grange Academy,197,45,3,48
Hertfordshire,Warren Dell Primary School,262,41,18,59
Hertfordshire,Oxhey Wood Primary School,367,64,19,83
Hertfordshire,Alban Wood Primary School and Nursery,240,35,7,42
Hertfordshire,Bromet Primary School,275,31,1,32
Hertfordshire,Broadfield Academy,395,83,10,93
Kent,Sutton-At-Hone Church of England Primary School,400,58,5,63
Leicestershire,Hinckley Parks Primary School,573,73,15,88
Lincolnshire,The Marton Academy,93,6,1,7
Manchester,Rolls Crescent Primary School,424,86,14,100
Medway,St Margaret's at Troy Town CofE Voluntary Controlled Primary School,225,28,1,29
Medway,Bligh Primary School (Infants),325,29,2,31
North Somerset,Milton Park Primary School,344,35,5,40
North Somerset,Bournville Primary School,485,123,19,142
North Somerset,Hutton Church of England Primary School,205,34,2,36
North Somerset,Christ Church Church of England Primary School,206,40,8,48
North Somerset,St Martin's Church of England Primary School,348,36,6,42
North Somerset,Walliscote Primary School,284,24,4,28
North Somerset,Becket Primary School,201,19,4,23
North Somerset,Ashcombe Primary School,620,39,21,60
North Somerset,Windwhistle Primary School,333,72,4,76
North Somerset,Locking Primary School,276,35,5,40
North Somerset,Oldmixon Primary School,245,35,5,40
North Somerset,Worle Village Primary School,186,21,3,24
North Yorkshire,Barlby High School,546,52,15,67
North Yorkshire,Tockwith Church of England Primary Academy,220,26,3,29
North Yorkshire,Selby Community Primary School,396,55,9,64
Nottinghamshire,The Carlton Junior Academy,231,48,3,51
Plymouth,Morley Meadow Primary School,196,26,3,29
Rochdale,St Patrick's Roman Catholic Primary School,300,40,17,57
Staffordshire,Birches First School,148,18,0,18
Stockton-on-Tees,Egglescliffe Church of England Primary School,220,16,5,21
Sunderland,Washington Academy,661,157,32,189
Surrey,Sandcross Primary School,659,147,25,172
Surrey,St Stephen's CofE Primary School,237,20,18,38
Sutton,All Saints Carshalton Church of England Primary School,447,24,10,34
Telford and Wrekin,Hadley Learning Community - Primary Phase,665,190,6,196
Blackpool,Westminster Primary Academy,406,115,8,123
Calderdale,Trinity Academy Grammar,918,152,32,184
Cambridgeshire,Downham Feoffees Primary Academy,159,15,3,18
Derbyshire,Somerlea Park Junior School,137,19,4,23
Doncaster,Atlas Academy,376,65,6,71
Dorset,St Andrew's Church of England Primary School,84,12,3,15
Dudley,The Link Academy,930,180,19,199
County Durham,Sacriston Academy,190,38,5,43
East Sussex,Ocklynge Junior School,798,154,5,159
Essex,Silver End Academy,341,11,12,23
Essex,Southview School,77,8,69,77
Hertfordshire,Bedmond Academy,91,25,7,32
Hertfordshire,Manor Fields Primary School,451,28,18,46
Islington,City of London Academy Highbury Grove,1150,243,31,274
Kirklees,Healey Junior Infant and Nursery School,371,49,6,55
Hammersmith and Fulham,Kensington Wade,107,25,0,25
Lincolnshire,Louth Academy,870,129,28,157
Medway,Featherby Junior School,339,57,1,58
Newcastle upon Tyne,Westgate Hill Primary Academy,781,103,2,105
Newcastle upon Tyne,St Michael's RC Primary School,229,18,8,26
Norfolk,Rockland St Mary Primary School,56,2,2,4
Norfolk,Surlingham Primary School,61,6,0,6
Norfolk,Thurlton Primary School,61,3,2,5
Norfolk,Wells-Next-the-Sea Primary and Nursery School,225,46,5,51
North Yorkshire,Outwood Academy Easingwold,709,65,17,82
Northumberland,Bedlington Academy,810,107,10,117
Nottinghamshire,Netherfield Primary School,455,59,3,62
Nottinghamshire,Robert Mellors Primary Academy,308,43,2,45
Peterborough,Thorpe Primary School,530,59,12,71
Rochdale,"Alice Ingham Catholic Primary School, A Voluntary Academy",148,15,1,16
Shropshire,Tilstock CofE Primary and Nursery,95,19,2,21
Somerset,Wembdon St George's Church School,329,40,11,51
Somerset,Holy Trinity Church of England Primary School,442,55,12,67
South Gloucestershire,The Meadows Primary School,166,18,5,23
Southend-on-Sea,Our Lady of Lourdes Catholic Primary School,460,46,8,54
Staffordshire,Great Wyrley Academy,535,69,12,81
Staffordshire,Bird's Bush Primary School,184,27,6,33
Sunderland,Thornhill Academy,578,77,14,91
County Durham,Staindrop Academy,387,82,12,94
Surrey,St Matthew's CofE Primary School,371,81,32,113
Wiltshire,New Close Primary School,123,35,2,37
Worcestershire,St George's CofE School,222,45,3,48
Worcestershire,St John's CofE Primary School,315,76,5,81
Worcestershire,Badsey First School,157,12,3,15
Worcestershire,Bretforton Village School,59,8,0,8
Wolverhampton,Ormiston SWB Academy,1166,188,24,212
Southend-on-Sea,Westborough Academy,458,75,9,84
Bexley,St. Paul's (Slade Green) Church of England Primary School,366,69,16,85
Kent,Morehall Primary School and Nursery,228,18,3,21
Kent,Richmond Academy,325,88,10,98
Kent,Knockhall Primary School,385,27,9,36
East Sussex,White House Academy,193,30,3,33
East Sussex,Phoenix Academy,97,26,2,28
Rotherham,Monkwood Primary School,452,105,6,111
Nottingham,Victoria Primary School,330,48,2,50
Warwickshire,Kingsbury School - A Specialist Science and Mathematics Academy,705,107,13,120
Essex,Monkwick Junior School,230,51,6,57
North Somerset,Dundry Church of England Primary School,89,16,3,19
North Yorkshire,Coppice Valley Primary School,205,25,4,29
Norfolk,Admirals Academy,241,66,7,73
Norfolk,Norwich Road Academy,317,54,9,63
Wandsworth,The Alton School,190,49,16,65
Suffolk,The Pines Primary School,222,25,1,26
Buckinghamshire,Great Horwood Church of England School,79,10,2,12
Buckinghamshire,Chesham Bois Church of England  School,216,15,4,19
Cambridgeshire,Trumpington Community College,457,52,21,73
Cheshire East,Excalibur Primary School,217,22,7,29
Cheshire East,Pikemere School,243,19,17,36
County Durham,South Stanley Junior School,162,33,2,35
Hillingdon,West Drayton Academy,664,83,14,97
Medway,Featherby Infant and Nursery School,297,32,0,32
Milton Keynes,Jubilee Wood Primary School,534,91,3,94
Redbridge,Farnham Green Primary School,388,49,15,64
Redbridge,Ray Lodge Primary School,670,116,18,134
Redcar and Cleveland,Riverdale Primary School,211,25,1,26
Staffordshire,Sir Thomas Boughey Academy,492,48,9,57
Staffordshire,Great Wood Community Primary School,115,9,0,9
Essex,North Crescent Primary School,180,27,5,32
Essex,Epping St Johns Church of England School,1015,106,11,117
Peterborough,Queen Katharine Academy,1559,203,14,217
Lincolnshire,The Priory Pembroke Academy,517,74,35,109
Staffordshire,Bishop Rawle CofE Primary School,142,18,2,20
Stockport,Bredbury Green Primary School,257,37,13,50
Suffolk,Stowmarket High School,872,73,23,96
South Gloucestershire,SGS Pegasus School,91,0,91,91
Wolverhampton,Woodbury School,25,0,25,25
Wandsworth,Griffin Primary School,176,30,18,48
Essex,Harwich and Dovercourt High School,1133,161,19,180
Milton Keynes,Kents Hill Park all-through school,931,119,19,138
Kent,Cherry Tree,9,0,9,9
Southampton,Weston Park Primary School,491,54,13,67
Buckinghamshire,Thomas Harding Junior School,222,39,10,49
Bath and North East Somerset,Farmborough Church Primary School,174,24,3,27
Bexley,Jubilee Primary School,196,19,7,26
Bradford,East Morton CofE Primary School,237,7,1,8
Bromley,Blenheim Primary School,201,27,9,36
Cheshire West and Chester,Upton Heath CofE Primary School,417,38,9,47
Cheshire West and Chester,Little Sutton C of E Primary School,168,14,1,15
Cheshire West and Chester,Clutton Church of England Primary School,59,4,3,7
Cornwall,Cusgarne Primary School,78,5,0,5
Cornwall,Lanner Primary School,219,30,3,33
Doncaster,Intake Primary Academy,250,33,3,36
Doncaster,Hatchell Wood Primary Academy,404,52,10,62
Kent,"St Mark's Church of England Primary School, Eccles",128,20,2,22
Lancashire,Carnforth High School,650,78,21,99
Leicestershire,Sherard Primary School,373,35,39,74
Leicestershire,Blackfordby St Margaret's Church of England Primary School,93,10,1,11
Liverpool,The Beacon Church of England Primary School,484,78,3,81
Newham,Rosetta Primary School,572,62,16,78
Newham,Earlham Primary School,450,58,12,70
Norfolk,Alderman Peel High School,582,114,20,134
North Yorkshire,Richmond School,1253,185,16,201
West Northamptonshire,Blakesley Church of England Primary School,101,9,2,11
Nottinghamshire,Alderman Pounder Infant and Nursery School,235,22,0,22
Nottinghamshire,The Carlton Infant Academy,209,26,1,27
Oxfordshire,Hill View Primary School,491,97,14,111
Rotherham,Anston Park Infant School,157,22,3,25
Sefton,"St Thomas Church of England Primary School, Lydiate",240,15,0,15
Staffordshire,William Shrewsbury Primary School,661,66,14,80
Staffordshire,The Meadows Primary School,102,11,1,12
Staffordshire,Outwoods Primary School,456,66,13,79
Staffordshire,John of Rolleston Primary School,364,19,4,23
Suffolk,First Base Ipswich Academy,0,0,0,0
Surrey,The Marist Catholic Primary School,424,52,16,68
Torbay,Collaton St Mary Church of England Primary School,205,21,9,30
Torbay,Galmpton Church of England Primary School,222,23,8,31
Waltham Forest,George Mitchell School,1024,88,38,126
Wigan,St James' Church of England Primary School,252,56,10,66
Cornwall,Brannel School,898,160,23,183
Derbyshire,Frederick Gent School,796,143,18,161
Essex,Glebe Primary School,426,51,22,73
Havering,Harrow Lodge Primary School,412,26,13,39
Medway,Maundene School,395,71,4,75
Newham,Cumberland Community School,1417,113,28,141
Wolverhampton,Coppice Performing Arts School,998,203,25,228
Kent,Chilmington Green Primary School,205,25,12,37
East Sussex,Compass Community School South,4,1,3,4
Kent,Riverview Junior School,504,71,12,83
Suffolk,Piper's Vale Primary - A Paradigm Academy,325,37,15,52
Dorset,Atlantic Academy Portland,787,236,39,275
Birmingham,Lordswood Boys' School,496,40,4,44
Hillingdon,Park Academy West London,831,114,28,142
Richmond upon Thames,Nelson Primary School,289,33,7,40
Gloucestershire,St John's C of E Academy,158,38,5,43
South Gloucestershire,Patchway Community School,765,134,16,150
Hampshire,Everest Community Academy,655,101,16,117
Westminster,Harris Academy St John's Wood,1383,130,28,158
Darlington,Embleton View,23,0,23,23
Nottingham,Take 1 Learning Centre,17,8,2,10
Southwark,Goose Green Primary and Nursery School,302,56,6,62
Croydon,Castle Hill Academy,295,88,44,132
Derby,City of Derby Academy,961,153,17,170
Stockport,Reddish Vale High School,1035,167,25,192
Wolverhampton,Ormiston NEW Academy,867,114,15,129
South Gloucestershire,Yate Academy,779,93,28,121
Middlesbrough,Hemlington Hall Academy,323,58,27,85
Cumbria,Tebay Primary School,49,7,2,9
Cumbria,Yanwath Primary School,150,12,1,13
Swindon,Kingsdown School,942,144,46,190
Bexley,Harris Garrard Academy,1477,179,29,208
Harrow,Avanti House Primary School,420,19,7,26
Nottingham,Bluecoat Primary Academy,443,48,9,57
Nottingham,Bluecoat Wollaton Academy,781,114,15,129
Cambridgeshire,Murrow Primary Academy,99,8,3,11
Swindon,UTC Swindon,184,66,4,70
Warrington,Penketh High School,895,116,44,160
Leicestershire,Melton Vale Sixth Form College,399,33,7,40
Norfolk,Kingsbrook School,14,0,14,14
Liverpool,Peregrinate Ltd.,36,0,2,2
Wandsworth,Tram House School,62,0,62,62
Wiltshire,St. Peter's CE Primary Academy,271,32,6,38
Surrey,The Beech House School,4,0,4,4
Rochdale,Elizabeth House School,4,0,1,1
Bradford,Appleton Academy,1237,218,46,264
Staffordshire,Brewood Middle CofE Academy,444,49,10,59
East Riding of Yorkshire,Croxby Primary School,352,41,8,49
Leeds,The Richmond Hill Academy,625,147,36,183
Coventry,Stoke Park School,1035,223,14,237
Bradford,Clayton St John CofE Primary School,407,42,7,49
Devon,On Track Education Services Ltd,53,0,52,52
Liverpool,Birtenshaw School Merseyside,78,0,78,78
Northumberland,Buzz Learning Independent Specialist School,20,0,20,20
Wigan,Progress Schools Wigan,4,1,3,4
Redcar and Cleveland,Outwood Academy Redcar,597,112,18,130
East Riding of Yorkshire,Easington CofE Primary Academy,28,6,0,6
East Riding of Yorkshire,Patrington CofE Primary Academy,224,22,8,30
Sheffield,Ecclesfield School,1711,313,21,334
Havering,Bep Academy,47,3,11,14
Lancashire,Aspire Hub Burnley,2,1,1,2
Richmond upon Thames,Falcons Prep - Richmond,90,17,3,20
Norfolk,Downham Market Academy,1209,165,31,196
Croydon,Harris Professional Skills Sixth Form,243,56,8,64
Wiltshire,The Springfields Academy,231,0,231,231
Somerset,Ashill Community Primary School,51,6,0,6
Warwickshire,Brooke School,208,6,202,208
Enfield,Carterhatch Junior School,342,59,10,69
Shropshire,Castlefields Primary School,233,15,3,18
Leicestershire,Church Langton Church of England Primary School,207,13,6,19
Bromley,Churchfields Primary School,486,45,29,74
Surrey,Dovers Green School,272,56,26,82
West Northamptonshire,East Hunsbury Primary School,427,44,52,96
Enfield,Grange Park Primary School,801,51,15,66
Bexley,Gravel Hill Primary School,420,48,15,63
Norfolk,Great Hockham Primary School and Nursery,113,24,0,24
Greenwich,Greenacres Primary School and Language Impairment Unit,276,54,16,70
Cornwall,Hayle Academy,510,77,22,99
"Bournemouth, Christchurch and Poole",Heatherlands Primary School,628,104,10,114
Surrey,Holmesdale Community Infant School,337,18,3,21
Coventry,Leigh Church of England Academy,222,33,6,39
Greenwich,Nightingale Primary School,230,33,5,38
Buckinghamshire,Padbury Church of England School,101,12,0,12
Surrey,Reigate School,1255,194,39,233
Staffordshire,Rykneld Primary School,625,47,6,53
Bedford,Springfield Primary School,367,46,10,56
Bradford,St John's CofE Primary School,445,49,8,57
Shropshire,St Leonard's CofE Primary School,291,56,4,60
Southampton,Thornhill Primary School,371,72,14,86
Stockton-on-Tees,Whinstone Primary School,474,31,9,40
Warwickshire,Woodlands,217,1,216,217
Bradford,Woodlands Church of England Primary Academy,113,13,1,14
Surrey,Wray Common Primary School,433,57,13,70
Medway,City of Rochester School,47,0,47,47
Enfield,Fern House School,67,1,66,67
Derbyshire,Bolsover Church of England Junior School,277,45,4,49
Suffolk,Ixworth Church of England Primary School,138,26,0,26
Newham,Monega Primary School,617,42,15,57
Kirklees,Brambles Primary Academy,258,19,8,27
Suffolk,Rougham Church of England Primary School,202,22,3,25
North Tyneside,Brenkley School,20,0,20,20
North Yorkshire,Fenton Grange School,6,2,4,6
Lancashire,Linton School,12,0,12,12
Bracknell Forest,Edgbarrow School,1497,91,43,134
Buckinghamshire,Great Kingshill Church of England Combined School,420,35,7,42
Cambridgeshire,Thriplow CofE Primary School,112,12,0,12
Cheshire East,Puss Bank School and Nursery,442,47,28,75
Derbyshire,Dunston Primary and Nursery Academy,298,42,13,55
Derbyshire,Street Lane Primary School,94,11,1,12
Devon,Rockbeare Church of England Primary School and Pre-School,105,9,3,12
County Durham,Ferryhill School,785,158,16,174
East Sussex,Hazel Court School,120,0,120,120
Hertfordshire,Grove Road Primary School,457,27,4,31
Hertfordshire,Hartsbourne Primary School,201,24,3,27
Hertfordshire,Waterside Academy,178,25,9,34
North Somerset,Grove Junior School,239,33,2,35
North Somerset,West Leigh Infant School,157,5,3,8
North Somerset,Hannah More Infant School,153,18,1,19
North Somerset,Yatton Church of England Junior School,338,29,8,37
North Somerset,Northleaze Church of England Primary School,213,11,3,14
North Somerset,Backwell Church of England Junior School,240,14,2,16
Peterborough,Ravensthorpe Primary School,379,50,7,57
Peterborough,Longthorpe Primary School,417,28,11,39
Peterborough,Gunthorpe Primary School,396,51,8,59
Peterborough,Wittering Primary School,315,32,11,43
Peterborough,John Clare Primary School,132,8,1,9
Peterborough,Jack Hunt School,1870,97,10,107
Peterborough,Werrington Primary School,411,48,8,56
Rotherham,Kilnhurst St Thomas' CofE Primary Academy,233,50,7,57
Sheffield,Stocksbridge High School,788,108,23,131
Shropshire,Condover CofE Primary School,115,13,2,15
Staffordshire,Rocklands School,127,0,127,127
Suffolk,West Row Academy,221,35,3,38
Surrey,Potters Gate CofE Primary School,535,68,11,79
Surrey,South Camberley Primary and Nursery School,621,115,16,131
Wandsworth,Chesterton Primary School,407,48,18,66
Wokingham,Nine Mile Ride Primary School,367,32,7,39
Wokingham,Oaklands Junior School,253,16,7,23
Wokingham,Oaklands Infant School,157,16,1,17
Wokingham,Hatch Ride Primary School,202,19,5,24
Wokingham,Saint Sebastians  Church of England Primary School,135,18,4,22
Wokingham,St Crispin's School,1384,179,50,229
Middlesbrough,Chandlers Ridge Academy,352,30,6,36
Wolverhampton,Trinity CofE Primary Academy,710,62,6,68
Wigan,Expanse Learning Wigan School,45,1,44,45
Tameside,Greater Manchester Alternative Provision,19,15,4,19
Cumbria,St Bees School,98,11,0,11
Somerset,The Orchard School,6,5,1,6
Haringey,Unique Children's School,4,0,4,4
Lancashire,Rosa House School,3,0,1,1
Hertfordshire,Goffs - Churchgate Academy,603,125,27,152
Buckinghamshire,Eton Dorney Independent Therapeutic School,36,0,36,36
Norfolk,Corpusty Primary School,26,6,0,6
Shropshire,St Edward's CofE Primary School,32,8,0,8
Norfolk,Drayton Community Infant School,250,19,3,22
Cambridgeshire,Farcet CofE (C) Primary School,111,16,5,21
Bradford,Holybrook Primary School,246,46,22,68
Norfolk,Kenninghall Primary School,86,16,3,19
Dudley,Priory Primary School,610,77,25,102
Leeds,Co-op Academy Beckfield,211,23,2,25
Norfolk,Queensway Infant Academy and Nursery,170,57,5,62
Somerset,Park House School,19,0,19,19
Southwark,Bacon's College,1028,132,28,160
Bolton,Bolton St Catherine's Academy,1061,304,32,336
Greenwich,The Halley Academy,876,112,28,140
Bracknell Forest,Wildmoor Heath School,201,20,7,27
"Bristol, City of",Compass Point Primary School,195,33,24,57
"Bristol, City of",Ashton Vale Primary School,185,34,2,36
Buckinghamshire,The Misbourne School,1065,145,45,190
Buckinghamshire,Great Kimble Church of England School,100,10,3,13
Central Bedfordshire,St Mary's Catholic Primary School,248,31,10,41
Central Bedfordshire,St Vincent's Catholic Primary School,215,43,3,46
Cumbria,Bassenthwaite Primary School,31,2,1,3
Derby,Derby Moor Spencer Academy,1680,142,42,184
Derbyshire,John King Infant Academy,104,8,1,9
Derbyshire,Longwood Infant Academy,50,8,1,9
Devon,Boasley Cross Community Primary School,36,3,1,4
Devon,Bridestowe Primary School,82,14,6,20
Devon,Lydford Primary School,36,5,1,6
Devon,North Tawton Community Primary School and Nursery,195,26,8,34
Devon,Okehampton Primary School and Foundation Unit,556,86,28,114
Devon,South Tawton Primary School,216,29,4,33
Devon,Tavistock College,1322,132,40,172
Devon,Okehampton College,1306,131,38,169
Devon,Chagford Church of England Primary School,152,18,3,21
Devon,Exbourne Church of England Primary School,49,10,2,12
Devon,Northlew and Ashbury Parochial Church of England Primary School,31,3,1,4
Devon,Black Torrington Church of England Primary School,16,8,0,8
Devon,Bridgerule Church of England Primary School,78,14,3,17
Devon,Holsworthy Community College,512,94,22,116
Devon,Yeoford Community Primary School,63,17,2,19
Devon,Tedburn St Mary School,95,7,2,9
Devon,Bradford Primary School,19,1,0,1
Devon,Dunsford Community Academy,92,3,3,6
Ealing,Dormers Wells High School,1493,116,32,148
Essex,Wyburns Primary School,192,27,11,38
Hertfordshire,Beechfield School,399,56,14,70
Hertfordshire,Meryfield Primary School,432,44,10,54
Hertfordshire,The Orchard Primary School,442,49,10,59
Hertfordshire,Cherry Tree Primary School,444,59,14,73
Kent,Vale View Community School,229,50,2,52
Leicester,Forest Lodge Academy,604,60,8,68
Lincolnshire,Waddington All Saints Academy,374,25,14,39
Liverpool,New Park Primary School,475,67,20,87
Liverpool,Roscoe Primary School,249,52,6,58
Newcastle upon Tyne,Newcastle Bridges School,33,4,24,28
Newham,Elmhurst Primary School,989,64,8,72
Newham,Hallsville Primary School,458,29,8,37
Newham,Nelson Primary School,805,103,23,126
Newham,Scott Wilkie Primary School,374,33,9,42
Newham,Vicarage Primary School,882,60,28,88
Newham,New City Primary School,632,78,14,92
Newham,Gallions Primary School,440,54,24,78
North Yorkshire,Sowerby Primary Academy,299,69,4,73
North Yorkshire,Carlton Miniott Primary Academy,206,22,3,25
Nottinghamshire,Willow Farm Primary School,213,12,3,15
Portsmouth,Castle View Academy,602,112,19,131
Sheffield,Windmill Hill Primary School,314,51,2,53
Sheffield,Greenhill Primary School,471,78,8,86
Staffordshire,Ryecroft CofE Middle School,193,22,6,28
Staffordshire,Oldfields Hall Middle School,511,75,11,86
Staffordshire,Grange School,153,12,3,15
Staffordshire,Marshbrook First School,189,22,4,26
Staffordshire,Princefield First School,215,37,4,41
Staffordshire,St John's CofE First School,76,9,3,12
Staffordshire,Wolgarston High School,813,75,8,83
Suffolk,"St Mary's Catholic Primary School, Ipswich",213,17,2,19
Surrey,Grafham Grange School,59,0,59,59
Surrey,St Dominic's School,153,0,153,153
Sutton,Stanley Park Infants School,291,21,4,25
Warrington,Park Road Community Primary School,211,13,3,16
Warrington,Chapelford Village Primary School,621,63,5,68
Warrington,Westbrook Old Hall Primary School,380,47,5,52
Warrington,Burtonwood Community Primary School,210,21,2,23
Warwickshire,Burton Green Church of England Academy,100,15,0,15
Warwickshire,All Saints Church of England Academy,131,18,1,19
Warwickshire,Rokeby Primary School,220,44,15,59
West Sussex,Brantridge School,75,0,75,75
Wolverhampton,Deyncourt Primary School,310,25,6,31
Wolverhampton,St Thomas' Church of England Primary Academy,203,36,12,48
Devon,Cheriton Bishop Community Primary School,113,22,0,22
"Bristol, City of",Ashton Park School,1238,213,32,245
"Bristol, City of",Luckwell Primary School,112,18,2,20
Calderdale,Dean Field Community Primary School,235,36,12,48
Cambridgeshire,Earith Primary School,97,18,4,22
Cumbria,SwitchED2,12,1,11,12
Derbyshire,Kirkstead Junior Academy,218,28,0,28
Devon,West Exe School,1180,204,36,240
Dorset,Emmanuel Middle Church of England Middle School,451,60,8,68
Ealing,Dormers Wells Junior School,321,55,7,62
Essex,Rayne Primary and Nursery School,229,21,6,27
Gloucestershire,Coaley Church of England Primary Academy,64,11,3,14
Hertfordshire,Springmead Primary School,292,45,3,48
Newham,Royal Docks Academy,883,128,82,210
North Yorkshire,Outwood Primary Academy Greystone,159,14,6,20
Northumberland,Shaftoe Trust Academy,111,18,1,19
Sheffield,Norfolk Community Primary School,457,100,12,112
Staffordshire,Dosthill Primary School,529,59,4,63
Warwickshire,Salford Priors CofE Academy,60,25,2,27
Slough,Al-Madani Independent Grammar School,82,2,0,2
Birmingham,New Ways School,24,0,24,24
Kent,Folkestone Academy,1080,216,32,248
Essex,Hilltop Junior School,349,26,3,29
Buckinghamshire,"St John's Church of England Primary School, Lacey Green",201,28,4,32
Cambridgeshire,Fen Ditton Primary School,148,19,8,27
Cambridgeshire,Stapleford Community Primary School,207,30,3,33
Cambridgeshire,Bottisham Community Primary School,300,19,5,24
Central Bedfordshire,Totternhoe Church of England Academy,188,24,9,33
Central Bedfordshire,Lawnside Academy,171,18,6,24
"Bournemouth, Christchurch and Poole",Christchurch Junior School,495,64,7,71
County Durham,Hartside Primary Academy,218,46,4,50
Hertfordshire,The Adeyfield Academy,709,184,23,207
"Kingston upon Hull, City of",Sidmouth Primary School,420,37,8,45
Kirklees,Engage Academy,13,5,8,13
Kirklees,Ethos College,23,1,22,23
Kirklees,Reach Academy,12,8,3,11
Knowsley,Huyton With Roby Church of England Primary School,425,68,14,82
Lincolnshire,Tattershall Holy Trinity Church of England Primary School,88,24,2,26
Lincolnshire,Bassingham Primary School,175,7,3,10
Liverpool,"Bishop Martin Church of England Primary School, Woolton",205,44,5,49
Manchester,Wilbraham Primary School,652,87,19,106
Medway,Hilltop Primary Academy,436,70,6,76
Norfolk,North Walsham Junior School,307,63,7,70
Norfolk,North Walsham Infant School,189,32,1,33
North Somerset,St Nicholas Chantry Church of England Primary School,355,31,1,32
North Somerset,Yatton Infant School,182,10,1,11
North Somerset,Flax Bourton Church of England Primary School,210,12,7,19
West Northamptonshire,Ashby Fields Primary School,367,45,4,49
Nottinghamshire,St Swithun's Church of England Primary Academy,117,17,4,21
Oxfordshire,Wootton-By-Woodstock Church of England Primary School,25,8,0,8
Portsmouth,King's Academy Northern Parade (Junior),441,67,12,79
Portsmouth,King's Academy Northern Parade (Infant),262,45,6,51
Portsmouth,King's Academy College Park (Infant),335,48,4,52
Sefton,"St Andrews Church of England Primary School, Maghull",251,28,2,30
Sefton,"Holy Trinity Church of England Primary School, Southport",209,24,1,25
Sheffield,High Storrs School,1695,179,40,219
Southampton,Sholing Junior School,351,48,6,54
Southampton,Sholing Infant School,270,39,7,46
St. Helens,"Parish Church of England Primary School, St Helens",221,24,4,28
Staffordshire,Richard Wakefield CofE Primary Academy,276,30,2,32
Suffolk,Wortham Primary School,98,12,1,13
North Lincolnshire,Act Fast NL Ltd,47,6,41,47
Liverpool,Employability Solutions Independent School,17,6,11,17
Cumbria,Moorfield Learning Centre,12,0,12,12
Shropshire,The Mews,5,0,1,1
Warwickshire,Brickyard Barn Outdoor Learning Centre,8,0,8,8
Essex,Brentwood County High School,1027,126,14,140
Hounslow,Southville Primary School,670,156,9,165
Suffolk,Glade Academy,226,28,6,34
Sunderland,Academy 360,893,178,50,228
Shropshire,The Prepatoria School,9,1,1,2
Hampshire,The Green Room School Kingsley,32,0,32,32
Gloucestershire,Henley Bank High School,741,189,20,209
Sutton,Cheam Common Infants' Academy,427,26,7,33
Bath and North East Somerset,Chew Valley School,1166,108,17,125
Worcestershire,Foley Park Primary Academy,241,59,4,63
Sutton,Manor Park Primary Academy,697,111,13,124
Trafford,Tyntesfield Primary School,448,47,0,47
Warwickshire,Welcombe Hills School,183,0,183,183
Hertfordshire,Beech Hyde Primary School and Nursery,168,18,4,22
Leicestershire,Blaby Stokes Church of England Primary School,342,50,3,53
Lincolnshire,Chapel St Leonards Primary School,131,19,5,24
Gateshead,Heworth Grange School,1055,99,19,118
Derbyshire,Langley Mill Academy,274,60,13,73
North Somerset,Mead Vale Community Primary School,238,38,4,42
Worcestershire,Wribbenhall School,4,0,4,4
Telford and Wrekin,Queensway,116,0,116,116
Buckinghamshire,Wooburn Green Primary School,138,27,2,29
"Bournemouth, Christchurch and Poole",Bayside Academy,247,69,3,72
Bradford,Eden Springs Girls Secondary,114,6,0,6
Derbyshire,John Port Spencer Academy,1929,290,20,310
Norfolk,Flegg High Ormiston Academy,785,122,18,140
South Gloucestershire,Winterbourne Academy,1861,209,26,235
Leicester,Jameah Boys Academy,139,0,0,0
Nottingham,Ambleside Primary School,628,153,6,159
Havering,The Bridge,24,9,3,12
Bath and North East Somerset,Bathampton Primary School,191,24,4,28
Bath and North East Somerset,Batheaston Church School,184,32,8,40
Bath and North East Somerset,St Saviours Junior Church School,198,27,6,33
Bath and North East Somerset,St Saviours Infant Church School,147,15,4,19
Bath and North East Somerset,Bathwick St Mary Church School,218,37,10,47
Bath and North East Somerset,St Andrew's Church School,222,34,12,46
Bath and North East Somerset,St Stephens Church School,334,32,6,38
Cornwall,St Cleer Primary Academy,240,24,5,29
Cornwall,Blisland Primary Academy,47,6,1,7
Derbyshire,Whittington Moor Nursery and Infant Academy,85,13,1,14
Derbyshire,Eckington School,1280,128,29,157
Enfield,Churchfield Primary School,553,90,20,110
Essex,"St Andrew's Church of England Primary School, Halstead",218,23,6,29
Gloucestershire,St Lawrence Church of England Primary School,196,22,3,25
Leeds,Pudsey Waterloo Primary,434,37,2,39
Leeds,Pudsey Primrose Hill Primary School,482,56,0,56
Lincolnshire,Coningsby St Michael's Church of England Primary School,296,44,6,50
Newcastle upon Tyne,Walker Riverside Academy,1158,132,33,165
Norfolk,Churchill Park Complex Needs School,219,0,219,219
Norfolk,Highgate Infant School,56,8,1,9
Norfolk,St Germans Academy,122,11,1,12
Norfolk,Magdalen Academy,46,4,4,8
Norfolk,Wimbotsham and Stow Academy,113,17,1,18
Norfolk,King's Oak Academy,137,31,4,35
Norfolk,Greyfriars Academy,258,39,12,51
Nottinghamshire,Mornington Primary School,295,40,3,43
Oldham,Greenacres Primary Academy,256,55,7,62
Staffordshire,Scotch Orchard Primary School,180,32,3,35
Suffolk,Hintlesham and Chattisham Church of England  Primary School,78,17,2,19
Suffolk,Rose Hill Primary,286,27,5,32
Suffolk,Poplars Community Primary School,349,60,13,73
Surrey,Westfield Primary School,436,91,4,95
Surrey,Wyke Primary Academy,206,24,4,28
West Sussex,Waterfield Primary School,355,53,6,59
Wiltshire,Larkhill Primary School,211,42,2,44
Nottinghamshire,Pollyteach Limited,12,0,12,12
Essex,Hadleigh Junior School,320,28,2,30
Devon,Tor View School,14,0,14,14
Newham,Jasper City School,0,0,0,0
Cambridgeshire,Gorefield Primary Academy,101,16,4,20
Wiltshire,Great Wishford CofE (VA) Primary School,63,20,1,21
Kirklees,Helme Church of England Academy,128,32,6,38
Essex,Jerounds Primary Academy,359,39,2,41
Leicester,Judgemeadow Community College,1199,82,9,91
Suffolk,Roman Hill Primary School,509,77,13,90
Bury,"St John's Church of England Primary School, Radcliffe",216,41,7,48
Cornwall,Trenode CofE VA Primary Academy,39,8,0,8
Sheffield,Westfield School,1245,205,22,227
Dudley,The Wenlock School,90,0,90,90
County Durham,Whitworth Park Academy,847,142,12,154
Harrow,Harrow Independent College,12,0,1,1
Calderdale,West Vale Academy,127,23,4,27
Derbyshire,Jasmine House School,10,0,10,10
Kent,Cross Keys Learning,34,0,34,34
Warwickshire,Bilton School,1097,144,25,169
Wakefield,St Botolphs CE Academy,330,45,16,61
Darlington,Longfield Academy,819,141,11,152
Wakefield,Trinity Academy Cathedral,1021,106,45,151
Birmingham,Arena Academy,1108,129,4,133
Nottingham,CP Riverside School,5,1,0,1
Bath and North East Somerset,Bathford Church School,178,25,7,32
Bath and North East Somerset,Freshford Church School,155,26,1,27
Bromley,Bickley Primary School,408,43,9,52
Cheshire East,Weston Village Primary School,251,22,10,32
Croydon,Beckmead Park Academy,116,10,106,116
Derby,Chaddesden Park Primary School,298,83,5,88
Dudley,The Pedmore High School,606,104,10,114
County Durham,Chilton Academy,313,53,6,59
East Riding of Yorkshire,Hook Church of England Primary School,202,17,9,26
East Riding of Yorkshire,Airmyn Park Primary School,103,7,5,12
Essex,Roding Valley High School,1439,133,17,150
Essex,"St John's Church of England Voluntary Controlled Primary School, Buckhurst Hill",410,22,8,30
Essex,High Beech CofE Primary School,93,11,7,18
Essex,Epping Upland CofE Primary School,186,20,4,24
Essex,William Martin Church of England Infant and Nursery School,197,14,1,15
Essex,White Bridge Primary School,416,40,11,51
Essex,Lambourne Primary School,215,15,5,20
Essex,Ivy Chimneys Primary School,299,16,7,23
Gloucestershire,Kemble Primary School,103,14,2,16
Gloucestershire,Siddington Church of England Primary School,95,17,6,23
Hackney,Lubavitch House School (Senior Girls),124,25,4,29
Hackney,Lubavitch Girls Primary School,115,16,1,17
"Kingston upon Hull, City of",Rokeby Park Primary School,170,52,4,56
"Kingston upon Hull, City of",Stoneferry Primary School,162,25,5,30
Knowsley,Whiston Willis Primary Academy,346,43,10,53
Lambeth,"Christ Church, Streatham Church of England Primary School",179,27,3,30
Lambeth,St Leonard's Church of England Primary School,367,39,13,52
Lambeth,St Luke's Church of England Primary School,165,30,6,36
Leicester,Overdale Infant School,357,39,10,49
Leicester,Overdale Junior School,472,97,12,109
Leicestershire,Brookside Primary School,435,59,26,85
Leicestershire,Woodland Grange Primary School,439,20,13,33
Lewisham,St George's CofE Primary School,217,45,9,54
Manchester,Oasis Academy Temple,703,69,22,91
Middlesbrough,Archibald Primary School,505,84,5,89
Newcastle upon Tyne,Sacred Heart Primary School,242,19,3,22
Newham,Shaftesbury Primary School,647,26,15,41
Norfolk,Angel Road Infant School,198,32,10,42
Norfolk,Ghost Hill Infant and Nursery School,220,22,6,28
North Somerset,Castle Batch Primary School Academy,415,36,32,68
North Somerset,St Anne's Church Academy,389,37,15,52
North Yorkshire,Newby and Scalby Primary School,418,58,8,66
West Northamptonshire,Upton Meadows Primary School,396,63,12,75
West Northamptonshire,Kislingbury Primary School,122,15,2,17
West Northamptonshire,Spratton Church of England Primary School,81,11,0,11
Northumberland,Thropton Village First School,46,9,0,9
Northumberland,Harbottle Church of England First School,18,2,1,3
Northumberland,Dr Thomlinson Church of England Middle School,214,30,5,35
Nottinghamshire,Farnsfield St Michael's Church of England Primary School,271,11,5,16
Nottinghamshire,Gilthill Primary School,211,14,1,15
Nottinghamshire,Lowe's Wong Infant School,185,23,0,23
Nottinghamshire,The Minster School,1636,79,18,97
Nottinghamshire,Kimberley Primary School,218,39,3,42
Nottinghamshire,Bleasby Church of England Primary School,147,13,1,14
Nottinghamshire,Halam Church of England Primary School,74,14,0,14
Nottinghamshire,Holy Trinity CofE Infant School,49,5,1,6
Oxfordshire,Madley Brook Community Primary School,276,42,6,48
Oxfordshire,Fir Tree Junior School,232,50,12,62
Oxfordshire,"St Nicholas' Church of England Infants' School and Nursery Class, Wallingford",187,29,1,30
Oxfordshire,Witney Community Primary School,210,40,6,46
Plymouth,Ford Primary School,203,35,4,39
Plymouth,Knowle Primary School,348,72,11,83
Plymouth,Victoria Road Primary,204,45,8,53
Plymouth,Plaistow Hill Infant and Nursery School,122,15,4,19
Plymouth,Mount Wise Community Primary School,268,36,4,40
Plymouth,Shakespeare Primary School,433,50,11,61
Portsmouth,Penbridge Infant School & Nursery,219,13,21,34
Reading,New Christ Church Church of England Primary School,198,31,10,41
Redcar and Cleveland,Westgarth Primary School,352,27,2,29
Redcar and Cleveland,Green Gates Primary School,260,43,3,46
Redcar and Cleveland,John Emmerson Batty Primary School,204,28,2,30
Redcar and Cleveland,Ings Farm Primary School,471,40,4,44
Redcar and Cleveland,Lakes Primary School,299,87,6,93
Redcar and Cleveland,Galley Hill Primary School,282,16,1,17
Redcar and Cleveland,New Marske Primary School,212,22,5,27
Redcar and Cleveland,Wheatlands Primary School,451,53,1,54
Redcar and Cleveland,Coatham Church of England Primary School,230,44,6,50
Redcar and Cleveland,St Peter's Church of England Primary School,332,56,28,84
Shropshire,Bishops Castle Primary School,130,20,4,24
Shropshire,"St George's CofE Academy, Clun",91,13,0,13
Somerset,West Buckland Primary School,117,7,1,8
Somerset,North Curry CofE Primary School,151,11,0,11
Somerset,St Vigor & St John Church School,211,11,5,16
Somerset,Chilton Trinity School,941,123,20,143
Southend-on-Sea,Sacred Heart Catholic Primary School,436,62,4,66
Staffordshire,St Peter's CofE Academy Alton,49,3,0,3
Staffordshire,Charnwood Primary Academy,232,32,3,35
Staffordshire,All Saints CofE Academy Denstone,82,6,0,6
Staffordshire,St Augustine's CofE Academy,55,8,1,9
Staffordshire,St Peter's CofE Primary Academy,441,59,6,65
Staffordshire,Hazel Slade Primary Academy,209,21,1,22
Staffordshire,Longford Primary Academy,306,45,2,47
Staffordshire,Lakeside Primary School,186,28,2,30
Staffordshire,Our Lady and St Werburgh's Catholic Primary School,212,10,1,11
Stockport,Meadowbank Primary School,440,50,21,71
Stockton-on-Tees,Crooksbarn Primary School,325,24,5,29
Stoke-on-Trent,Sneyd Academy,573,76,9,85
Suffolk,"St Peter and St Paul Church of England Primary School, Eye",184,26,6,32
Suffolk,"All Saints Church of England Primary School, Laxfield",106,5,5,10
Suffolk,Somerleyton Primary School,58,7,2,9
Suffolk,Woods Loke Primary School,486,26,10,36
Suffolk,Fressingfield Church of England Primary School,123,33,1,34
Suffolk,Stradbroke Church of England Primary School,113,8,5,13
Suffolk,Abbots Green Primary Academy,528,34,4,38
Surrey,Holy Trinity CofE Primary School,417,38,10,48
Surrey,Windlesham Village Infant School,91,2,2,4
Surrey,Crawley Ridge Infant School,175,11,2,13
Surrey,Crawley Ridge Junior School,211,24,5,29
Sutton,The Limes College,104,97,6,103
Tameside,Poplar Street Primary School,451,81,6,87
Telford and Wrekin,Ercall Wood Academy,952,175,35,210
Waltham Forest,Lammas School and Sixth Form,744,94,20,114
Wandsworth,Linden Lodge School,146,2,144,146
Warrington,Penketh South Community Primary School,256,44,3,47
Warwickshire,Coughton CofE Primary School,179,18,4,22
Warwickshire,Temple Grafton CofE Primary School,107,7,0,7
Wigan,Highfield St Matthew's Church of England Primary School,428,26,3,29
Wiltshire,Great Bedwyn Church of England School,194,9,1,10
Wolverhampton,Villiers Primary School,667,120,12,132
Bath and North East Somerset,St Michaels Junior Church School,145,42,9,51
Brent,Braintcroft E-ACT Primary Academy,687,67,13,80
Cambridgeshire,Stilton Church of England Primary Academy,158,17,7,24
Cheshire East,Astbury St Mary's CofE Primary School,82,14,8,22
Dorset,Bere Regis Primary and Preschool,147,18,4,22
East Riding of Yorkshire,Holderness Academy and Sixth Form College,1101,116,40,156
Oldham,Oasis Academy Leesbrook,982,190,22,212
Ealing,Ada Lovelace Church of England High School,865,17,21,38
Essex,Steeple Bumpstead Primary School,174,15,1,16
Essex,William Martin Church of England Junior School,239,25,7,32
Essex,Feering Church of England Primary School,133,24,1,25
Essex,The Alderton Junior School,216,55,9,64
Gloucestershire,Cam Woodfield Junior School,194,41,11,52
Hackney,Lubavitch Boys' Primary School,105,22,3,25
Islington,Hungerford School,144,29,29,58
Leeds,Penny Field School,57,0,57,57
Leeds,Methley Primary School,443,37,5,42
Lincolnshire,Holbeach Bank Primary Academy,75,21,3,24
Liverpool,Garston Church of England Primary School,230,35,6,41
Milton Keynes,Lord Grey Academy,1420,157,34,191
Norfolk,Angel Road Junior School,259,47,6,53
Norfolk,Diss Church of England Junior Academy,199,68,4,72
Peterborough,Middleton Primary School,388,77,23,100
Rotherham,Rockingham Junior and Infant School,317,69,4,73
Slough,Arbour Vale School,342,0,342,342
Sutton,Wallington Primary Academy,192,29,3,32
Swindon,Abbey Park School,1153,169,33,202
Telford and Wrekin,Windmill Primary School,395,65,9,74
Trafford,Bollin Primary School,406,24,7,31
Wolverhampton,St Alban's Church of England Primary Academy,200,22,5,27
Bolton,St Peter's Smithills Dean Church of England Primary School,215,12,1,13
Bradford,Co-op Academy Parkland,215,38,4,42
Cornwall,Cardinham School,87,8,2,10
Cornwall,Lanivet Community Primary School,166,10,6,16
Cornwall,Berrycoombe School,234,33,11,44
Cornwall,Coads Green Primary School,48,12,0,12
Derby,Alvaston Junior Academy,335,52,6,58
Derby,Village Primary Academy,675,72,11,83
Devon,Kenton Primary School,74,9,4,13
Devon,Bampton Church of England Primary School,102,11,5,16
Devon,Willowbank Primary School,253,38,9,47
Devon,Combe Martin Primary School,155,28,3,31
Devon,Woolacombe School,233,24,3,27
Devon,Cockwood Primary School,86,9,1,10
Devon,Holywell Church of England School,89,13,6,19
Devon,Kenn Church of England Primary School,96,11,2,13
Devon,St Helen's Church of England School,210,23,7,30
Devon,Dolton Church of England Primary School,38,4,2,6
Doncaster,Canon Popham CofE Primary Academy,242,28,2,30
Essex,Crays Hill Primary School,99,12,3,15
Essex,Mountnessing Church of England Primary School,138,15,2,17
Middlesbrough,Acklam Grange School,1461,232,35,267
Middlesbrough,Linthorpe Community Primary School,723,88,7,95
Norfolk,Framingham Earl High School,789,97,29,126
North Yorkshire,Tadcaster Grammar School,1513,177,35,212
North Yorkshire,Monk Fryston Church of England Primary School,208,22,6,28
Northumberland,Belsay Primary School,75,14,1,15
Northumberland,Ponteland Primary School,474,51,7,58
Northumberland,Darras Hall Primary School,472,14,8,22
Northumberland,"Heddon-on-the-Wall, St Andrew's Church of England Primary School",225,21,7,28
Northumberland,Ponteland High School,1584,22,37,59
Northumberland,Richard Coates Church of England Primary School,334,31,8,39
Nottinghamshire,Awsworth Primary and Nursery School,295,40,1,41
Peterborough,Discovery Primary Academy,550,81,22,103
Shropshire,Market Drayton Junior School,359,68,2,70
Shropshire,The Wilfred Owen School,237,39,5,44
Shropshire,St Peter's CofE Primary School,420,38,5,43
Shropshire,Woodfield Infant School,284,25,8,33
Shropshire,Market Drayton Infant & Nursery School,374,41,5,46
Shropshire,Greenacres Primary School,133,30,2,32
Staffordshire,Shobnall Primary & Nursery School,229,16,5,21
Suffolk,Rendlesham Primary School,308,30,2,32
Surrey,Meadow Primary School,628,58,12,70
Surrey,West Ewell Primary School and Nursery,514,60,30,90
Wakefield,South Hiendley Primary School,205,28,6,34
Warrington,Beamont Primary School,372,64,7,71
Warrington,Alderman Bolton Primary School,309,33,3,36
Cambridgeshire,Bar Hill Community Primary School,278,27,10,37
Cambridgeshire,Lantern Community Primary School,397,36,13,49
Central Bedfordshire,Everton Heath Primary School,88,14,1,15
Derby,Ash Croft Primary Academy,172,32,5,37
Devon,Bratton Fleming Community Primary School,94,13,5,18
Devon,Ashleigh CofE  Primary School,217,37,7,44
Dorset,Lockyer's Middle School,462,65,6,71
Essex,Laindon Park Primary School & Nursery,221,35,2,37
Hartlepool,Hart Primary School,110,16,1,17
Hartlepool,St Peter's Elwick Church of England Primary School,101,9,0,9
Kent,Wrotham Road Primary School,446,22,6,28
Lancashire,Blacko Primary School,103,10,3,13
Lancashire,Laneshaw Bridge Primary,211,24,4,28
Lancashire,Colne Lord Street School,355,86,12,98
North Yorkshire,Sherburn High School,883,94,16,110
North Yorkshire,South Milford Primary School,203,12,5,17
North Yorkshire,Sherburn Hungate Primary School,325,18,9,27
North Yorkshire,"Riverside School, Tadcaster",376,39,12,51
North Northamptonshire,Studfall Junior Academy,460,73,28,101
North Northamptonshire,Studfall Infant Academy,384,47,20,67
Nottinghamshire,Larkfields Infant School,173,24,0,24
Nottinghamshire,Hollywell Primary School,208,35,1,36
Sheffield,Oughtibridge Primary School,418,46,8,54
Staffordshire,St Luke's CofE Academy Endon,208,9,3,12
Staffordshire,Stoneydelph Primary School,294,65,2,67
Suffolk,Brooklands Primary School,236,19,2,21
Worcestershire,Nunnery Wood Primary School,405,61,11,72
Worcestershire,Castlemorton Church of England Primary School,83,11,1,12
Worcestershire,Powick CofE Primary School,183,33,2,35
Somerset,Hatch Beauchamp Church of England Primary School,34,9,1,10
Cornwall,Treviglas Academy,931,97,12,109
Devon,The Clinton Church of England Primary School,26,3,2,5
Manchester,Grange School,252,0,252,252
North Yorkshire,Saxton Church of England Primary School,60,12,1,13
Nottinghamshire,Hillocks Primary Academy,314,75,3,78
Rotherham,Wath Academy,1983,166,46,212
Brent,The Corner School,13,0,13,13
Salford,New Park Academy,123,0,123,123
Suffolk,Morland Church of England Primary School,375,45,6,51
Swindon,St Luke's Academy,78,0,78,78
Warwickshire,Kingsway Community Primary School,181,28,2,30
Bolton,Tonge Moor Primary Academy,421,51,8,59
Derby,Reigate Park Primary Academy,394,55,13,68
Essex,Two Village Church of England Primary School,163,21,1,22
Lambeth,Archbishop Tenison's School,267,42,5,47
Birmingham,Arc Oakbridge School,43,0,43,43
Merton,Harris Academy Wimbledon,846,77,26,103
Bedford,Marston Vale Middle School,580,73,22,95
Blackpool,Armfield Academy,1105,77,21,98
Sheffield,Astrea Academy Sheffield,988,178,11,189
Hounslow,Bolder Academy,844,134,21,155
Bromley,Bullers Wood School for Boys,900,176,36,212
Wakefield,CAPA College,335,16,4,20
Stockport,Cheadle Hulme Primary School,341,20,10,30
Luton,Chiltern Academy,1165,141,31,172
Manchester,CHS South,964,98,35,133
Swindon,Churchward School,91,0,91,91
Croydon,Coombe Wood School,1021,124,37,161
Middlesbrough,Discovery Special Academy,126,1,125,126
Birmingham,"Eden Boys' Leadership Academy, Birmingham East",608,112,4,116
Leeds,Elements Primary School,278,28,0,28
Essex,Newhall Primary Academy,350,23,3,26
Swindon,Great Western Academy,878,105,29,134
Surrey,Hatchlands Primary,241,37,6,43
Southwark,John Keats Primary School,244,48,7,55
Staffordshire,John Taylor Free School,1141,142,35,177
Hertfordshire,Katherine Warington School,744,94,28,122
Bracknell Forest,King's Academy Binfield,1051,124,33,157
Stockport,Laurus Cheadle Hulme,1071,197,43,240
Tameside,Laurus Ryecroft,952,133,31,164
Greenwich,Leigh Academy Blackheath,895,86,19,105
Sheffield,Mercia School,787,103,13,116
Surrey,Merstham Park School,521,92,22,114
Bath and North East Somerset,Mulberry Park Educate Together Primary Academy,120,19,7,26
Newcastle upon Tyne,North East Futures UTC,317,14,7,21
Lincolnshire,Poplar Farm School,293,28,11,39
West Northamptonshire,The Radstone Primary School,346,48,0,48
North Northamptonshire,Red Kite Academy,141,2,139,141
Devon,Sherford Vale School,254,24,6,30
Devon,St James Church of England Primary and Nursery School,186,18,4,22
Norfolk,St. Clements Hill Primary Academy,202,25,5,30
Essex,The Beaulieu Park School,1112,113,30,143
Haringey,The Grove,122,0,122,122
Lancashire,The Heights Burnley,1,1,0,1
Barnet,Saracens High School,827,110,23,133
Oldham,The Springboard Project,65,0,65,65
Kent,Turner Free School,826,154,30,184
Cambridgeshire,Wintringham Primary Academy,120,19,2,21
West Sussex,Downsbrook Primary School,308,33,5,38
Medway,Elaine Primary School,301,70,26,96
Leeds,Cockburn John Charles Academy,1208,248,13,261
Rotherham,Brookfield Junior Academy,260,32,7,39
East Riding of Yorkshire,Goole Academy,1113,98,24,122
Doncaster,Montagu Academy,324,57,3,60
Essex,Bmat Stem Academy,196,21,1,22
Lincolnshire,Build a Future Independent School,84,0,10,10
Doncaster,Waverley Academy,189,20,1,21
Doncaster,Willow Primary School,399,46,7,53
Bradford,Thornbury Primary Leadership Academy,505,71,10,81
Wakefield,Outwood Academy Freeston,935,143,20,163
Wakefield,Outwood Academy Hemsworth,1064,155,15,170
Wakefield,Outwood Primary Academy Park Hill,456,49,12,61
Wakefield,Outwood Primary Academy Newstead Green,222,29,12,41
Wakefield,Outwood Primary Academy Bell Lane,320,34,2,36
Sheffield,Yewlands Academy,902,202,17,219
Havering,St Edward's Church of England Academy,575,49,15,64
West Berkshire,Theale Green School,723,71,24,95
Barnet,Shiras Devorah High School,74,4,1,5
Nottinghamshire,APTCOO - A Place to Call Our Own,20,1,18,19
Stoke-on-Trent,Intuition Holistic Education,10,0,10,10
Kent,Pilgrims' Way Primary School,348,37,4,41
Nottingham,The Bulwell Academy,1074,175,7,182
Lincolnshire,The Gainsborough Academy,700,175,19,194
Enfield,Delta Primary School,138,24,3,27
Northumberland,NCEA Bishop's Primary School,471,91,7,98
Northumberland,NCEA Castle School,118,0,118,118
Norfolk,The Stables Independent School,15,0,15,15
Hertfordshire,Elysium Healthcare Potters Bar Clinic School,13,11,2,13
Cornwall,Indian Queens Primary School,367,67,6,73
Derbyshire,Friesland School,1279,178,23,201
Derbyshire,Langwith Bassett Junior Academy,124,28,1,29
Enfield,Eastfield Primary School,451,59,21,80
Hertfordshire,Mount Pleasant Lane Primary School,270,31,5,36
Leicester,Hope Hamilton CofE Primary School,456,31,2,33
Leicestershire,Richard Hill Church of England Primary School,134,19,0,19
Leicestershire,All Saints Church of England Primary School,216,33,10,43
Leicestershire,Houghton-on-the-Hill Church of England Primary School,207,22,3,25
Norfolk,Dickleburgh Church of England Primary Academy (With Pre-School),181,13,4,17
Stockton-on-Tees,Kirklevington Primary School,151,21,0,21
Sutton,Barrow Hedges Primary School,686,44,13,57
Lancashire,Casterton Primary Academy,298,33,12,45
Suffolk,Stutton Church of England Primary School,76,13,2,15
East Sussex,Mountfield Heath School,30,0,30,30
Cheshire East,Egerton Primary School,209,5,3,8
Derby,Cottons Farm Primary Academy,114,16,1,17
County Durham,Bloemfontein Primary School,178,44,7,51
Enfield,Alma Primary School,493,64,13,77
Enfield,Worcesters Primary School,661,27,12,39
Enfield,Keys Meadow Primary School,408,40,14,54
Essex,Oak View School,134,1,133,134
Essex,Perryfields Infant School,180,17,4,21
Essex,The Alderton Infant School,163,25,2,27
Essex,Hereward Primary School,446,16,14,30
Essex,Limes Farm Infant School and Nursery,173,30,6,36
Essex,Hillhouse CofE Primary School,307,28,4,32
Essex,Chigwell Row Infant School,58,6,5,11
Essex,St Joseph's Catholic Primary School,201,17,4,21
Essex,Holy Family Catholic Primary School,207,39,11,50
Essex,Our Lady of Ransom Catholic Primary School,399,36,4,40
Essex,St Teresa's Catholic Primary School,161,26,8,34
Essex,Barnes Farm Junior School,362,40,13,53
Essex,Theydon Bois Primary School,317,33,4,37
Essex,Barnes Farm Infant School,237,38,6,44
Essex,Staples Road Primary School,612,42,17,59
Hampshire,Bordon Junior School,250,26,9,35
Leeds,Thorner Church of England Primary School,202,24,2,26
North Somerset,Wraxall Church of England Primary School,80,8,0,8
North Yorkshire,Appleton Roebuck Primary School,111,12,3,15
North Yorkshire,Kellington Primary School,115,12,4,16
North Yorkshire,Kirk Fenton Church of England Primary School,242,16,4,20
West Northamptonshire,Farthinghoe Primary School,46,4,0,4
West Northamptonshire,Old Stratford Primary School,183,17,4,21
Nottinghamshire,Parkdale Primary School,455,38,3,41
Nottinghamshire,Flintham Primary School,97,4,0,4
Sheffield,Nook Lane Junior School,242,45,14,59
South Gloucestershire,New Siblands School,126,0,126,126
South Gloucestershire,Culverhill School,146,0,146,146
Southend-on-Sea,St Helen's Catholic Primary School,422,60,10,70
Southend-on-Sea,St George's Catholic Primary School,207,30,5,35
Stockton-on-Tees,Layfield Primary School,218,23,3,26
Stockton-on-Tees,Wolviston Primary School,130,19,3,22
Stockton-on-Tees,Hartburn Primary School,600,37,5,42
Stockton-on-Tees,Village Primary School,244,36,4,40
Suffolk,Claydon Primary School,484,43,6,49
Surrey,Shalford Infant School,113,13,1,14
Surrey,Pirbright Village Primary School,382,70,10,80
Surrey,The Vale Primary School,170,16,7,23
Surrey,Northmead Junior School,348,54,29,83
Telford and Wrekin,Redhill Primary Academy,469,53,9,62
Worcestershire,Wychbold First and Nursery School,166,32,3,35
York,Osbaldwick Primary Academy,298,31,9,40
Southampton,Weston Shore Infant School,75,7,5,12
Lancashire,The Nook School,3,1,2,3
Islington,The London Screen Academy,758,140,21,161
Wakefield,King's Meadow Academy,268,61,4,65
West Northamptonshire,Blackthorn Primary School,233,30,18,48
Brighton and Hove,Brighton and Hove Clinic School,14,5,1,6
Buckinghamshire,Longwick Church of England Combined School,184,34,6,40
Bradford,Cullingworth Village Primary School,315,41,4,45
Cambridgeshire,Upwood Primary Academy,193,31,8,39
Cornwall,St Issey Church of England Primary School,121,9,1,10
Derbyshire,Bennerley Fields School,97,0,97,97
Derbyshire,Peak School,79,0,79,79
Derbyshire,Stanton Vale School,97,0,97,97
Derbyshire,Amber Valley and Erewash Support Centre,92,65,27,92
Derbyshire,South Derbyshire Support Centre,6,4,0,4
Derbyshire,North East Derbyshire Support Centre,127,118,9,127
Derbyshire,Holbrook School for Autism,140,0,140,140
Norfolk,Gayton Church of England Primary Academy,159,12,10,22
Norfolk,Hopton Church of England Primary Academy,178,31,2,33
Norfolk,Sandringham and West Newton Church of England Primary Academy,86,5,0,5
Norfolk,Broadland High Ormiston Academy,745,74,8,82
Norfolk,Little Snoring Community Primary Academy,72,14,3,17
North Somerset,Mendip Green Primary School,620,107,44,151
Redcar and Cleveland,Wilton Primary Academy,66,9,1,10
Rotherham,Laughton All Saints' CofE Primary School,119,19,6,25
Somerset,Hemington Primary School,42,10,3,13
Staffordshire,The Fountains High School,223,0,223,223
Staffordshire,The Fountains Primary School,201,0,201,201
Suffolk,First Base Bury St Edmunds,0,0,0,0
Swindon,Abbey Meads Community Primary School,491,48,13,61
Worcestershire,Wolverley Sebright Primary Academy,197,22,3,25
Birmingham,Birchfield Primary School,686,117,12,129
Cornwall,Bude Primary Academy - Infants,130,11,2,13
Cornwall,Bude Primary Academy - Juniors,268,54,16,70
Staffordshire,Peak Education - Primary,14,0,14,14
Derby,Ashwood Spencer Academy,550,83,18,101
Derby,Lakeside Primary Academy,625,97,15,112
Kent,Edenbridge Primary School,407,71,10,81
Norfolk,Raleigh Infant Academy,164,22,0,22
Staffordshire,Winshill Village Primary and Nursery School,243,45,7,52
Suffolk,"All Saints Church of England Primary School, Newmarket",184,28,4,32
Wigan,The Westleigh School,917,136,38,174
Wirral,"St Joseph's Catholic Primary School, Birkenhead",306,24,1,25
Wiltshire,King's Gate Primary School,153,25,1,26
Devon,Landkey Community Primary Academy,194,38,6,44
Devon,The Park Community School,1448,108,36,144
Devon,Sticklepath Community Primary Academy,457,103,4,107
Devon,Eden Park Academy,169,44,8,52
Plymouth,Mount Street Primary School,243,24,3,27
Wiltshire,Wilton CofE Primary School,155,35,19,54
Derbyshire,Tupton Hall School,1574,213,23,236
Lewisham,Turnham Academy,201,27,9,36
"Bristol, City of",Evergreen Primary Academy,139,20,4,24
Leeds,Blackgates Primary Academy,299,81,4,85
Oxfordshire,Maiden Erlegh Chiltern Edge,395,91,11,102
Derby,St Joseph's Catholic Voluntary Academy,373,47,10,57
Leicestershire,St Charles Catholic Primary Voluntary Academy,130,21,2,23
Essex,Rivenhall Church of England Primary School,121,23,6,29
Solihull,St Margaret's Church of England Primary School,230,23,8,31
Leicester,Sir Jonathan North Girls' College,1172,104,9,113
Derbyshire,St Anne's Catholic Voluntary Academy,213,35,4,39
Halton,Brookfields School,119,0,119,119
North Yorkshire,Stakesby Primary Academy,182,25,4,29
Derbyshire,St Margaret's Catholic Voluntary Academy,30,11,0,11
Kent,Coxheath Primary School,434,33,3,36
Knowsley,Yew Tree Primary Academy,248,68,36,104
Brent,Our Lady of Grace Catholic Junior School,232,22,4,26
Southwark,Surrey Square Primary School,461,69,20,89
Derbyshire,St Elizabeth's Catholic Voluntary Academy,197,41,1,42
St. Helens,Nutgrove Methodist Primary School,203,32,1,33
Northumberland,Hexham Priory School,113,0,113,113
Hertfordshire,Knutsford Primary Academy,436,33,8,41
Birmingham,Archbishop Ilsley Catholic School,1158,174,11,185
Staffordshire,Horton St Michael's CofE First School,78,6,1,7
Kingston upon Thames,Green Lane Primary and Nursery School,400,36,8,44
Derbyshire,St Thomas More Catholic Voluntary Academy,437,57,13,70
East Riding of Yorkshire,Howden School,698,74,25,99
Staffordshire,William MacGregor Primary School,201,40,6,46
Cheshire West and Chester,Sandiway Primary School,212,19,3,22
Derbyshire,All Saints Catholic Voluntary Academy,71,11,1,12
Leicestershire,Saint Peters Catholic Voluntary Academy,205,22,2,24
Croydon,Courtwood Primary School,215,29,21,50
Portsmouth,Meon Infant School,177,13,5,18
Havering,Hacton Primary School,613,25,33,58
Croydon,Quest Primary School,182,47,15,62
Essex,High Ongar Primary School,132,17,1,18
Derby,St Mary's Catholic Voluntary Academy,359,37,7,44
Bolton,St Maxentius CofE Primary School,190,34,3,37
Essex,Felmore Primary School,408,70,5,75
Kent,Loose Primary School,656,49,10,59
Norfolk,Old Buckenham High School,504,55,15,70
Derbyshire,St Thomas Catholic Voluntary Academy,234,15,4,19
Shropshire,Meole Brace School,1343,104,13,117
Leicester,Saint Patrick's Catholic Voluntary Academy,216,36,7,43
Suffolk,Charsfield Church of England Primary School,31,10,3,13
Warwickshire,Long Itchington CofE Academy,194,11,5,16
Swindon,Red Oaks Primary School,455,66,29,95
Warwickshire,Southam St James CofE Academy,190,28,3,31
North Yorkshire,Tadcaster Primary Academy,109,14,4,18
Dorset,Milldown CofE Academy,231,26,8,34
Peterborough,St Botolph's Church of England Primary School,372,38,12,50
Stoke-on-Trent,Christ Church CofE Primary Academy,194,29,4,33
Bury,St Thomas Church of England Primary School,419,43,13,56
Essex,The Downs Primary School and Nursery,421,61,3,64
Leicester,Christ the King Catholic Voluntary Academy,628,76,8,84
Sutton,Abbey Primary School,467,63,10,73
East Riding of Yorkshire,Melbourne Community Primary School,205,13,1,14
Telford and Wrekin,The Seeds School,24,2,22,24
Wiltshire,The Spires,28,1,27,28
Devon,The Greater Horseshoe School,48,0,48,48
North Northamptonshire,Oundle Church of England Primary School,366,51,4,55
Warwickshire,Coleshill Church of England Primary School,409,61,3,64
Suffolk,Occold Primary School,53,17,1,18
East Riding of Yorkshire,Riston Church of England Primary Academy,85,13,3,16
Suffolk,Crawford's Church of England Primary School,76,10,0,10
Harrow,St George's Primary Catholic Voluntary Academy,406,44,6,50
Tameside,Rosehill Methodist Primary Academy,396,61,16,77
Harrow,St John Fisher Catholic Primary School,628,59,14,73
Brent,St Margaret Clitherow RC Primary School,225,25,7,32
Leicestershire,Saint Francis Catholic Primary School,207,26,4,30
Essex,Hockley Primary School,339,25,11,36
Tameside,Lawrence House,1,1,0,1
Shropshire,St George's Junior School,352,47,7,54
Havering,Dame Tipping Church of England Primary School,88,17,3,20
Sefton,Litherland Moss Primary School,205,57,1,58
Stockport,St Mary's Catholic Voluntary Academy,233,19,4,23
Southwark,"Spa School, Bermondsey",111,0,111,111
Wandsworth,Franciscan Primary School,280,80,7,87
Wolverhampton,Woodthorne Primary School,427,69,2,71
Essex,Chipping Ongar Primary School,205,33,6,39
Leicester,"English Martyrs' Catholic School, A Voluntary Academy",1161,115,6,121
Bradford,Dixons Cottingley Academy,867,110,5,115
Warwickshire,Keresley Newland Primary Academy,162,36,2,38
Devon,The Outdoors School,57,0,57,57
Staffordshire,Two Rivers Primary School,126,2,124,126
Cheshire West and Chester,Little Leigh Primary School,168,13,1,14
Lincolnshire,Waddington Redwood Primary Academy,303,37,10,47
Calderdale,The Whitley AP Academy,76,70,6,76
Lincolnshire,Cherry Willingham Primary Academy,195,37,4,41
North Northamptonshire,Newton Road School,254,44,7,51
North Northamptonshire,Rushden Academy,852,70,5,75
Essex,Oaklands Infant School,179,17,6,23
Derbyshire,Hilton Spencer Academy,648,64,13,77
Brent,The Village School,309,0,309,309
Leeds,Austhorpe Primary School,212,20,0,20
Wandsworth,ARK John Archer Primary Academy,200,29,10,39
Leeds,Meadowfield Primary School,464,69,2,71
Leeds,Boston Spa Academy,1362,107,6,113
Leeds,Templenewsam Halton Primary School,452,71,2,73
Leeds,Whitkirk Primary School,384,39,4,43
"Kingston upon Hull, City of",Frederick Holmes School,108,0,108,108
Lewisham,Childeric Primary School,427,83,25,108
Middlesbrough,Captain Cook Primary School,429,40,4,44
Bradford,Eastwood Community School,487,34,10,44
Leicester,"Holy Cross Catholic School, a Voluntary Academy",230,62,19,81
Croydon,Monks Orchard Primary School,215,26,1,27
Lincolnshire,Saint Mary's Catholic Voluntary Academy,199,45,12,57
Manchester,Co-op Academy Broadhurst,236,39,5,44
Lancashire,Colne Park High School,1089,113,17,130
Suffolk,"St Matthew's Church of England Primary School, Ipswich",415,66,8,74
Essex,Ongar Primary School,168,30,2,32
East Sussex,Langney Primary Academy,501,76,9,85
Leicester,"St Paul's Catholic School, a Voluntary Academy",1130,95,9,104
Leeds,Colton Primary School,239,34,5,39
Suffolk,Dennington Church of England Primary School,75,11,1,12
Staffordshire,Blessed Robert Sutton Catholic Voluntary Academy,566,59,14,73
Oxfordshire,Middle Barton Primary School,115,14,1,15
Norfolk,Litcham School,764,109,21,130
Derbyshire,Christ the King Catholic Voluntary Academy,230,23,3,26
Manchester,Wright Robinson College,1826,278,43,321
Lincolnshire,Saint Mary's RC Primary Academy,200,28,4,32
Essex,Margaretting Church of England Voluntary Controlled Primary School,78,9,2,11
Somerset,Otterhampton Primary School,77,6,4,10
Hampshire,Rowner Junior,205,49,8,57
Harrow,The Sacred Heart Language College,838,94,7,101
Harrow,St Joseph's Catholic Primary School,414,53,12,65
Leeds,Temple Moor High School,1309,81,17,98
Devon,Highampton Community Primary School,26,7,0,7
Middlesbrough,"St  Pius X Catholic Primary School, a Catholic Voluntary Academy",233,28,3,31
Cumbria,James Rennie School,167,0,167,167
Middlesbrough,Lingfield Primary School,226,18,2,20
Middlesbrough,The Avenue Primary School,435,33,3,36
Derby,St Alban's Catholic Voluntary Academy,348,36,10,46
Devon,Holbeton Primary School,72,6,3,9
Surrey,The Abbey School,133,0,133,133
Darlington,St Teresa's Catholic Primary School,340,33,12,45
Lincolnshire,St Norbert's Catholic Voluntary Academy,207,21,5,26
Surrey,Stoughton Infant School,308,50,6,56
Derbyshire,St Mary's Catholic Voluntary Academy,127,19,1,20
"Bristol, City of",Stoke Park Primary School,237,22,10,32
Middlesbrough,Marton Manor Primary School,258,38,14,52
Bath and North East Somerset,Roundhill Primary School,306,72,15,87
Surrey,Meadhurst Primary School,429,83,35,118
Ealing,Dormers Wells Infant School,218,30,6,36
Staffordshire,Holy Rosary Catholic Voluntary Academy,203,18,3,21
North Lincolnshire,Outwood Junior Academy Brumby,470,69,11,80
Birmingham,St Mary and St John Junior and Infant School,441,66,5,71
Bedford,Roxton Church of England Academy,60,14,1,15
Oxfordshire,Sandhills Community Primary School,254,46,4,50
Suffolk,Shotley Community Primary School,145,25,0,25
Staffordshire,Chaselea Alternative Provision Academy,30,25,2,27
Derbyshire,St Charles' Catholic Voluntary Academy,180,39,2,41
West Sussex,Littlegreen Academy,82,0,82,82
Reading,St Mary & All Saints Church of England Primary School,319,73,10,83
Lancashire,Marsden Heights Community College,1046,161,18,179
Lewisham,The Young Women's Hub,8,0,4,4
Oxfordshire,Rose Hill Primary School,288,65,15,80
Lincolnshire,Colsterworth Church of England Primary School,115,6,3,9
Suffolk,Howard Community Academy,175,43,3,46
Bradford,Beckfoot Nessfield,304,36,2,38
Lancashire,Burscough Priory Academy,679,20,7,27
West Northamptonshire,Parklands Primary School,409,27,3,30
Southampton,Oasis Academy Sholing,1040,131,20,151
Devon,K-HQ,7,3,4,7
Nottinghamshire,Westbourne School,53,0,53,53
Staffordshire,Needwood CofE Primary School,79,5,3,8
Staffordshire,All Saints CofE (C) Primary School,112,2,2,4
Thurrock,Holy Cross Catholic Primary School,229,26,20,46
Leeds,Middleton Primary School,424,95,2,97
Birmingham,St Peter and St Paul RC Junior and Infant School,206,31,4,35
Thurrock,St Thomas of Canterbury Catholic Primary School,605,102,14,116
Thurrock,St Joseph's Catholic Primary School,191,21,5,26
Cambridgeshire,Cambridge International School,70,9,1,10
Salford,AldridgeUTC@MediaCityUK,337,63,17,80
Hertfordshire,Ridgeway Academy,904,193,34,227
Leeds,Christ Church Upper Armley Church of England Primary School,193,33,2,35
West Berkshire,Lambourn CofE Primary School,193,54,3,57
Bury,Holy Trinity Primary School,231,30,7,37
Havering,Sanders Draper,664,87,23,110
Cambridgeshire,Thongsley Fields Primary and Nursery School,276,73,9,82
Gloucestershire,Grange Primary School,258,91,8,99
North Yorkshire,Braeburn Primary and Nursery Academy,408,70,13,83
Sefton,Shoreside Primary School,200,27,4,31
Nottinghamshire,The Python Hill Academy,320,29,2,31
Wirral,Co-op Academy Bebington,1120,259,43,302
Oldham,E-ACT Royton and Crompton Academy,1062,160,24,184
Ealing,Ark Acton Academy,860,98,15,113
Norfolk,Nelson Infant School,143,27,5,32
Barnsley,Darton Academy,1159,71,38,109
Derbyshire,St Mary's Catholic Voluntary Academy,121,13,3,16
Suffolk,Britannia Primary School and Nursery,668,79,4,83
Cornwall,Cape Cornwall School,232,32,25,57
Gloucestershire,Chesterton Primary School,206,40,12,52
Kirklees,"Royds Hall,  A Share Academy",1244,192,50,242
Nottingham,Djanogly Sherwood Academy,350,43,2,45
Suffolk,New Skill Centre,45,0,45,45
East Riding of Yorkshire,Sycamore House School,4,0,4,4
Somerset,Compton Dundon School,13,0,13,13
Surrey,Arun Court,15,0,15,15
Leeds,The Pivot Academy LS East,55,16,39,55
Shropshire,Overton School,13,0,13,13
Wiltshire,Bowerhill Primary School,406,31,10,41
Wiltshire,Melksham Oak Community School,1282,167,50,217
Wiltshire,Shaw CE Primary School,201,30,9,39
Wiltshire,"St George's Church of England Primary School, Semington",86,14,4,18
Wiltshire,St Mary's Broughton Gifford Voluntary Controlled Church of England Primary School,81,8,5,13
Wiltshire,The Manor CofE VC Primary School,178,38,13,51
Telford and Wrekin,Aspris Telford School,12,1,11,12
Cambridgeshire,Swaffham Prior Church of England Primary School,102,16,4,20
Sandwell,Tameside Primary Academy,471,75,11,86
Hertfordshire,Larkspur Academy,113,20,3,23
Leicestershire,Dovetree School,42,2,40,42
Leeds,Dixons Unity Academy,886,175,7,182
Kirklees,"Thornhill Community Academy, A Share Academy",886,140,36,176
West Northamptonshire,Lumbertubs Primary School,241,28,8,36
Kirklees,Castle Hall Academy,735,118,16,134
Lambeth,Van Gogh Primary,344,65,12,77
Cambridgeshire,Ernulf Academy,703,102,26,128
Doncaster,Astrea Academy Woodfields,713,115,4,119
West Northamptonshire,Monksmoor Park Church of England Primary School,175,14,8,22
Northumberland,Haltwhistle Primary Academy,244,41,15,56
Derbyshire,Kirk Hallam Community Academy,871,96,14,110
Hillingdon,UTC Heathrow,219,36,8,44
Kent,Rosherville Church of England Academy,141,17,5,22
Buckinghamshire,Princes Risborough School,1019,93,59,152
Bexley,King Henry School,1286,285,24,309
Solihull,Tudor Grange Academy Kingshurst,1259,214,18,232
Oxfordshire,Orchard Meadow Primary School,242,50,9,59
Oxfordshire,Windale Primary School,199,61,9,70
Cheshire East,Hungerford Primary Academy,418,63,22,85
Sandwell,Q3 Academy Tipton,1542,175,24,199
Birmingham,City Road Primary School,440,61,4,65
"Bournemouth, Christchurch and Poole",Parkfield School,492,54,28,82
Cheshire East,Poynton High School,1457,96,34,130
Cornwall,Camelford Community Primary School,304,45,16,61
Cornwall,St Teath Community Primary School,110,19,0,19
Croydon,Keston Primary School,441,41,4,45
Cornwall,Otterham Community Primary School,70,9,2,11
Oxfordshire,Fitzharrys School,733,128,35,163
Coventry,Richard Lee Primary School,468,64,6,70
Stockton-on-Tees,Levendale Primary School,216,7,2,9
Cornwall,St Breward Community Primary School,47,14,0,14
Bath and North East Somerset,St Julian's Church School,106,14,4,18
Rutland,Great Casterton Church of England Primary School,91,3,5,8
Wigan,St Paul's Church of England Primary School,196,17,4,21
Kent,Fordcombe Church of England Primary School,70,8,1,9
Merton,Stanford Primary School,152,18,29,47
Cheshire East,Lostock Hall Primary School,213,9,8,17
Redcar and Cleveland,Overfields Primary School,210,31,0,31
Salford,Co-op Academy Walkden,1503,181,66,247
Sheffield,Loxley Primary School,210,21,1,22
Bolton,Ladywood School,193,4,189,193
Cambridgeshire,Westwood Primary School,805,38,18,56
Cornwall,Sir James Smith's School,601,92,14,106
Bath and North East Somerset,Westfield Primary School,413,65,10,75
Bolton,Firwood High School,199,4,195,199
Rotherham,Laughton Junior and Infant School,224,23,7,30
Warrington,St Helen's Church of England Primary School,119,6,3,9
North Northamptonshire,Warwick Academy,262,31,3,34
North Northamptonshire,Ruskin Academy,273,30,9,39
North Northamptonshire,Olympic Primary,375,42,8,50
Warrington,Glazebury Church of England Primary School,132,24,0,24
Suffolk,Riverwalk School,206,0,206,206
Surrey,Ottershaw Christ Church Church of England Junior School,228,37,10,47
Surrey,Ottershaw Christ Church Church of England Infant School,207,15,5,20
Wiltshire,Noremarsh Junior School,240,64,4,68
Suffolk,The Albany,19,3,16,19
Cumbria,Flimby Primary School,126,17,3,20
Bath and North East Somerset,Shoscombe Church School,119,10,8,18
Rutland,Empingham Church of England Primary School,80,8,1,9
Shropshire,Whitchurch CofE Infant and Nursery Academy,278,43,4,47
Staffordshire,St Mary's CofE First Academy,75,5,0,5
Rutland,Uppingham Church of England Primary School,137,27,3,30
St. Helens,St James' Church of England Primary School,159,24,2,26
Cheshire East,Hollinhey Primary School,195,18,13,31
Suffolk,Warren School,123,0,123,123
Shropshire,Whitchurch CofE Junior Academy,305,43,7,50
Worcestershire,Burlish Park Primary School,439,61,10,71
Sandwell,Newtown Primary School,222,62,5,67
Bradford,Fearnville Primary School,363,39,4,43
Coventry,Foxford Community School,1056,154,15,169
Birmingham,Brookfields Primary School,331,42,2,44
Surrey,Surrey Hills All Saints Primary School,153,19,2,21
Somerset,The King Alfred School an Academy,1354,134,26,160
Hertfordshire,Laureate Academy,754,116,8,124
Staffordshire,Cheslyn Hay Academy,1262,142,17,159
Derbyshire,Horsley Woodhouse Primary School,106,24,5,29
Somerset,Countess Gytha Primary School,146,16,2,18
Somerset,Leigh On Mendip School,102,3,1,4
West Sussex,The March CofE Primary School,209,31,2,33
Stockton-on-Tees,St Mary's Church of England Primary School,110,15,1,16
Derbyshire,Laceyfields Academy,80,7,0,7
Derbyshire,Wilsthorpe School,1192,125,20,145
Worcestershire,Stanley Road Primary School,322,55,13,68
Derbyshire,Howitt Primary Community School,326,46,4,50
Barnsley,Horizon Community College,2004,160,44,204
Tameside,Yew Tree Primary School,386,114,3,117
Warwickshire,Curdworth Primary School,114,12,2,14
Stoke-on-Trent,Forest Park Primary School,458,90,10,100
Suffolk,Broke Hall Community Primary School,626,57,10,67
Derbyshire,Longford CofE Primary School,50,6,0,6
Milton Keynes,Heronshaw School,246,28,3,31
Doncaster,Sandringham Primary School,427,49,10,59
Stoke-on-Trent,Etruscan Primary School,450,44,12,56
Stoke-on-Trent,St Mark's CofE Primary School,459,68,7,75
Stoke-on-Trent,Oakhill Primary School,427,86,8,94
Rotherham,Anston Hillcrest Primary School,236,20,12,32
Cambridgeshire,Swaffham Bulbeck Church of England Primary School,98,15,6,21
Rotherham,Kiveton Park Infant School,163,33,4,37
Derbyshire,Kilburn Junior School,144,32,1,33
Stoke-on-Trent,The Meadows Primary Academy,363,65,8,73
Hounslow,St Richard's Church of England Primary School,203,27,21,48
Dorset,Lytchett Matravers Primary School,428,44,11,55
Derby,Homefields Primary School,354,39,9,48
Norfolk,Mousehold Infant & Nursery School,251,35,9,44
Tameside,Greenside Primary School,472,170,30,200
Oxfordshire,Stadhampton Primary School,93,10,3,13
North Northamptonshire,Irchester Community Primary School,377,35,4,39
York,"Archbishop of York's CofE Voluntary Controlled Junior School, Bishopthorpe",227,16,4,20
Derbyshire,Aldercar Infant School,193,42,4,46
Redcar and Cleveland,Errington Primary School,229,32,5,37
Stoke-on-Trent,Abbey Hulton Primary School,228,49,6,55
Sheffield,Bradfield Dungworth Primary School,136,19,0,19
North Northamptonshire,Wollaston School,1410,148,21,169
Dorset,Upton Junior School,346,50,7,57
Nottinghamshire,Brookside Primary School,314,17,1,18
Rotherham,Harthill Primary School,166,36,2,38
Staffordshire,Nether Stowe School,666,112,10,122
Suffolk,Saxmundham Primary School,268,48,9,57
Derbyshire,Richardson Endowed Primary School,199,28,5,33
Dorset,Upton Infant School,247,34,5,39
Stoke-on-Trent,Kemball School,220,0,220,220
Sheffield,Wharncliffe Side Primary School,161,26,23,49
Lincolnshire,Lacey Gardens Junior Academy,326,70,22,92
Derby,Chellaston Junior School,506,61,10,71
Barnsley,Astrea Academy Dearne,1146,140,54,194
Derbyshire,Loscoe CofE Primary School and Nursery,199,37,3,40
Stoke-on-Trent,Watermill School,234,3,230,233
Lincolnshire,Eastfield Infants and Nursery Academy,256,50,11,61
Shropshire,Belvidere School,826,79,22,101
Derby,Chellaston Infant School,290,25,6,31
Derbyshire,Heath Primary School,335,53,4,57
Shropshire,Mary Webb School and Science College,621,109,8,117
Sheffield,Stannington Infant School,180,12,3,15
Wigan,St David Haigh and Aspull CofE Primary School,99,15,3,18
Bradford,Wycliffe CofE Primary School,350,37,1,38
Staffordshire,Two Gates Primary School,249,50,1,51
Cambridgeshire,The Galfrid School,287,74,24,98
Oxfordshire,Oxford International College,373,20,0,20
Buckinghamshire,Bourne End Academy,823,143,46,189
Gloucestershire,Norton College Tewkesbury,45,0,45,45
Kent,Cornfields School,50,0,50,50
Gateshead,Keser Girls School,412,28,3,31
Surrey,Unified Academy,64,0,64,64
North Northamptonshire,Little Harrowden Community Primary School,188,12,2,14
Bury,Tottington High School,919,121,17,138
Wirral,Moreton Christ Church CofE Primary School,372,72,7,79
Devon,Yeo Valley Primary School,204,57,6,63
Suffolk,Grange Community Primary School,172,23,4,27
Devon,Totnes St John's Church of England Primary School,155,25,5,30
Bolton,Beacon Primary School,184,23,8,31
Bradford,Shipley CofE Primary School,207,38,2,40
Nottinghamshire,Oak Tree Primary School,221,43,3,46
Cheshire West and Chester,Grange Community Nursery and Primary School,142,49,4,53
Nottingham,Ellis Guilford School,1284,180,9,189
Leeds,Calverley Parkside Primary School,245,22,2,24
Blackburn with Darwen,St Silas's CofE Primary School,323,64,13,77
Leeds,Bramley Park Academy,272,93,12,105
Croydon,South Norwood Primary,331,56,18,74
Northumberland,Malvin's Close Academy,434,91,23,114
Northumberland,Croftway Academy,408,77,16,93
Wandsworth,Goldfinch Primary School,193,38,4,42
Norfolk,Nightingale Infant & Nursery School,125,10,3,13
Camden,LSI Independent College,22,6,2,8
Norfolk,Brisley Church of England Primary Academy,74,9,4,13
Lincolnshire,Hartsholme Academy,404,60,12,72
Plymouth,UTC Plymouth,536,90,16,106
Lincolnshire,St Giles Academy,390,77,10,87
Nottinghamshire,Arnold Hill Spencer Academy,1573,252,19,271
Walsall,West Midlands Education and Skills,21,0,21,21
Nottingham,Farnborough Spencer Academy,881,145,5,150
North Northamptonshire,St. Marys CofE Primary School,291,35,8,43
Devon,Atlantic Academy,263,57,31,88
Lancashire,Turning Point Academy,60,0,60,60
Rotherham,Abbeywood School,67,0,67,67
"Bristol, City of",Wansdyke Primary School,209,25,6,31
Surrey,St Cuthbert Mayne Catholic Primary School,212,25,6,31
Kent,Greenlands Primary School,187,34,3,37
Derby,Derby St Chad's CofE Nursery and Infant School,124,21,1,22
Devon,Whipton Barton Junior School,211,43,11,54
Derby,Griffe Field Primary School,468,52,13,65
Shropshire,The Grove School,848,112,14,126
Bradford,Crossley Hall Primary School,704,71,53,124
Rotherham,Kiveton Park Meadows Junior School,194,50,9,59
Doncaster,Owston Park Primary Academy,436,70,11,81
Bradford,Lower Fields Primary Academy,414,62,7,69
Lincolnshire,Frithville Primary School,37,13,5,18
Staffordshire,Beresford Memorial CofE First School,162,23,2,25
Staffordshire,Leek First School,149,20,0,20
Bradford,Greengates Primary Academy,216,14,2,16
Staffordshire,Rushton CofE First School,41,4,0,4
North Somerset,Winford Church of England Primary School,200,25,2,27
Lincolnshire,New York Primary School,42,15,11,26
Nottinghamshire,Ernehale Infant School,198,16,1,17
Devon,Whipton Barton Infants and Nursery School,245,29,2,31
Essex,Endeavour Co-Operative Academy,150,0,150,150
Leicestershire,Arnesby Church of England Primary School,54,10,3,13
Leicestershire,St Peter's Church of England Primary School Whetstone,202,15,1,16
Staffordshire,Foley Infant School Academy,171,14,4,18
Derbyshire,Walton On Trent CofE Primary and Nursery School,142,18,5,23
Staffordshire,Brindley Heath Junior School Academy,229,52,6,58
Leicestershire,Sherrier Church of England Primary School,414,39,5,44
Staffordshire,All Saints CofE First School,237,35,0,35
Cheshire East,Handforth Grange Primary School,346,24,19,43
Kirklees,Field Lane Junior Infant and Nursery School,231,39,9,48
Leicestershire,Manorfield Church of England Primary School,410,40,6,46
Leicestershire,Croft Church of England Primary School,133,18,5,23
Cheshire West and Chester,Cuddington Primary School,192,23,2,25
Staffordshire,Westwood First School,277,31,1,32
Kent,Goodwin Academy,900,79,35,114
Norfolk,Argyll House,8,0,8,8
Leeds,Southway Independant School,91,83,6,89
Cumbria,The Whitehaven Academy,665,101,19,120
Staffordshire,Kidsgrove Secondary School,295,30,3,33
Staffordshire,Kidsgrove Primary School,150,38,3,41
Doncaster,The Laurel Academy,654,76,7,83
Sunderland,Trinity Academy New Bridge,131,0,131,131
Cheshire West and Chester,Weaverham Primary Academy,82,20,2,22
Oldham,SMS Changing lives School,33,0,33,33
Medway,Waterfront UTC,267,82,6,88
Wiltshire,LUMIAR STOWFORD SCHOOL,30,4,0,4
Surrey,Serenity School,56,0,56,56
Surrey,St John's Primary School,200,14,9,23
Barnet,Sacks Morasha Jewish Primary School,207,32,3,35
Enfield,Wolfson Hillel Primary School,461,42,12,54
Derbyshire,Gamesley Primary School,235,98,8,106
Wakefield,Ash Grove Primary Academy,295,37,10,47
Worcestershire,Honeywell Primary School,135,34,8,42
Swindon,The Chalet School,72,0,72,72
Southwark,St Paul's Church of England Primary School,194,32,3,35
Oldham,St John's Church of England Primary School,269,22,5,27
Gloucestershire,Belong School Gloucestershire,27,0,27,27
Doncaster,Askern Moss Road Infant Academy,95,14,3,17
Plymouth,Hyde Park Infants' School,256,13,1,14
North Northamptonshire,Bozeat Community Primary School,134,10,0,10
Somerset,West Monkton Church of England School,418,56,14,70
Calderdale,Warley Road Primary Academy,540,67,15,82
Worcestershire,Welland Primary School,144,8,0,8
Stockton-on-Tees,St Joseph's Catholic Academy,290,15,2,17
Newcastle upon Tyne,Thomas Bewick School,314,0,314,314
Waltham Forest,Woodford Green Primary School,231,32,3,35
Surrey,Walton Oak Primary School,453,48,10,58
Oxfordshire,Bardwell School,106,0,106,106
Norfolk,Fakenham Infant and Nursery School,240,30,4,34
Central Bedfordshire,The Rushmere Park Academy,170,21,5,26
"Bristol, City of",Cheddar Grove Primary School,456,37,4,41
Sefton,Churchtown Primary School,743,77,9,86
Bath and North East Somerset,Ubley Church of England Primary School,81,5,3,8
Dorset,Hillside Community First School,206,31,3,34
Warwickshire,Temple Herdewyke Primary School,93,18,2,20
Norfolk,Diss Infant Academy and Nursery,123,38,3,41
Solihull,Ulverley School,476,69,6,75
North Northamptonshire,Trinity Church of England Primary School,139,20,3,23
Essex,Elm Hall Primary School,211,29,9,38
Birmingham,Colmers Farm Primary School,406,55,6,61
Warwickshire,Kenilworth School and Sixth Form,1834,322,20,342
Somerset,Selworthy Special School,198,1,197,198
Worcestershire,Birchensale Middle School,594,126,18,144
Birmingham,Marlborough Primary School,638,118,4,122
Tameside,"Parochial CofE Primary and Nursery School, Ashton-under-Lyne",204,37,2,39
Somerset,Blackbrook Primary School,240,31,6,37
Doncaster,Askern Littlemoor Infant Academy,176,29,1,30
Bath and North East Somerset,Stanton Drew Primary School,55,11,1,12
Thurrock,Horndon-On-the-Hill CofE Primary School,237,35,5,40
Stockton-on-Tees,Our Lady of the Most Holy Rosary Catholic Academy,185,17,1,18
Plymouth,Hyde Park Junior School,331,31,3,34
Norfolk,Fakenham Junior School,298,48,7,55
North Northamptonshire,Priors Hall - A Learning Community,444,33,6,39
Luton,Southfield Primary Academy,397,87,8,95
Derby,Arboretum Primary School,639,59,25,84
Tameside,Canon Johnson CofE Primary School,220,47,7,54
Somerset,Ruishton Church of England School,199,31,7,38
Worcestershire,Holyoakes Field First School,307,54,2,56
Dorset,Verwood Church of England First School,310,22,6,28
Brent,Our Lady of Grace RC Infant and Nursery School,224,27,2,29
Birmingham,Yenton Primary School,625,107,1,108
Hertfordshire,Sarratt Church of England Primary School,159,8,1,9
Croydon,Kensington Avenue Primary School,515,55,38,93
Essex,Gosfield Community Primary School,141,7,3,10
Peterborough,Braybrook Primary Academy,216,16,0,16
Staffordshire,Two Rivers High School,244,0,244,244
Enfield,Houndsfield Primary School,487,101,15,116
Wandsworth,Al Risalah Boys' School,110,0,0,0
Birmingham,Titan Aston Academy,2,1,0,1
Devon,The Shoreline Academy,39,33,6,39
Stockton-on-Tees,Hartwell School,86,2,84,86
Devon,Stansfield Academy,58,49,9,58
Devon,River Dart Academy,36,34,2,36
Kent,Alchemy School,46,0,46,46
Wirral,Co-op Academy Woodslee,222,40,11,51
Cheshire West and Chester,Ellesmere Port Church of England College,608,81,15,96
Blackpool,Roseacre Primary Academy,610,67,3,70
Somerset,Priorswood Primary School,186,37,4,41
Hackney,Yesodey Hatorah Girls School,478,55,8,63
Worcestershire,Sutton Park Primary School,231,67,3,70
Harrow,Priestmead Primary School and Nursery,879,58,27,85
Luton,Whitefield Primary Academy,448,79,12,91
Newcastle upon Tyne,Jesmond Park Academy,2019,245,34,279
Peterborough,Hampton Vale Primary Academy,687,87,7,94
Worcestershire,St George's CofE First School and Nursery,187,21,1,22
Lancashire,Adlington St Paul's Church of England Primary School,172,12,5,17
Cumbria,Dean CofE School,94,13,1,14
Norfolk,Winterton Primary School and Nursery,68,16,6,22
North East Lincolnshire,Woodlands Academy,310,44,4,48
Warrington,Padgate Academy,577,49,38,87
Oldham,Oasis Academy Clarksfield,459,93,15,108
Liverpool,Croxteth Community Primary School,298,71,9,80
North Yorkshire,Graham School,1006,110,29,139
Middlesbrough,Ayresome Primary School,740,125,5,130
Oldham,Teenage Works,43,0,43,43
Hampshire,Kingsgate School,18,1,17,18
Somerset,Nerrols Primary School and Nursery,202,22,3,25
Cheshire West and Chester,The Grosvenor Park Church of England Academy,197,25,5,30
Birmingham,Hopwood Hall School,16,0,16,16
Surrey,St Mark and All Saints Church of England Primary,149,25,8,33
Harrow,The Welldon Park Academy,445,61,21,82
Derbyshire,The Green Infant School,89,10,1,11
Walsall,Busill Jones Primary School,282,60,12,72
East Sussex,Annecy Catholic Primary School,199,43,3,46
Bath and North East Somerset,East Harptree Church of England Primary School,90,7,2,9
Bath and North East Somerset,Bishop Sutton Primary School,182,21,4,25
Dorset,The Beeches School,26,0,26,26
Salford,Marlborough Road Academy,291,59,9,68
Salford,The Albion Academy,892,136,11,147
Essex,Philip Morant School and College,1733,161,30,191
Essex,Colne Community School and College (Secondary and 16 to 19 Provision),1243,154,30,184
"Bournemouth, Christchurch and Poole",Kinson Academy,205,33,3,36
Wigan,Dean Trust Rose Bridge,699,182,10,192
Bradford,Southmere Primary Academy,365,45,9,54
Oxfordshire,Greyfriars Catholic School,655,60,16,76
Barnet,Shalom Noam Primary School,236,30,6,36
Essex,Clarity Independent School,7,0,7,7
Staffordshire,Peak Education - Cannock,57,1,56,57
Staffordshire,All Saints' CofE  Primary School,112,19,0,19
Wiltshire,Bemerton St John Church of England Primary,209,21,4,25
Buckinghamshire,Bedgrove Junior School,486,42,13,55
Oxfordshire,Hardwick Primary School,233,44,8,52
Oldham,Thorp Primary School,215,11,1,12
Gloucestershire,Bibury Church of England Primary School,26,6,1,7
Oldham,Fir Bank Primary School,231,26,4,30
Staffordshire,Redbrook Hayes Community Primary School,212,27,10,37
Oxfordshire,Larkrise Primary School,401,118,9,127
Birmingham,Princethorpe Junior School,241,50,8,58
Thurrock,Aveley Primary School,434,67,26,93
North Yorkshire,George Pindar School,660,95,17,112
Slough,Lynch Hill Enterprise Academy,869,119,23,142
Hounslow,Springwell School,634,46,12,58
Stockton-on-Tees,Elmbank Learning Centre,5,2,3,5
East Sussex,Rye College,569,92,3,95
East Sussex,Rye Community Primary School,250,70,3,73
North Northamptonshire,Exeter A Learning Community Academy,520,98,25,123
Derby,Springfield Primary School,344,38,57,95
York,Rufforth Primary School,100,10,4,14
Sheffield,Pye Bank CofE Primary School,468,55,11,66
Bromley,St Paul's Cray Church of England Primary School,237,89,5,94
Peterborough,Woodston Primary School,584,65,16,81
Leicester,Highfields Primary School,365,53,8,61
Peterborough,Orton Wistow Primary School,396,40,6,46
Surrey,Warren Mead Infant School,220,26,2,28
Derby,Borrow Wood Primary School,325,37,8,45
Knowsley,Willow Tree Primary School,161,31,4,35
Wiltshire,Bishops Cannings Church of England Primary School,234,20,5,25
Swindon,Grange Infants' School,214,19,2,21
Bradford,Bradford Alternative Provision Academy,49,22,6,28
Leicester,Green Lane Infant School,317,47,5,52
Leicester,Uplands Infant School,403,28,9,37
Peterborough,Nene Valley Primary School,315,39,3,42
Derby,Asterdale Primary School,229,48,3,51
Hartlepool,Barnard Grove Primary School,328,58,6,64
Leicester,Sparkenhoe Community Primary School,467,63,14,77
Birmingham,Queensbury School,267,0,267,267
Hertfordshire,St John Catholic Primary School,188,29,2,31
Northumberland,Broomley First School,137,13,1,14
Kirklees,Netherton Infant and Nursery School,196,18,0,18
Enfield,Galliard Primary School,717,89,41,130
Staffordshire,Anson CofE Primary School,103,9,4,13
North Northamptonshire,Raunds Park Infant School,160,7,5,12
Rotherham,Thurcroft Infant School,269,66,3,69
Thurrock,St Mary's Catholic Primary School,234,17,12,29
Enfield,Walker Primary School,421,31,12,43
Lincolnshire,St Thomas CofE Primary Academy,404,46,8,54
Bexley,Belmont Academy,432,67,19,86
Northumberland,Highfield Middle School,398,73,9,82
Medway,Halling Primary School,376,33,6,39
Staffordshire,Knypersley First School,286,9,3,12
Staffordshire,Oxhey First School,215,14,3,17
Suffolk,Coldfair Green Community Primary School,141,17,3,20
Derby,Beaufort Community Primary School,312,66,11,77
Hertfordshire,Wheatfields Junior Mixed School,358,51,9,60
Derby,Portway Junior School,346,53,4,57
Norfolk,Kinsale Junior School,218,35,5,40
Wiltshire,Woodborough Church of England Primary School,167,17,3,20
Enfield,Raynham Primary School,647,74,35,109
Bexley,Woodside Academy,199,0,199,199
Redcar and Cleveland,Teesville Academy,323,47,2,49
Portsmouth,Stamshaw Infant Academy,207,46,5,51
Cambridgeshire,Holme CofE Primary School,117,14,2,16
Kirklees,Meltham Moor Primary School,215,31,5,36
Bury,Elms Bank,307,0,307,307
Bexley,Castilion Primary School,359,44,8,52
Hertfordshire,Wheatfields Infants' and Nursery School,328,54,9,63
Northumberland,Ovingham Middle School,335,29,12,41
Sefton,Kew Woods Primary School,452,64,18,82
Somerset,Charlton Horethorne Church of England Primary School,54,6,1,7
Shropshire,Lower Heath CofE Primary School,106,12,3,15
Essex,"St Andrew's Church of England Primary School, Great Yeldham",139,18,2,20
Blackburn with Darwen,Crosshill Special School,106,0,106,106
Enfield,Wilbury Primary School,819,97,22,119
Staffordshire,Queen's Croft High School,204,1,203,204
Wiltshire,Chirton Church of England Primary School,77,7,1,8
Hertfordshire,Holy Rood Catholic Primary School,452,32,5,37
Staffordshire,Kingsfield First School,223,18,5,23
North Northamptonshire,Hawthorn Community Primary School,294,44,11,55
Kirklees,Honley High School,1271,159,38,197
Staffordshire,The Friary School,1228,104,12,116
Suffolk,Pakefield High School,687,103,25,128
Staffordshire,Henry Chadwick Primary School,103,16,4,20
Northumberland,Wylam First School,132,18,5,23
North Somerset,All Saints Church of England Primary School,120,11,2,13
North Northamptonshire,Woodford Church of England Primary School,109,11,2,13
Staffordshire,James Bateman Middle School,392,44,4,48
Newham,North Beckton Primary School,491,62,18,80
Lincolnshire,Wyberton Primary Academy,210,31,5,36
Surrey,Maybury Primary School,260,58,7,65
Staffordshire,Manor Hill First School,162,17,2,19
Doncaster,Brooke Primary Academy,328,38,3,41
Essex,Doddinghurst Church of England Junior School,212,24,5,29
Derby,Cherry Tree Hill Primary School,619,98,8,106
Hertfordshire,Divine Saviour Roman Catholic Primary School,204,25,0,25
Essex,Colne Engaine Church of England Primary School,114,16,4,20
Northumberland,Prudhoe Castle First School,69,17,2,19
Wiltshire,All Cannings Church of England Primary School,154,17,0,17
Northumberland,Prudhoe Community High School,754,85,10,95
Leeds,Raynville Academy,436,102,2,104
Cambridgeshire,Warboys Primary Academy,332,50,9,59
Northumberland,Ovingham Church of England First School,129,7,2,9
Bury,Unsworth Primary School,214,28,19,47
Wiltshire,Rushall Church of England Primary School,63,9,1,10
Enfield,Fleecefield Primary School,390,41,20,61
Blackburn with Darwen,Blackburn Central High School,921,192,21,213
Northumberland,Mickley First School,87,4,2,6
Derby,Oakwood Junior School,353,68,18,86
Oxfordshire,Beckley Church of England Primary School,100,8,1,9
Oxfordshire,Sutton Courtenay Church of England Primary School,213,45,4,49
Somerset,Brent Knoll Church of England Primary School,185,14,6,20
Staffordshire,The Reginald Mitchell Primary School,197,17,3,20
Essex,Fairhouse Community Primary School,410,68,9,77
Enfield,Brettenham Primary School,412,71,9,80
Doncaster,Marshland Primary Academy,140,21,1,22
Northumberland,Whittonstall First School,77,10,1,11
Kent,All Soul's Church of England Primary School,250,42,6,48
Bath and North East Somerset,Castle Primary School,328,48,7,55
Redcar and Cleveland,Mo Mowlam Academy,97,0,97,97
South Gloucestershire,Tyndale Primary School,153,21,2,23
Dorset,Harbour Vale School,6,4,2,6
Calderdale,Trinity Academy St Chad's,152,14,1,15
Derbyshire,Holme Hall Primary School,145,19,2,21
Suffolk,Helmingham Primary School and Nursery,30,7,1,8
Nottinghamshire,Langold Dyscarr Community School,287,26,3,29
"Bristol, City of",May Park Primary School,524,103,10,113
Cambridgeshire,St Luke's CofE Primary School,107,15,7,22
North Yorkshire,Starbeck Primary Academy,233,17,11,28
Cambridgeshire,Somersham Primary School,275,31,17,48
North Yorkshire,Northallerton School & Sixth Form College,1061,160,36,196
Bury,Hazel Wood High School,716,60,17,77
Lincolnshire,Witham Prospect School,15,0,15,15
Bath and North East Somerset,Beechen Cliff School,1284,154,19,173
Havering,Koru Independent AP Academy,50,10,2,12
Surrey,Hale Nursery & Primary Academy,329,70,10,80
Bath and North East Somerset,Cameley CEVC Primary School,157,19,3,22
Suffolk,St Pancras Catholic Primary School,192,29,5,34
Bath and North East Somerset,Pensford Primary School,99,11,1,12
Bath and North East Somerset,Chew Magna Primary School,103,18,0,18
Essex,Mildmay Primary School,652,43,32,75
Staffordshire,Heather Field School,95,0,95,95
Staffordshire,Lyme Brook Independent School,7,0,7,7
Swindon,Grange Junior School,334,46,5,51
Wigan,The Holden School,60,4,56,60
Cheshire East,Daven Primary School,145,31,11,42
Bury,Wesley Methodist Primary School,311,69,4,73
York,Skelton Primary School,103,11,2,13
Doncaster,Spa Academy Askern,232,69,1,70
Birmingham,Camp Hill Education,3,0,3,3
Hertfordshire,Roman Way Academy,188,33,4,37
Birmingham,Holy Souls Catholic Primary School,381,52,1,53
Somerset,Pawlett Primary School Academy,67,13,1,14
Somerset,King Arthur's School,463,46,16,62
Birmingham,St Thomas More Catholic Primary School,335,43,5,48
Lancashire,The Valley Leadership Academy,585,78,12,90
Somerset,North Cadbury Church of England Primary School,77,8,0,8
Hampshire,Oakfield Primary School,166,20,5,25
Derbyshire,Tupton Primary and Nursery Academy,238,63,4,67
Wokingham,Beechwood Primary School,352,41,9,50
Somerset,Winsham Primary School,44,2,0,2
Brent,Al-Zahra School,115,4,0,4
Croydon,Al-Khair Secondary Girls,83,1,0,1
Essex,Castle View School,968,138,20,158
Oxfordshire,Manor Primary School,345,42,7,49
Kent,The View School,24,0,24,24
Surrey,Bramley Hill School,36,0,36,36
Birmingham,Heritage Academy,56,7,0,7
Kent,Deal Parochial Church of England Primary School,199,37,9,46
Kent,Hornbeam Primary School,238,20,3,23
Kent,Northbourne Church of England Primary School,132,11,2,13
Kent,Sandown School,380,40,6,46
Kent,Sholden Church of England Primary School,97,9,2,11
Kent,The Downs Church of England Primary School,317,37,10,47
Kent,Stone Lodge School,677,163,44,207
Haringey,Odyssey House School,18,0,18,18
Barnet,Ark Pioneer Academy,720,74,18,92
Buckinghamshire,Abbey View Primary Academy,185,16,6,22
Suffolk,Abbeygate Sixth Form College,910,42,7,49
Devon,ACE Tiverton Special School,83,0,83,83
Swindon,Badbury Park Primary School,210,28,4,32
Hampshire,Boorley Park,192,31,6,37
Bradford,Bronte Girls' Academy,583,81,4,85
Leicester,Castle Mead Academy,966,143,16,159
South Gloucestershire,Charlton Wood Primary Academy,270,17,7,24
Derbyshire,Chellaston Fields Spencer Academy,141,16,3,19
Bexley,Cleeve Meadow School,108,0,108,108
"Bristol, City of",Trinity Academy,634,106,17,123
Southwark,Haberdashers' Borough Academy,704,111,16,127
Peterborough,Hampton Lakes Primary School,257,19,10,29
Nottinghamshire,Hucknall Flying High Academy,225,24,2,26
Bracknell Forest,King's Academy Oakwood,180,12,2,14
Bolton,King's Leadership Academy Bolton,717,98,7,105
Warwickshire,Lower Farm Academy,189,11,5,16
Cornwall,Nansledan School,302,35,8,43
Essex,Paxman Academy,697,116,41,157
Central Bedfordshire,Pix Brook Academy,561,51,20,71
Staffordshire,Poppyfield Primary Academy,146,5,4,9
Kent,River Mill Primary School,240,10,9,19
Devon,Roundswell Community Primary Academy,210,17,6,23
Staffordshire,Streethay Primary School,191,23,2,25
Swindon,The Deanery CE Academy,724,129,24,153
Dorset,Harbour School Dorset,81,0,81,81
Derbyshire,The Mease Spencer Academy,111,20,1,21
Leicestershire,New Lubbesthorpe Primary School,298,24,2,26
Warwickshire,Tudor Grange Primary Academy Meon Vale,137,20,0,20
Wiltshire,Wellington Eagles Primary Academy,201,22,2,24
Norfolk,White House Farm,164,29,2,31
Swindon,William Morris Primary School,289,30,5,35
North Yorkshire,Marton-Cum-Grafton Church of England Primary School,91,20,5,25
Peterborough,Welbourne Primary Academy,206,35,17,52
North Yorkshire,Knaresborough St John's Church of England Primary School,314,46,9,55
Bradford,Carlton Bolling,1623,264,35,299
Wigan,Golborne Community Primary School,331,43,4,47
South Tyneside,St Mary's Catholic Primary School,260,20,1,21
Staffordshire,Blackshaw Moor CofE First School,76,7,2,9
Kent,Cage Green Primary School,225,33,28,61
York,Carr Junior School,296,39,11,50
Shropshire,Mereside Church of England Primary Academy,378,48,10,58
Derbyshire,Woodthorpe CofE Primary School,143,19,1,20
County Durham,Our Lady of the Rosary Catholic Primary School,252,39,4,43
Birmingham,Sacred Heart Catholic School,185,25,1,26
Cambridgeshire,Oakington CofE Primary School,108,17,4,21
Birmingham,Sutton Park Primary,314,92,5,97
Milton Keynes,Langland Community School,194,35,4,39
Cumbria,Caldew Lea School,239,30,11,41
Lancashire,Morecambe Bay Academy,1050,133,15,148
Gloucestershire,The Milestone School,329,0,329,329
Bradford,Co-op Academy Delius,171,2,169,171
Derbyshire,Old Hall Junior School,246,25,3,28
Derby,Brookfield Primary School,254,21,10,31
Derbyshire,Walton Holymoorside Primary School,383,17,5,22
Coventry,Pearl Hyde Community Primary School,292,27,5,32
County Durham,Dene Academy,621,177,11,188
Sunderland,St Joseph's Catholic Primary School,221,14,1,15
Derbyshire,Ashgate Croft School,152,0,152,152
Derby,Carlyle Infant and Nursery Academy,166,18,3,21
Somerset,Critchill Special School,89,0,89,89
Oxfordshire,Springfield School,103,0,103,103
Hampshire,The Ferns Primary Academy,113,34,4,38
Doncaster,Norton Junior School,234,48,7,55
Sunderland,St Michael's Catholic Primary School,209,18,2,20
Derby,St Andrew's Academy,145,5,140,145
Cheshire East,Bexton Primary School,477,23,17,40
Doncaster,Norton Infant School,189,20,0,20
Gateshead,St Anne's Catholic Primary School,137,27,0,27
Sheffield,Becton School,9,4,5,9
Derby,St Clare's School,143,0,143,143
Sunderland,St Bede's  Catholic Primary School,221,10,4,14
Sunderland,Our Lady Queen of Peace Catholic Primary School,342,20,4,24
Derbyshire,Brooklands Primary School,400,59,1,60
Dorset,Shillingstone Church of England Primary School,115,27,8,35
Sunderland,St Robert of Newminster Catholic School and Sixth Form College,1642,148,24,172
Derby,St Martins School,230,0,230,230
Derbyshire,Westfield Infant School,178,19,1,20
Dorset,St Mary the Virgin Church of England  Primary School,245,45,4,49
Sunderland,St John Boste Catholic Primary School,172,19,1,20
Leicester,Abbey Mead Primary Academy,725,101,6,107
Derbyshire,Hodthorpe Primary School,61,10,0,10
Bradford,Oldfield Primary School,67,7,3,10
Lincolnshire,Thurlby Community Primary Academy,195,34,7,41
Milton Keynes,Moorland Primary School,208,37,2,39
Dudley,Northfield Road Primary School,390,79,8,87
Buckinghamshire,Elmhurst School,483,71,13,84
Derbyshire,Glossopdale School and Sixth Form,1246,133,25,158
Gloucestershire,Paternoster School,66,0,66,66
Bury,Radcliffe Hall Church of England Methodist  Primary School,292,59,7,66
Suffolk,The Bridge School,165,0,165,165
Walsall,St Bernadette's Catholic Primary School,156,17,2,19
Warwickshire,Stockingford Academy,527,96,27,123
Worcestershire,St Stephen's CofE First School,170,30,1,31
Dorset,Okeford Fitzpaine Church of England School,0,0,0,0
Lewisham,The Family Learning School,18,8,0,8
Staffordshire,Parkgate Farm,3,3,0,3
Lincolnshire,Castle Futures,124,0,124,124
Kirklees,Rida Boys High School,57,1,0,1
Bath and North East Somerset,Peasedown St John Primary School,446,76,8,84
Portsmouth,Stamshaw Junior School,240,66,5,71
Bradford,Co-op Academy Grange,1487,223,40,263
Gateshead,Grace College,1231,205,18,223
Waltham Forest,Longshaw Primary Academy,259,26,11,37
Waltham Forest,Salisbury Manor Primary School,327,20,12,32
Sandwell,West Bromwich Collegiate Academy,642,80,14,94
Central Bedfordshire,Marston Moreteyne VC School,649,103,30,133
Croydon,Al-Khair School Preparatory School,276,15,1,16
Southend-on-Sea,Cecil Jones Academy,883,246,19,265
West Sussex,Bohunt Horsham,727,166,16,182
Richmond upon Thames,Capella House School,55,7,48,55
Barking and Dagenham,Pathways School,47,9,38,47
Worcestershire,North Worcester Primary School,223,25,6,31
Sandwell,Shireland Technology Primary School,286,21,2,23
North Yorkshire,Keeble Gateway Academy,133,24,3,27
West Sussex,Kilnwood Vale Primary School,188,22,2,24
Lincolnshire,Springwell Alternative Academy Lincoln,52,34,18,52
Lincolnshire,Springwell Alternative Academy Mablethorpe,34,25,9,34
Lincolnshire,Springwell Alternative Academy Grantham,50,44,6,50
"Bournemouth, Christchurch and Poole",The Stable School,60,0,37,37
Greenwich,Social Arts for Education,25,4,21,25
Birmingham,"Eden Girls'  Leadership Academy, Birmingham",529,67,5,72
Oxfordshire,The Swan School,667,87,14,101
Bradford,"Eden Boys' Leadership Academy, Bradford",488,74,2,76
Kent,VTC Independent School,19,1,18,19
Lancashire,Bridgeway School,56,0,56,56
Kent,Medway Green School,50,0,50,50
Salford,Ateres Elisheva,137,22,0,22
East Riding of Yorkshire,Our Lady and St Peter Catholic Primary School  A Catholic Voluntary Academy,204,21,6,27
North Yorkshire,St George's Catholic Primary School - a Catholic voluntary academy,105,29,3,32
North Yorkshire,St Augustine's Catholic School - a Catholic voluntary academy,599,69,26,95
North Yorkshire,St Francis Xavier School - a Joint Catholic and Church of England Voluntary Academy,606,65,16,81
Dorset,All Saints' Church of England Academy,781,120,46,166
Thurrock,Little Thurrock Primary School,661,61,17,78
North Yorkshire,Cambrai Primary School,115,8,4,12
"Bristol, City of",Blaise High School,904,163,53,216
"Herefordshire, County of",Compass Community School Hereford,3,2,1,3
Leicester,Imam Muhammad Adam Institute Boys School,149,0,0,0
Bury,Yesoiday Hatorah Girls Academy,464,90,6,96
Staffordshire,The Woodlands Community Primary School,278,29,4,33
North Yorkshire,"All Saints Catholic Primary School, a Catholic Voluntary Academy",75,12,2,14
Birmingham,Orion School,11,7,2,9
Stockport,Progress Schools - Stockport,10,0,9,9
Stoke-on-Trent,Excellence Girls Academy,62,5,2,7
Cumbria,South Lakes Academy,13,0,13,13
Barnet,Hasmonean High School for Girls,581,72,6,78
Bexley,Hook Lane Primary School,439,57,28,85
North Yorkshire,St Mary's Catholic Primary School - a Catholic voluntary academy,165,11,3,14
Buckinghamshire,Bearbrook Combined School,457,76,19,95
North Yorkshire,St Joseph's Catholic Primary School - a Catholic voluntary academy,88,12,2,14
East Riding of Yorkshire,St Mary's Catholic Primary School - a Catholic voluntary academy,85,5,6,11
Wiltshire,Winsley CoE VC Primary School,137,15,12,27
Hertfordshire,Chancellor's School,1218,159,21,180
Norfolk,Cromer Junior School,252,56,14,70
East Riding of Yorkshire,St Mary & St Joseph Catholic Primary School - a Catholic voluntary academy,116,10,5,15
Wokingham,Shinfield Infant and Nursery School,317,21,8,29
Swindon,Catherine Wayte Primary School,400,47,9,56
Wiltshire,Fitzmaurice Primary School,295,37,15,52
East Riding of Yorkshire,St John of Beverley Catholic Primary School - a Catholic voluntary academy,168,21,6,27
Knowsley,St Gabriel's CofE Primary School,225,44,7,51
Stockton-on-Tees,Thornaby Church of England Primary School,350,65,5,70
Essex,Acorn Academy,265,34,1,35
North Northamptonshire,Glapthorn Church of England Primary School,75,8,2,10
Surrey,Woodmansterne Primary School,431,48,9,57
North Yorkshire,St Mary's Catholic Primary School - a Catholic voluntary academy,210,28,8,36
"Kingston upon Hull, City of",Gillshill Primary School,499,43,11,54
Lancashire,Central Lancaster High School,588,116,13,129
Suffolk,Set Felix,306,19,61,80
Halton,St Michael with St Thomas CE Primary School,186,46,1,47
Plymouth,Tor Bridge Primary School,180,29,5,34
Dorset,Bovington Academy,202,35,6,41
Essex,Waltham Holy Cross Primary Academy,587,66,7,73
Halton,Ditton Primary School,382,61,6,67
Halton,Kingsway Primary Academy School,230,26,20,46
Lincolnshire,University Academy Long Sutton,703,116,27,143
Milton Keynes,Christ the Sower Ecumenical Primary School,301,37,10,47
"Kingston upon Hull, City of",Cavendish Primary School,330,37,6,43
Leeds,Cockburn Haigh Road Academy,117,41,0,41
Salford,Beis Rochel Mcr Girls school ltd,122,15,0,15
West Berkshire,Francis Baily Primary School,551,83,10,93
North Yorkshire,St Benedict's Catholic Primary School - a Catholic voluntary academy,78,9,1,10
Stockton-on-Tees,St Francis of Assisi Church of England Primary School,450,59,3,62
North Yorkshire,Sacred Heart Catholic Primary School - a Catholic voluntary academy,94,10,2,12
Plymouth,Plympton St Mary's CofE Infant School,99,14,1,15
North Yorkshire,St Peter's Catholic Primary School - a Catholic voluntary academy,209,16,5,21
Staffordshire,St Mary and St Chad CofE First School,155,13,2,15
Kent,Horsmonden Primary Academy,180,11,4,15
Oxfordshire,Watlington Primary School,207,27,3,30
Essex,St Peter's Catholic Primary School,418,24,3,27
Hertfordshire,Hertsmere Jewish Primary School,418,25,8,33
Worcestershire,Northleigh CofE Primary School,168,27,1,28
North Somerset,Blagdon Primary School,101,6,1,7
Norfolk,Sacred Heart Catholic Voluntary Aided Primary School,101,26,4,30
Dorset,Wey Valley Academy,962,203,30,233
Slough,Darul Madinah,38,1,1,2
Bolton,"The Aspire Hub, Bolton",12,4,8,12
Hackney,Beis Rochel d’Satmar School,636,81,16,97
North Yorkshire,Clervaux Garden School,21,0,21,21
Staffordshire,Burton Fields School,201,31,6,37
Gloucestershire,Holmleigh Park High School,1312,249,19,268
Lancashire,Edenfield Girls' High School,76,0,0,0
Wakefield,Compass Community School Hemsworth,6,2,4,6
Derby,Hackwood Primary Academy,240,33,2,35
Gloucestershire,Hartpury Church of England Primary School,109,11,3,14
South Gloucestershire,Woodlands Primary School,470,65,10,75
Hackney,Ohr Emes,76,5,0,5
Gateshead,Tashbar Boys Nursery,37,4,1,5
Norfolk,Stalham Infant School and Nursery,90,10,1,11
Norfolk,East Ruston Infant School & Nursery,24,6,1,7
Somerset,Spaxton CofE Primary School,70,13,3,16
Somerset,Stogursey Church of England Primary School,65,6,2,8
Wandsworth,Ravenstone Primary School,385,31,30,61
Barking and Dagenham,St Joseph's Catholic Primary School,245,35,3,38
Barking and Dagenham,St Joseph's Catholic Primary School,319,43,11,54
Barking and Dagenham,The St Teresa Catholic Primary School,222,18,6,24
Kent,New School Canterbury,48,4,2,6
Bexley,Belvedere Infant School,264,27,4,31
Kingston upon Thames,Robin Hood Primary and Nursery School,200,20,2,22
Newham,St Edward's Catholic Primary School,428,27,9,36
Newham,St Francis' Catholic Primary School,334,34,6,40
Redbridge,Our Lady of Lourdes RC Primary School,429,54,8,62
Redbridge,SS Peter and Paul's Catholic Primary School,414,33,11,44
Coventry,St Elizabeth's Catholic Primary School,236,39,7,46
Coventry,St John Vianney Catholic Primary School,238,22,1,23
Coventry,St Augustine's Catholic Primary School,363,68,2,70
Coventry,St Thomas More Catholic Primary School,344,27,4,31
Coventry,Bishop Ullathorne Catholic School,1101,105,7,112
Coventry,Cardinal Newman Catholic School,1424,201,15,216
Sandwell,Shenstone Lodge School,107,0,107,107
Bury,Mill School - Bury,64,0,64,64
North Somerset,Winterstoke Hundred Academy,508,81,14,95
North Somerset,Broadoak Academy,683,330,28,358
Lewisham,Haberdashers' Hatcham Primary,415,51,11,62
Bexley,Haberdashers' Slade Green Primary,270,53,8,61
Bexley,Haberdashers' Crayford Primary,221,20,9,29
Derbyshire,Kensington Junior Academy,197,37,3,40
Gloucestershire,St Matthew's Church of England Primary School,199,25,4,29
Devon,Torlands Academy,2,1,1,2
Lewisham,Haberdashers' Knights Primary,172,25,7,32
Solihull,Tudor Grange Primary Academy Yew Tree,271,20,3,23
Salford,Bnos Margulis Viznitz Girls' School,101,13,1,14
Wolverhampton,St Anthony's Catholic Primary Academy,346,61,3,64
Oldham,Beal Vale Primary School,194,21,4,25
Rochdale,Matthew Moss High School,1206,156,48,204
Tameside,Dane Bank Primary School,233,19,4,23
Trafford,Longford Park School,73,2,71,73
Doncaster,West Road Primary Academy,382,62,8,70
Rotherham,Brinsworth Howarth Primary School,192,23,3,26
Sheffield,Woodseats Primary School,433,69,5,74
Luton,Tennyson Road Primary School,716,21,10,31
Wokingham,"St Nicholas Church of England Primary, Hurst",135,20,0,20
Wokingham,Crazies Hill Church of England Primary School,88,5,3,8
Wokingham,Sonning Church of England Primary School,202,18,3,21
Milton Keynes,Ashbrook School,178,16,6,22
Milton Keynes,Holmwood School,185,21,8,29
Peterborough,Northborough Primary School,188,10,5,15
Cambridgeshire,St Laurence Catholic Primary School,264,37,10,47
Peterborough,St Thomas More Catholic Primary School,412,49,12,61
Peterborough,Sacred Heart Catholic Primary School,209,25,7,32
Warrington,Croft Primary School,215,23,5,28
Warrington,Woolston Community Primary School,234,22,22,44
Warrington,Gorse Covert Primary School,229,13,4,17
Redcar and Cleveland,Bankfields Primary School,297,40,4,44
Redcar and Cleveland,Whale Hill Primary School,507,52,8,60
Redcar and Cleveland,Grangetown Primary School,294,87,12,99
Cumbria,Arlecdon Primary School,46,6,0,6
Cumbria,Thornhill Primary School,82,9,5,14
Cumbria,Wreay Church of England Primary School,92,17,4,21
Derbyshire,Church Gresley Infant and Nursery School,317,40,3,43
Derby,Ravensdale Junior School,360,72,11,83
Derbyshire,Springwell Community College,902,136,27,163
Devon,St Luke's Church of England School,829,218,25,243
County Durham,St William's Catholic Primary School,141,19,0,19
Essex,Tolleshunt D'Arcy St Nicholas Primary Academy,114,20,2,22
Essex,St Pius X Catholic Primary School,213,21,2,23
"Herefordshire, County of",St Weonard's Academy,28,7,1,8
East Riding of Yorkshire,All Saints Church of England Junior Academy,386,54,4,58
East Riding of Yorkshire,All Saints Church of England Infant Academy,314,26,6,32
Kent,Paddock Wood Primary Academy,611,62,6,68
Leicester,Braunstone Frith Primary Academy,532,136,15,151
Leicester,Kestrel Mead Primary Academy,796,96,23,119
Lincolnshire,Seathorne Primary Academy,265,45,9,54
Essex,"St Nicholas Church of England Primary School, Tillingham",146,19,4,23
Lincolnshire,Willoughby Academy,135,0,135,135
Norfolk,St Martha's Catholic Primary School,418,27,6,33
York,St Aelred's Catholic Primary School - a Catholic Voluntary Academy,196,50,7,57
York,St George's Catholic Primary School - a Catholic Voluntary Academy,218,22,2,24
York,St Wilfrid's Catholic Primary School - a Catholic Voluntary Academy,257,10,4,14
Somerset,Milford Junior School,392,59,12,71
Staffordshire,Woodcroft Academy,154,16,1,17
Staffordshire,St Paul's CofE First School,152,11,1,12
Staffordshire,St Leonard's CofE First School,70,7,1,8
Staffordshire,Etching Hill CofE Primary Academy,449,51,7,58
Staffordshire,Church Eaton Primary School,89,16,0,16
Surrey,Knaphill School,295,34,4,38
Surrey,The Knaphill Lower School,252,34,4,38
Surrey,St Polycarp's Catholic Primary School,410,48,11,59
Surrey,St Peter's Catholic School,1329,163,34,197
Surrey,St Thomas of Canterbury Catholic Primary School,430,23,8,31
Warwickshire,Kineton High School,1031,242,26,268
Redcar and Cleveland,Caedmon Primary School,296,51,2,53
Cambridgeshire,Pathfinder CofE Primary School,441,57,9,66
Stockton-on-Tees,Bewley Primary School,399,49,6,55
York,Our Lady Queen of Martyrs Catholic Primary School - a Catholic Voluntary Academy,408,37,7,44
Coventry,Christ The King Catholic Primary School,449,65,8,73
Staffordshire,Dove CofE Academy,79,14,0,14
Greenwich,The John Roan School,1106,199,35,234
Birmingham,King Edward VI Balaam Wood Academy,393,111,7,118
Cambridgeshire,Offord Primary School,79,18,2,20
Cornwall,Poltair School,802,116,10,126
Dorset,Budmouth Academy Weymouth,1538,204,48,252
Essex,Roxwell Church of England Primary School,88,12,1,13
Medway,Wainscott Primary School,455,65,8,73
Lincolnshire,St Nicholas CE Primary Academy,196,21,3,24
North Yorkshire,Friarage Community Primary School,323,48,11,59
Staffordshire,"All Saints CofE Primary School, Bednall",44,11,6,17
Suffolk,Great Whelnetham Church of England Primary School,76,14,0,14
Hertfordshire,Links Hatfield Academy,13,13,0,13
Birmingham,"The Olive School, Small Heath",420,53,4,57
Oldham,Medlock Valley Primary School,312,81,11,92
Kent,Dartford Bridge Community Primary School,471,50,3,53
Merton,Liberty Woodland School,63,14,1,15
Nottingham,The Wells Academy,682,89,2,91
North East Lincolnshire,Learning4Life-GY,45,0,25,25
Worcestershire,Nurture Learning,16,0,16,16
"Bournemouth, Christchurch and Poole",Avonbourne Boys' Academy,742,155,5,160
Wirral,Progress Schools - Hamilton Square,49,38,6,44
Devon,Belong School Devon,48,0,48,48
Essex,Compass Community School Essex,12,1,11,12
"Bristol, City of",Elmlea Infant School,271,22,1,23
Liverpool,University of Liverpool Mathematics School,76,8,2,10
Birmingham,Saint Barnabas Church of England Primary School,440,66,2,68
Dudley,Cherry Tree Learning Centre,0,0,0,0
Walsall,Pheasey Park Farm Primary School and Early Years Centre,633,117,6,123
Sheffield,Totley All Saints Church of England Voluntary Aided Primary School,210,15,0,15
Leeds,"St Augustine's Catholic Primary School, A Voluntary Academy",460,77,0,77
Leeds,"St Urban's Catholic Primary School, a Voluntary Academy",208,33,1,34
Leeds,"Sacred Heart Catholic Primary School, a Voluntary Academy",198,53,2,55
Leeds,"St Paul's Catholic Primary School, a Voluntary Academy",210,27,0,27
Leeds,"Immaculate Heart of Mary Catholic Primary School, A Voluntary Academy",446,45,7,52
Leeds,"Holy Rosary and St Anne's Catholic Primary School, a Voluntary Academy",241,42,1,43
Buckinghamshire,Woodside Junior School,242,22,2,24
Cheshire West and Chester,Acresfield Academy,245,9,11,20
Derby,St Werburgh's CofE Primary School,301,36,5,41
Derby,Ivy House School,84,0,84,84
Devon,Clawton Primary School,107,14,0,14
Devon,Broadhempston Village Primary School,58,7,0,7
Devon,Princetown Community Primary School,38,10,4,14
Devon,Drake's Church of England Primary School,50,5,2,7
Devon,Otterton Church of England Primary School,53,3,4,7
Worcestershire,Broadheath CofE Primary School,148,16,3,19
Worcestershire,Callow End CofE Primary School,101,7,0,7
Worcestershire,Martley CofE Primary School,139,17,1,18
East Riding of Yorkshire,North Cave Church of England Primary School,116,10,3,13
Norfolk,North Walsham High School,578,64,18,82
Nottinghamshire,Richard Bonington Primary and Nursery School,453,49,2,51
Oxfordshire,Benson Church of England Primary School,275,31,11,42
Shropshire,The Thomas Adams School,1255,134,16,150
Suffolk,Ringshall School,123,12,6,18
Surrey,Hinchley Wood Primary School,623,94,11,105
Swindon,Nythe Primary School,201,31,6,37
Wiltshire,Sutton Benger Church of England Primary School,172,14,1,15
Swindon,Orchid Vale Primary School,415,35,5,40
Derbyshire,North Wingfield Primary and Nursery Academy,354,34,10,44
Doncaster,Heatherwood School,82,0,82,82
Stockport,St Elisabeth's Church of England Primary,271,74,3,77
Kirklees,New Mill Infant School,80,8,3,11
County Durham,Bishop Ian Ramsey CofE Primary School,136,10,5,15
Hampshire,St Anne's Catholic Primary School,243,14,9,23
Lincolnshire,Spalding Parish Church of England Day School,553,80,12,92
North Yorkshire,Brayton Church of England Primary School,386,58,9,67
Somerset,St Mary's & St Peter's Church School,31,7,2,9
Somerset,Shepton Beauchamp Church School,32,4,2,6
Surrey,The Park School,110,0,110,110
Wolverhampton,Woodfield Primary School,597,68,13,81
Lincolnshire,Ermine Primary Academy,411,78,18,96
County Durham,Hermitage Academy,1041,72,12,84
Sunderland,Monkwearmouth Academy,878,76,9,85
Derbyshire,Hope Valley College,545,60,30,90
Kirklees,Co-op Academy Smithies Moor,233,30,2,32
Hertfordshire,Onslow St Audrey's School,824,138,26,164
Enfield,AIM Academy North London,605,140,18,158
Thurrock,Harris Academy Ockendon,1438,122,38,160
Sutton,Oaks Park High School,1260,206,91,297
Shropshire,Grange Primary School,174,28,2,30
Shropshire,Shrewsbury Academy,802,122,10,132
Redcar and Cleveland,Freebrough Academy,814,144,35,179
Lambeth,Harris Academy Clapham,582,79,21,100
Redcar and Cleveland,Outwood Academy Normanby,731,187,18,205
West Sussex,Educate U,40,0,40,40
Wandsworth,Roehampton Hospital School,29,9,5,14
Lancashire,Calder Lodge School,44,0,44,44
Worcestershire,Oldbury Park Primary School,334,79,15,94
Bury,Tottington Primary School,344,52,16,68
Trafford,St Hilda's CofE Primary School,244,34,4,38
Doncaster,Lakeside Primary Academy,399,44,6,50
Leeds,Bramhope Primary School,368,19,1,20
Bath and North East Somerset,Swainswick Church School,80,17,0,17
Wokingham,Polehampton Church of England Infant School,178,23,2,25
Derby,St Giles' Spencer Academy,143,0,143,143
Dorset,Damers First School,484,69,28,97
Essex,Tiptree Heath Primary School,195,21,3,24
Essex,Buckhurst Hill Community Primary School,380,30,16,46
Gloucestershire,Battledown Centre for Children and Families,65,0,65,65
Kent,Rolvenden Primary School,83,13,4,17
Lancashire,"St Augustine of Canterbury RC Primary School, A Voluntary Academy",206,23,5,28
Lancashire,"All Saints' Roman Catholic High School, a Voluntary Academy",489,92,11,103
Lincolnshire,Long Sutton County Primary School,432,79,10,89
Norfolk,Northgate Primary School,412,56,16,72
Shropshire,St Marys CofE Primary School,260,33,4,37
Staffordshire,Edge Hill Academy,348,22,4,26
Staffordshire,Wilnecote Junior Academy,304,33,8,41
Staffordshire,Heathfields Infant Academy,247,51,4,55
Staffordshire,St John's CofE Primary School,179,25,2,27
Staffordshire,Paulet High School,903,100,12,112
Suffolk,Wetheringsett Church of England Primary School,37,8,1,9
Doncaster,Plover Primary School,398,92,15,107
Gloucestershire,Belmont School,178,0,178,178
Lancashire,"St John the Baptist RC Primary School, a Voluntary Academy",211,9,6,15
Telford and Wrekin,Wrekin View Primary School,478,71,10,81
Wokingham,Polehampton Church of England Junior School,234,32,8,40
Lancashire,"Blessed Trinity Roman Catholic College, A Voluntary Academy",1283,296,21,317
Doncaster,Coppice School,132,1,131,132
Calderdale,St Joseph's Roman Catholic Voluntary Academy,132,23,4,27
Kirklees,Carlinghow Academy,286,34,8,42
Kent,St Katherine's School & Nursery,511,75,4,79
Lancashire,"St Mary's Roman Catholic Primary School, a Voluntary Academy",167,36,7,43
North Yorkshire,Carnagill Community Primary School,156,27,3,30
Suffolk,Chalk Hill,10,0,6,6
Wiltshire,Ludwell Primary School,96,12,1,13
Cumbria,Hensingham Primary School,148,28,7,35
Surrey,Merrywood House Independent Special School,56,0,56,56
Essex,Holland Park Primary School,417,61,6,67
Essex,Alton Park Junior School,421,65,7,72
Blackburn with Darwen,Noorul Uloom,142,0,0,0
Leicestershire,R.E.A.L Independent Schools Hinckley,22,0,22,22
Hampshire,Compass Community School Hampshire,5,2,3,5
Barnsley,Worsbrough Common Primary School,415,60,18,78
Barnsley,Churchfield Primary School,409,42,28,70
Doncaster,Sheep Dip Lane Academy,258,45,7,52
Sheffield,Whiteways Primary School,473,101,19,120
Sheffield,Owler Brook Primary School,441,144,13,157
Kirklees,Lepton CofE Primary Academy,183,10,3,13
Derby,Lawn Primary School,422,22,9,31
Derbyshire,Model Village Primary School,242,37,6,43
Derbyshire,Whaley Thorns Primary School,151,30,3,33
Derbyshire,Stubbin Wood School,218,1,185,186
"Kingston upon Hull, City of",Oldfleet Primary School,358,66,5,71
Kirklees,Hillside Primary School,343,72,11,83
Wolverhampton,St Patrick's Catholic Primary Academy,235,24,2,26
Bolton,"St Gregory's RC Primary School, A Voluntary Academy",190,26,5,31
Leeds,Armley Park Primary School,208,38,0,38
Leeds,St Marys Church of England Primary Academy,257,50,2,52
Nottinghamshire,Haggonfields Primary and Nursery School,96,20,1,21
Kent,Infiniti School,26,0,26,26
Warrington,Meadowside Community Primary and Nursery School,282,76,21,97
Warrington,Broomfields Junior School,351,42,12,54
Cheshire West and Chester,Eaton Primary School,151,9,2,11
Devon,Bere Alston Primary Academy,128,25,6,31
Oxfordshire,Charlbury Primary School,183,32,3,35
Oxfordshire,Blewbury Church of England Primary School,117,19,3,22
Warwickshire,Lillington Primary School,254,48,12,60
Devon,Dawlish College,674,93,31,124
Devon,Starcross Primary School,186,14,4,18
Sunderland,Hopespring Sunderland,19,7,12,19
Wiltshire,Rowde CofE Academy,103,30,5,35
Devon,Avanti Hall School,412,102,37,139
Somerset,Avanti Park School,452,55,6,61
"Bristol, City of",Avanti Gardens School,218,35,5,40
Hackney,Waterside Academy,392,32,10,42
Cheshire East,The Oaks Academy,536,66,23,89
Hampshire,GLADE School,20,0,20,20
Cheshire East,Norbury Court School,1,0,1,1
Cambridgeshire,The Martin Bacon Academy,123,0,123,123
Rochdale,Rochdale Islamic Academy,170,1,1,2
Windsor and Maidenhead,Queensmead House School,103,0,103,103
Derbyshire,R.E.A.L Independent Schools Ilkeston,25,0,25,25
Liverpool,Prudentia Education,48,28,20,48
Rotherham,Ellern Mede Moorgate School,6,3,3,6
Birmingham,Abbey Catholic Primary School,415,44,5,49
County Durham,Sedgefield Community College,991,109,20,129
Surrey,Byfleet Primary School,236,46,9,55
Reading,Hamilton School,51,0,51,51
Southampton,Weston Secondary School,747,114,15,129
Lincolnshire,Linchfield Academy,326,28,8,36
Surrey,Darley Dene Primary School,235,29,17,46
Hertfordshire,Brandles School,69,0,69,69
Brighton and Hove,Moulsecoomb Primary School,172,61,5,66
Greenwich,Greenwich Engineering and Medical School,0,0,0,0
Halton,Sandymoor Ormiston Academy,601,70,20,90
Derby,UTC Derby Pride Park,263,43,6,49
Luton,Al Hikmah Boys School,102,0,0,0
North Northamptonshire,Progress Schools - Thrapston,24,22,1,23
Gateshead,Shoshanim,42,3,0,3
Hampshire,St Columba CE Primary School,106,23,9,32
Birmingham,V.A.S.E Academy,20,0,19,19
Lincolnshire,Esland Grantham School,23,1,22,23
Essex,The Karalius Foundation,18,0,18,18
Somerset,Silver Bridge School,47,0,47,47
Barnet,Childs Hill Primary School,462,36,25,61
Birmingham,St Edmund Campion Catholic School,1127,115,5,120
Dudley,Blowers Green Primary School,243,37,1,38
Bradford,Co-Op Academy Princeville,476,28,29,57
Dorset,Henbury View First School,150,14,5,19
County Durham,Seaham High School,1158,173,26,199
East Sussex,St John's Meads Church of England Primary School,216,29,8,37
Essex,Home Farm Primary School,406,58,3,61
Worcestershire,St Thomas More Catholic First School,184,34,2,36
Nottinghamshire,Forest Glade Primary School,242,22,3,25
Oxfordshire,Christopher Rawlins Church of England Voluntary Aided Primary School,269,44,5,49
Barnsley,Athersley South Primary School,304,46,6,52
Barnsley,Mapplewell Primary School,347,27,6,33
Reading,Cranbury College,74,45,29,74
Portsmouth,The Harbour School,106,10,96,106
Dudley,Wallbrook Primary Academy,262,43,5,48
Stockport,Bredbury St. Marks CofE Primary School,154,35,1,36
Redcar and Cleveland,Laurence Jackson School,1214,161,40,201
Derby,St Peter's Church of England Aided Junior School,204,29,2,31
Gloucestershire,The Willow Primary Academy,185,37,40,77
Lincolnshire,"St Paul's Community Primary and Nursery School, Spalding",247,39,8,47
Oxfordshire,Orion Academy,96,0,96,96
Kent,Sunny Bank Primary School,194,36,10,46
Salford,St Paul's CofE Primary School,237,23,5,28
Southwark,Arco Academy,8,6,1,7
Calderdale,Beacon Lights Schools,120,11,0,11
Leicestershire,Nanpantan Hall Nurture Centre,8,0,8,8
Lancashire,Springfield House School,3,1,2,3
Sandwell,Dudley Port School,25,0,25,25
Cheshire West and Chester,Maple Grove School,48,0,48,48
Rotherham,Redscope Primary School,454,147,9,156
Rotherham,Thorpe Hesley Primary School,546,68,9,77
Derbyshire,Chaucer Infant School,209,29,5,34
Derbyshire,Chaucer Junior School,234,31,10,41
Kent,Queenborough School and Nursery,470,72,7,79
Kent,Bysing Wood Primary School,236,35,13,48
Kent,Briary Primary School,295,30,7,37
Kent,Holywell Primary School,196,17,5,22
Oxfordshire,Finmere Church of England Primary School,35,7,1,8
Swindon,Brook Field Primary School,412,38,7,45
Birmingham,Starbank School,2186,352,26,378
Birmingham,Osborne Primary School,405,69,7,76
Oxfordshire,Botley School,287,52,7,59
East Riding of Yorkshire,Keyingham Primary School,194,32,6,38
Worcestershire,Upper Arley CofE Primary School,63,8,2,10
North Yorkshire,Rillington Primary School,111,37,4,41
North Yorkshire,Thornton Dale CofE Primary School,135,22,4,26
North Yorkshire,Skipton Parish Church of England Primary School,230,26,2,28
Middlesbrough,Thorntree Academy,269,35,1,36
Surrey,Pathways Education,7,0,7,7
Medway,Delce Academy,359,63,17,80
Staffordshire,Compass Community School Staffordshire,5,1,4,5
Worcestershire,RGS Dodderhill,187,79,4,83
Oxfordshire,Northern House Academy,82,0,82,82
Hertfordshire,The Grange Academy,984,85,14,99
Salford,OYY Lubavitch Boys School,48,8,0,8
Sheffield,Bradfield School,1059,208,26,234
Surrey,Elysian Animal Assisted Therapy and Learning CIC,15,0,15,15
Hammersmith and Fulham,Queensmill School,243,1,242,243
Sandwell,St Mary's Catholic Primary School,230,25,5,30
Walsall,Brownhills Ormiston Academy,714,112,25,137
Doncaster,Hawthorn Primary School,246,36,2,38
Kirklees,New Mill Junior School,170,25,3,28
Bath and North East Somerset,Whitchurch Primary School,198,31,5,36
Bath and North East Somerset,St Mark's CofE School,247,71,24,95
Central Bedfordshire,Ramsey Manor Lower School,267,28,13,41
Central Bedfordshire,Parkfields Middle School,458,75,20,95
Wokingham,Keep Hatch Primary School,461,52,14,66
Windsor and Maidenhead,Clewer Green CofE First School,255,16,3,19
Buckinghamshire,Curzon Church of England Combined School,149,24,2,26
Peterborough,Dogsthorpe Infant School,259,21,9,30
Cheshire West and Chester,Comberbach Nursery and Primary School,176,11,1,12
Cheshire East,Little Bollington CofE Primary School,91,19,4,23
Derbyshire,Elmsleigh Infant & Nursery School,163,45,11,56
Devon,Berry Pomeroy Parochial CofE Primary School,97,3,4,7
Torbay,Brixham Church of England Primary School,244,24,9,33
County Durham,Stanhope Barrington CofE Primary School,148,18,1,19
County Durham,Ingleton CofE Primary School,48,6,1,7
Essex,Beckers Green Primary School,313,63,10,73
Essex,Finchingfield St John the Baptist CofE Primary Academy,56,7,0,7
Hertfordshire,St John's Church of England Infant and Nursery School,215,10,3,13
North Yorkshire,The Forest School,136,0,136,136
Northumberland,Morpeth Stobhillgate First School,143,24,2,26
Oxfordshire,Mabel Prichard School,105,1,104,105
Somerset,Cheddar First School,326,21,2,23
Somerset,Shipham Church of England First School,97,8,1,9
Somerset,Draycott & Rodney Stoke Church of England First School,70,6,0,6
Somerset,Fairlands Middle School,472,34,4,38
Staffordshire,Coton Green Primary School,322,28,3,31
Nottinghamshire,Hucknall National Church of England Primary School,418,35,2,37
Doncaster,North Ridge Community School,137,0,137,137
Shropshire,Oakmeadow Church of England Primary and Nursery School,479,35,3,38
Croydon,Ark Blake Academy,523,102,10,112
Kent,Aspire School,152,0,152,152
Hertfordshire,Avanti Meadows Primary School,148,11,2,13
Hampshire,Barton Farm Primary Academy,104,7,3,10
Leicester,Beauchamp City Sixth Form,925,28,5,33
Doncaster,Doncaster UTC,712,59,4,63
Oxfordshire,Wantage Primary Academy,148,22,0,22
Devon,Glendinning Academy,121,0,121,121
Sunderland,Harry Watts Academy,140,8,132,140
Somerset,Isambard Kingdom Brunel Primary School,145,8,3,11
Essex,Lakelands Primary School,116,8,3,11
Blackpool,Lotus School,40,0,40,40
Devon,Monkerton Community Primary School,292,31,3,34
Thurrock,Orsett Heath Academy,348,48,14,62
Middlesbrough,Outwood Academy Riverside,448,90,6,96
Suffolk,Sir Bobby Robson School,65,0,65,65
Kent,Springhead Park Primary School,368,42,4,46
Torbay,St Michael's Church of England Academy,48,0,0,0
Hampshire,Stoneham Park Primary Academy,116,6,1,7
Thurrock,Thames Park Secondary School,362,18,24,42
Cheshire East,The Axis Academy,61,4,57,61
East Sussex,The Workplace,0,0,0,0
Surrey,Westvale Park Primary Academy,215,26,2,28
Norfolk,Wymondham College Prep School,234,26,2,28
Leicestershire,The Fusion Academy,66,0,66,66
Tameside,Safe Start School,23,0,23,23
Milton Keynes,Watling Academy,841,72,15,87
Bath and North East Somerset,Two Rivers Church of England Primary,60,15,1,16
Wokingham,Alder Grove Church of England  Primary School,204,20,3,23
Ealing,Ark Soane Academy,350,61,8,69
Doncaster,Bader Special Academy,98,0,98,98
Oxfordshire,Barton Park Primary School,109,9,2,11
Kent,Bearsted Primary Academy,263,54,3,57
Kent,Ebbsfleet Green Primary School,262,38,16,54
Reading,Green Park Village Primary Academy,120,10,2,12
Derbyshire,Highfields Spencer Academy,183,39,3,42
Kent,Snowfields Academy,175,0,175,175
Rotherham,Waverley Junior Academy,534,43,13,56
Oxfordshire,Whitelands Academy,361,106,16,122
Croydon,Addington Valley Academy,113,1,112,113
Rochdale,Newhouse Academy,998,134,19,153
Buckinghamshire,St Mary's Church of England School,455,51,11,62
Cheshire East,Disley Primary School,284,19,4,23
Essex,St Mary's Church of England Primary School,43,10,2,12
Hertfordshire,Woodside Primary School,223,28,5,33
Suffolk,Combs Ford Primary School,377,58,10,68
Sandwell,Stuart Bathurst Catholic High School,899,121,13,134
Bury,The Heys School,595,67,13,80
Kirklees,Old Bank Academy,106,16,2,18
Manchester,Prospect House Specialist Support Primary School,80,0,80,80
Kirklees,Newsome Academy,700,85,46,131
"Bristol, City of",Soundwell Academy,120,0,120,120
Bath and North East Somerset,St Mary's CofE Primary School,151,28,1,29
Milton Keynes,St Mary and St Giles Church of England School,366,69,5,74
Peterborough,Richard Barnes Academy,98,28,3,31
Dorset,Pamphill Church of England First School,71,5,3,8
County Durham,Tanfield School,701,116,14,130
Gloucestershire,Drybrook Primary School,143,35,6,41
Cheshire East,Lavender Field School,93,0,93,93
Kent,The Holmesdale School,509,54,10,64
Oxfordshire,St John's Catholic Primary School,175,23,2,25
Cheshire East,Cornerstone Academy,14,0,14,14
Leicestershire,Countesthorpe Academy,1232,156,16,172
Worcestershire,St Matthias Church of England Primary School,189,49,3,52
Dorset,St Osmund's Church of England Middle School,722,111,13,124
Plymouth,Millbay Academy,550,76,22,98
Dorset,The Luccombe Hub,25,0,25,25
Kingston upon Thames,Tennis Avenue School,12,2,0,2
Oxfordshire,Cherry Fields Primary School,100,11,5,16
Nottinghamshire,Rosecliffe Spencer Academy,282,15,1,16
West Sussex,Atelier21 Future School,105,15,4,19
Oldham,Westwood Boys School,15,0,0,0
Redcar and Cleveland,Mackenzie Thorpe Centre,30,0,30,30
Tameside,St James' Church of England Primary School,211,25,1,26
Tameside,Wild Bank Primary School,158,27,3,30
Rotherham,Meadow View Primary School,203,77,8,85
Sheffield,Woodhouse West Primary School,401,97,5,102
Bradford,"St Francis Catholic Primary School, A Voluntary Academy",243,33,5,38
Bradford,"St Cuthbert and the First Martyrs' Catholic Primary School, A Voluntary Academy",244,50,4,54
Bradford,"St Joseph's Catholic Primary School, A Voluntary Academy",188,24,4,28
Nottinghamshire,The Florence Nightingale Academy,363,71,3,74
Wokingham,Wescott Infant School,159,8,10,18
Derbyshire,Ashbrook Junior School,174,32,2,34
County Durham,"St Godrics Catholic Primary School, Thornley",70,12,1,13
County Durham,"St Marys Catholic Primary School, Wingate",65,12,0,12
Northumberland,NCEA Warkworth Church of England Primary School,188,21,0,21
Suffolk,Freeman Community Primary School,208,32,4,36
Suffolk,Chilton Community Primary School,165,15,5,20
Suffolk,Abbot's Hall Community Primary School,396,44,6,50
Suffolk,Bosmere Community Primary School,251,28,5,33
Surrey,Broadwater School,665,144,54,198
West Sussex,Milton Mount Primary School,626,72,7,79
West Sussex,St Joseph's Catholic Primary School,422,55,6,61
Rotherham,St Ann's Primary School,364,76,6,82
Bradford,Carlton Mills,320,44,9,53
Norfolk,Bluebell Primary School,233,31,20,51
Rochdale,"Our Lady & St Paul's RC Primary School, A Voluntary Academy",196,42,3,45
Stockport,"St Anne's Roman Catholic High School, A Voluntary Academy",592,103,17,120
Surrey,Bramley Oak Academy,57,0,57,57
Peterborough,Lime Academy Orton,151,0,151,151
Leeds,Alder Tree Primary Academy,317,61,0,61
Nottinghamshire,Venture Learning,13,8,5,13
Cheshire West and Chester,Abbey School for Exceptional Children,67,0,67,67
Westminster,Maida Vale School,159,60,6,66
Leicestershire,Lodge Farm Education,10,0,10,10
Harrow,Harmony Primary School,50,0,0,0
Plymouth,Marine Academy Plymouth,910,123,20,143
Norfolk,Watton Junior School,261,57,9,66
Merton,Benedict Academy,163,33,4,37
Croydon,West Thornton Primary School,929,88,13,101
Southwark,THE BRIDGE SPECIAL EDUCATION NEEDS SCHOOL,12,0,12,12
Northumberland,Rosewood Independent School,20,1,19,20
Bradford,"St Anthony's Catholic Primary School, A Voluntary Academy",226,20,0,20
Bradford,"St Anthony's Catholic Primary School, A Voluntary Academy",125,19,3,22
Calderdale,Millcourt School,45,0,45,45
Stoke-on-Trent,Rowan House School,5,2,3,5
Croydon,The New School,86,8,5,13
Somerset,The Levels School,62,9,53,62
Greenwich,Serenity School Eltham,111,0,111,111
Bath and North East Somerset,Paulton Infant School,206,27,8,35
Bath and North East Somerset,St Mary's Church of England Primary School,159,38,6,44
Central Bedfordshire,Westoning Lower School,106,6,1,7
Cheshire West and Chester,Tarvin Primary School,266,32,6,38
East Sussex,Sedlescombe CofE Primary School,187,24,2,26
Somerset,Lyngford Park Primary School,294,21,6,27
Staffordshire,Endon High School,698,77,20,97
Lewisham,Sedgehill Academy,722,84,14,98
Southampton,St Monica Primary School,420,42,9,51
Somerset,Abbot's Way School,34,5,29,34
Essex,Beckmead Moundwood Academy,61,26,1,27
Swindon,St Leonard's Church of England Primary Academy,174,17,3,20
Buckinghamshire,International School of Creative Arts,66,18,0,18
Devon,Colyton Primary Academy,161,30,6,36
Southwark,Charles Dickens Primary School,488,51,12,63
Rotherham,Ferham Primary School,242,26,4,30
Wokingham,Westende Junior School,240,16,21,37
Buckinghamshire,Elmtree Infant and Nursery School,207,32,8,40
Derbyshire,Field House Infant School,163,43,3,46
Derbyshire,Ladywood Primary School,337,89,7,96
Derbyshire,Waingroves Primary School,206,35,4,39
Devon,Fremington Primary School,424,71,15,86
Devon,North Molton Primary School,128,29,1,30
North Yorkshire,Greatwood Community Primary School,216,30,7,37
North Yorkshire,"St Hedda's Catholic Primary School, a Catholic Voluntary Academy",32,6,0,6
Somerset,East Huntspill Primary Academy,86,4,0,4
Wiltshire,The New Forest Church of England Primary School,147,28,3,31
Newham,St Antony's Catholic Primary School,468,93,2,95
Trafford,"St Antony's Roman Catholic School, a Voluntary Academy",686,61,63,124
Leicestershire,The Cedars,4,0,4,4
North Lincolnshire,Flourish With Us,27,0,27,27
Leicestershire,Foxfields Academy,59,0,59,59
"Bournemouth, Christchurch and Poole",The Lion Works School,23,0,23,23
Warwickshire,VLC,19,0,19,19
East Sussex,The Ropemakers' Academy,62,0,62,62
Gloucestershire,Gloucester Academy,750,124,11,135
Stoke-on-Trent,Active Wellbeing School,39,0,39,39
Cornwall,Red Moor School,55,0,55,55
Lancashire,Northbrook Primary Academy,176,24,7,31
Hertfordshire,De Havilland Primary School,453,76,8,84
Shropshire,Westbury School,6,0,6,6
Croydon,Aya College (Educational Provision),0,0,0,0
Dorset,Graduately Developing Futures,7,0,7,7
Cheshire East,Compass Community School Cheshire,2,0,2,2
Bury,"St Gabriel's RC High School, a Voluntary Academy",1048,70,41,111
Bury,"St Monica's RC High School, a Voluntary Academy",1111,126,31,157
Warwickshire,ALP Nuneaton,23,0,23,23
East Sussex,The Flagship School,26,1,25,26
Lancashire,Pioneer TEC,4,1,3,4
Suffolk,Wetheringsett Manor School,40,0,40,40
Calderdale,Compass Community School Willow Park,25,0,25,25
Gloucestershire,Tredington Community Primary School,66,6,8,14
Staffordshire,Forest Hills Primary School,100,29,3,32
Kent,Belle Vue School,44,0,44,44
Sandwell,Compass Community School Victoria Park,25,3,22,25
Kent,Folkestone Primary,424,50,9,59
"Bournemouth, Christchurch and Poole",Connie Rothman Learning Centre,26,0,26,26
Wigan,Progress Schools - Lilford Centre,23,4,19,23
Redbridge,Endeavour House School,8,0,8,8
Portsmouth,Wimborne Primary School,559,41,13,54
Coventry,Summit School,27,16,9,25
Birmingham,Guardian Angels Catholic Primary School,207,39,3,42
Birmingham,Our Lady's Catholic Primary School,210,32,3,35
Birmingham,St Wilfrid's Catholic Junior and Infant School,353,38,3,41
Solihull,Lady Katherine Leveson Church of England Primary School,164,32,6,38
Solihull,Our Lady of the Wayside Catholic Primary School,456,58,3,61
Solihull,St Andrew's Catholic Primary School,232,28,2,30
Solihull,St Augustine's Catholic Primary School,238,19,1,20
Solihull,St George and St Teresa Catholic Primary School,214,32,4,36
Solihull,Our Lady of Compassion Catholic Primary School,338,44,2,46
Solihull,St Anthony's Catholic Primary School,258,39,4,43
Solihull,St Anne's Catholic Primary School,453,85,9,94
Solihull,St John the Baptist Catholic Primary School,215,27,2,29
Solihull,St Peter's Catholic School,1291,175,10,185
Bolton,Chorley New Road Primary Academy,311,58,9,67
Bury,Greenhill Primary School,243,21,3,24
Bury,Woodhey High School,1114,124,49,173
Tameside,St George's CofE Primary School,228,28,14,42
Sheffield,Brook House Junior,338,34,5,39
Bradford,"St Joseph's Catholic Primary School, A Voluntary Academy",346,76,4,80
Bradford,"St William's Catholic Primary School, A Voluntary Academy",142,18,2,20
Central Bedfordshire,Campton Academy,125,15,1,16
Cambridgeshire,Girton Glebe Primary School,186,22,9,31
Cornwall,Pondhu Primary School,180,33,11,44
Derbyshire,Bakewell CofE Infant School,30,4,0,4
Derbyshire,Bishop Pursglove CofE (A) Primary School,109,16,0,16
County Durham,Wolsingham School,752,187,13,200
Essex,St Joseph's Catholic Primary School,112,22,4,26
Essex,Holy Family Catholic Primary School,206,31,4,35
Oxfordshire,Sandwell Learning Centre,12,4,8,12
Southampton,Woolston Infant School,171,27,6,33
Worcestershire,Tudor Grange Primary Academy Perdiswell,380,64,3,67
Worcestershire,Feckenham CofE Primary School,114,19,1,20
Kent,Marden Primary Academy,281,36,4,40
Medway,Oaklands School,430,49,3,52
Kent,Eastchurch Church of England Primary School,368,59,18,77
Norfolk,Southtown Primary School,189,49,10,59
North Yorkshire,Escrick Church of England Primary School,183,21,11,32
Stoke-on-Trent,Waterside Primary School,449,65,5,70
Staffordshire,Castlechurch Primary School,254,29,2,31
Surrey,Fordway Centre,4,4,0,4
Surrey,Wey Valley College,28,26,2,28
Warwickshire,St Edward's Catholic Primary School,222,26,4,30
Sunderland,Consilium Evolve,0,0,0,0
Cambridgeshire,Northstowe Secondary College,471,40,15,55
Surrey,Reigate Valley College,34,32,2,34
Stoke-on-Trent,The Beechfield School,10,2,8,10
Tameside,Greenfield Primary Academy,215,45,2,47
Staffordshire,Elm House School,5,1,4,5
Kirklees,Hill View Academy,210,36,3,39
Newcastle upon Tyne,Walbottle Academy,1630,145,23,168
Cheshire East,Alsager Highfields Community Primary School,222,32,16,48
Cumbria,Newtown Primary School,121,16,7,23
County Durham,Bluebell Meadow Primary School,228,49,5,54
Essex,de Vere Primary School,195,20,6,26
Worcestershire,Arrow Valley First School,152,41,1,42
West Sussex,Blackwell Primary School,346,67,6,73
Calderdale,Trinity Academy St Peter's,103,18,1,19
Kent,North West Kent Alternative Provision Service,7,5,2,7
Wiltshire,Silverwood School,425,0,425,425
Wirral,LIFE Wirral Sports School,13,0,13,13
Hounslow,Sparrow Farm Primary School,469,112,4,116
Norfolk,Parker's Church of England Primary Academy,80,21,2,23
Norfolk,Caston Church of England Primary Academy,84,17,4,21
Ealing,Blooming Tree Primary School,14,0,14,14
Barnet,Woodside School,3,0,3,3
Worcestershire,Lokrum Fields,12,1,11,12
Birmingham,Redstone Academy for Girls,82,0,0,0
Lancashire,Warton St Paul's Church of England Primary Academy,103,25,11,36
Bradford,Cottingley Village Primary School,430,46,16,62
North Somerset,Uphill Village Academy,316,43,7,50
Dorset,Ferndown First School,359,52,10,62
Dorset,Parley First School,315,39,21,60
Dorset,Ferndown Middle School,595,73,21,94
East Riding of Yorkshire,St Joseph's Catholic Primary School,107,14,5,19
Leicester,Millgate School,125,3,122,125
North Yorkshire,"St Mary's Catholic Primary School, a Voluntary Academy",163,18,4,22
North Yorkshire,"Holy Family Catholic High School, A Voluntary Academy",342,77,24,101
Nottinghamshire,Abbey Road Primary School,429,24,4,28
Surrey,Kingfield Primary School,256,25,5,30
West Sussex,Clapham and Patching CofE Primary School,45,20,3,23
Leicester,Keyham Lodge School,115,0,115,115
Thurrock,Warren Primary School,448,30,28,58
Wiltshire,Amesbury Archer Primary School,412,71,12,83
Kirklees,ES Independent School Kirklees,23,2,2,4
Wiltshire,The Eaves Learning Centre,14,4,10,14
Liverpool,Runnymede St Edward's Catholic Primary School,303,29,3,32
South Gloucestershire,Raysfield Primary School,402,52,14,66
East Sussex,The Turing School,636,114,9,123
Devon,The Wildings,5,0,5,5
Doncaster,More Than Ed Independent School,21,0,21,21
Dudley,Foxyards Primary School,336,41,7,48
Worcestershire,Cherry Orchard Primary School,620,86,15,101
West Sussex,Rumboldswhyke CofE Primary School,77,15,3,18
Lincolnshire,The Giles Academy,768,98,15,113
Stockton-on-Tees,Thornaby Academy,454,98,25,123
Birmingham,City Academy,737,88,3,91
Nottinghamshire,Progression 2 Work,1,1,0,1
Lincolnshire,Aspiration House School,9,0,8,8
Hounslow,Unique Academy,44,1,0,1
Shropshire,Acorn Wood,6,0,6,6
Milton Keynes,Water Hall Primary School,284,55,6,61
Liverpool,Cavendish View School,30,0,30,30
Bradford,Grove House Primary School,418,29,21,50
Calderdale,Bowling Green Academy,147,26,6,32
Cheshire West and Chester,"St Paul's CofE Primary School, Utkinton and Cotebrook",18,7,2,9
County Durham,"St Bede's Catholic Primary School, Sacriston",95,16,2,18
County Durham,"St Benet's Catholic Primary School, Ouston",247,15,5,20
County Durham,"Our Lady Queen of Martyrs Catholic Primary School, Esh Winning",81,26,0,26
County Durham,"St Godric's Catholic Primary School, Durham",208,12,3,15
County Durham,"St Joseph's Catholic Primary School, Ushaw Moor",92,21,5,26
Thurrock,Bonnygate Primary School,446,65,15,80
Essex,Ford End Church of England Primary School,68,13,0,13
Gloucestershire,Aylburton Church of England Primary School,72,15,1,16
Gloucestershire,Lydney Church of England Community School,209,38,8,46
Hampshire,Awbridge Primary School,161,12,6,18
Hampshire,Wellow Primary School,207,18,5,23
Hampshire,Weyford Nursery and Primary Academy,428,66,6,72
Hampshire,Halterworth Primary School,435,30,7,37
Kent,Holy Trinity Church of England Primary School,457,65,9,74
Nottinghamshire,Winthorpe Primary School,98,13,1,14
Stoke-on-Trent,Co-Op Academy Clarice Cliff,413,68,3,71
Stoke-on-Trent,Birches Head Academy,1024,102,23,125
West Sussex,Steyning Grammar School,2206,350,41,391
Croydon,Woodcote Primary School,868,79,15,94
Newham,Eastlea Community School,885,98,42,140
Birmingham,Mayfield School,306,0,306,306
Liverpool,Alsop High School,1478,71,39,110
Central Bedfordshire,Lime Tree Primary Academy,294,45,2,47
Buckinghamshire,Edlesborough Primary Academy,174,20,3,23
Milton Keynes,Holne Chase Primary School,208,21,2,23
Gloucestershire,Bream Church of England Primary School,147,38,7,45
Lancashire,Castle View Primary Academy,123,30,6,36
Norfolk,Newton Flotman Church of England Primary Academy,102,13,1,14
North Yorkshire,Alanbrooke Academy,50,7,0,7
Central Bedfordshire,Studham Village CofE Academy,78,2,1,3
Staffordshire,Bailey Street Alternative Provision Academy,29,12,0,12
Cambridgeshire,The Harbour School,103,0,103,103
Norfolk,Garboldisham Church of England Primary Academy,74,11,2,13
Lancashire,Mayfield House School,1,0,1,1
Redbridge,Hatchside School,42,5,37,42
Wakefield,Ivy Lane School,18,0,18,18
Warwickshire,THE SECRET GARDEN SCHOOL,26,0,26,26
Barking and Dagenham,Frobel Independent School,23,0,0,0
Leicestershire,Henry David Learning Woodfield School,9,0,9,9
Oxfordshire,St Frideswide Church of England Primary School,306,79,9,88
Staffordshire,JP Alternative Education,20,8,12,20
Brent,Roundwood School and Community Centre,17,0,4,4
Wolverhampton,WV2 Education,20,0,20,20
Derbyshire,Hague Bar Primary School,62,6,2,8
Lancashire,Ormskirk School,1230,116,17,133
Leeds,LS-TEN,28,5,2,7
Bradford,"Our Lady and St Brendan's Catholic Primary School, A Voluntary Academy",193,30,10,40
North Northamptonshire,Polebrook Church of England Primary School,89,13,2,15
Bradford,"St Columba's Catholic Primary School, a Voluntary Academy",406,84,8,92
County Durham,"St Cuthbert's Catholic Primary School, Chester-Le-Street",189,19,2,21
Northumberland,"St Joseph's Catholic Middle School, Hexham",238,9,8,17
Northumberland,"St Mary's Catholic First School, Hexham",109,6,5,11
County Durham,"St Michael's Catholic Primary School, Esh Village",159,16,1,17
Birmingham,St John Fisher Catholic Primary School,209,20,0,20
Sandwell,Perryfields Academy,989,111,11,122
Bradford,Marshfield Primary,453,44,7,51
Newcastle upon Tyne,St Charles' Catholic Primary School,239,11,3,14
Newcastle upon Tyne,St Cuthbert's Catholic Primary School,193,12,2,14
Newcastle upon Tyne,St Catherine's Catholic Primary School,207,21,4,25
Newcastle upon Tyne,St Lawrence's Catholic Primary School,232,30,6,36
Newcastle upon Tyne,Our Lady and St Anne's Catholic Primary School,233,27,1,28
South Tyneside,St Aloysius Catholic Junior School Academy,243,36,6,42
South Tyneside,"St Aloysius Catholic Infant School, Hebburn",233,20,2,22
South Tyneside,"St Joseph's Catholic Primary School, Jarrow",231,18,5,23
Sunderland,"St Leonard's Catholic Primary School, Silksworth",130,34,3,37
Cheshire East,Manor Park Primary School and Nursery,270,61,11,72
Hartlepool,"Sacred Heart Catholic Primary School, Hartlepool",409,33,4,37
Hartlepool,"St Bega's Catholic Primary School, Hartlepool",155,23,2,25
County Durham,"St Chad's Catholic Primary School, Witton Park",79,8,2,10
Northumberland,St Wilfrid's Catholic Primary School,284,34,3,37
Northumberland,St Bede's Catholic Primary School,228,16,5,21
Nottinghamshire,John Hunt Academy,373,49,4,53
Staffordshire,Little Aston Primary Academy,245,19,0,19
West Sussex,St. Joseph's Infant School,112,12,2,14
Wakefield,Grove Lea Primary School,248,27,9,36
Bradford,Thorpe Primary,194,38,2,40
Barking and Dagenham,St Vincent's Catholic Primary School,228,26,3,29
Wirral,Brackenwood Junior School,251,49,6,55
Kirklees,Kirkheaton Primary School,377,31,15,46
Leeds,"Corpus Christi Catholic College, A Voluntary Academy",883,142,26,168
South Gloucestershire,Chipping Sodbury School,736,155,25,180
"Bristol, City of",North Star 82°,60,0,60,60
Luton,Farley Junior Academy,343,70,3,73
Redcar and Cleveland,Saltburn Primary School,378,41,10,51
Derbyshire,Highfields School,1303,139,23,162
Dorset,St James Church of England First School,117,2,2,4
Dorset,Cranborne Church of England First School,80,13,1,14
Dorset,Wimborne St Giles Church of England First School and Nursery,73,9,0,9
County Durham,Esh CofE (Aided) Primary School,92,13,1,14
County Durham,St Bede's Catholic School and Byron Sixth Form College,918,132,16,148
Essex,Bocking Primary School,190,39,3,42
Essex,Cressing Primary School,187,26,5,31
North Lincolnshire,Wrawby St Mary's CofE Primary School,136,9,0,9
Kent,Kingsdown and Ringwould Church of England Primary School,213,21,1,22
North Yorkshire,Carlton Primary School,155,10,5,15
North Northamptonshire,Ruskin Infant School,183,21,2,23
North Northamptonshire,Sywell Church of England Primary School,90,8,2,10
Nottinghamshire,John Clifford Primary School,385,13,5,18
Telford and Wrekin,Crudgington Primary School,122,19,1,20
Somerset,Neroche Primary School,237,15,5,20
Staffordshire,Greysbrooke Primary School,203,27,2,29
Staffordshire,St Christophers Catholic Primary Academy,201,7,4,11
Warwickshire,All Saints Bedworth CofE Academy,200,47,3,50
Swindon,Liden Academy,426,60,4,64
"Bristol, City of",North Star 240°,76,1,75,76
Dorset,Trinity Church of England First School,135,5,0,5
Surrey,Cobham Montessori School,26,8,0,8
Bury,Summerseat Methodist Primary School,82,17,5,22
Manchester,"St Chad's Roman Catholic Primary School, a Voluntary Academy",231,32,1,33
Stockport,Werneth School,1109,197,30,227
Dorset,Wool Church of England Primary School,100,13,6,19
Worcestershire,Witton Middle School,442,76,7,83
North Yorkshire,Outwood Primary Academy Alne,95,7,2,9
North Yorkshire,Forest Moor School,71,0,71,71
Sandwell,Lightwoods Primary Academy,418,43,3,46
Bedford,Ravensden CofE Primary Academy,75,11,10,21
Redcar and Cleveland,Huntcliff School,514,112,20,132
Cumbria,Kirkland Church of England Academy,31,2,1,3
Derbyshire,Outwood Academy Hasland Hall,784,113,22,135
Worcestershire,The De Montfort School,883,53,11,64
North Northamptonshire,Our Lady's Catholic Primary School,378,45,6,51
Sandwell,Hateley Heath Academy,436,43,7,50
Redcar and Cleveland,Outwood Alternative Provision Eston,35,31,1,32
Cornwall,The Lowen School,9,0,9,9
Hampshire,The Austen Academy,100,4,96,100
Norfolk,Banks House School,3,0,3,3
Worcestershire,Vale of Evesham School,184,2,182,184
Worcestershire,Newbridge School,38,38,0,38
Wokingham,Chiltern Way Academy Wokingham,49,0,49,49
Sutton,Beddington Park Academy,360,56,8,64
Croydon,Harris Primary Academy Croydon,406,45,7,52
Oxfordshire,Heyford Park School,584,92,16,108
Oxfordshire,The Oxford Academy,1154,293,33,326
Lincolnshire,Holton Sleaford Independent School,38,0,38,38
"Bournemouth, Christchurch and Poole",Avonwood Primary School,536,45,12,57
Enfield,Silverways School,35,0,35,35
Sandwell,The Regis Academy,5,4,0,4
Norfolk,Aurora White House School,54,0,54,54
Barnsley,Goldthorpe Primary Academy,288,79,5,84
Warwickshire,Trinity Catholic School,561,83,38,121
Hertfordshire,Roman Fields Academy,39,0,39,39
Walsall,Blackwood School,704,58,8,66
St. Helens,Rainford CofE Primary School,263,39,3,42
Hartlepool,"St Joseph's Catholic Primary School, Hartlepool",126,16,1,17
Hartlepool,"St Teresa's Catholic Primary School, Hartlepool",323,34,0,34
Derby,St James' Church of England Aided Junior School,282,51,10,61
Plymouth,Plymouth High School for Girls,826,9,3,12
Kent,Worth Primary School,63,16,0,16
Lincolnshire,The Bluecoat School,188,32,18,50
Lincolnshire,The Pinchbeck East Church of England Primary Academy,405,42,7,49
Lincolnshire,Spalding Primary Academy,414,59,14,73
North Yorkshire,Kirkbymoorside Community Primary School,209,31,9,40
North Yorkshire,Sinnington Community Primary School,107,4,1,5
North Yorkshire,Helmsley Community Primary School,169,22,4,26
North Yorkshire,Ryedale School,737,43,22,65
Somerset,The Sky Academy,76,0,76,76
Slough,Khalsa Primary School,490,31,8,39
Hartlepool,"St Cuthbert's Catholic Primary School, Hartlepool",249,56,2,58
North Yorkshire,"St Robert's Catholic Primary School, A Voluntary Academy",284,41,4,45
Nottinghamshire,Abbey Primary School,464,34,1,35
Nottinghamshire,The St Augustine's Academy,469,51,2,53
Derby,Brackensdale Spencer Academy,463,112,59,171
Hampshire,Marnel Junior School,411,76,16,92
Worcestershire,The Orchards School,260,39,2,41
Lancashire,Farington Primary School,202,27,5,32
Doncaster,Outwood Primary Academy Woodlands,405,88,8,96
Manchester,St Matthew's RC High School,1308,194,32,226
Leicestershire,Highgate Primary School,220,31,1,32
Leicester,Fosse Mead Primary Academy,434,59,4,63
Lincolnshire,Surfleet Primary School,68,17,3,20
Salford,The Lowry Academy,970,126,20,146
"Bristol, City of",Grace Garden School,22,0,22,22
Norfolk,The Damara School,9,0,9,9
West Sussex,Graffham Church of England Infant School (Voluntary Controlled),54,6,0,6
Lancashire,Compass Community School Lancashire,2,2,0,2
Warwickshire,Mill House School,20,0,20,20
Sandwell,High Point Academy,73,0,73,73
Staffordshire,St Thomas' CofE Primary Academy,191,29,5,34
Staffordshire,The King's CofE Academy,757,84,23,107
Plymouth,St Peter's CofE Primary School,122,21,2,23
Dorset,"Thorncombe, St Mary's Church of England Primary Academy",36,4,0,4
Lincolnshire,Friskney All Saints Church of England Primary School,84,21,2,23
Derbyshire,Spring Valley School,11,0,11,11
Kingston upon Thames,Chessington School,641,106,31,137
Doncaster,Carcroft Primary School,283,74,6,80
Gateshead,"St Oswald's Catholic Primary, Wrekenton",199,11,8,19
Gateshead,"St Alban's Catholic Primary School, Pelaw",194,20,4,24
Central Bedfordshire,Northill Church of England Academy,53,15,3,18
County Durham,"St Joseph's Catholic Primary, Stanley",225,21,1,22
County Durham,"St Mary's Catholic Primary School, Blackhill",205,18,4,22
Suffolk,Rushmere Hall Primary School,611,102,32,134
Ealing,Seva Education,49,0,49,49
Leicestershire,The Hinckley School,1163,170,23,193
North Somerset,Seven Hills,7,0,7,7
Worcestershire,Abigail's Place,9,0,9,9
Milton Keynes,KWS Milton Keynes,6,0,6,6
Essex,The Tower School,41,0,41,41
Essex,Mark Hall Academy,748,94,11,105
Leicestershire,The Lady Byron School,17,0,17,17
Suffolk,Ness Point School,18,0,18,18
Derbyshire,Poolsbrook Primary Academy,77,15,2,17
Derbyshire,Walton Peak Flying High Academy,136,25,3,28
Coventry,Meadow Park School,797,120,7,127
Tameside,Rayner Stephens High School,537,68,14,82
Tameside,Longdendale High School,805,84,15,99
Lincolnshire,West Grantham Church of England Primary Academy,239,32,5,37
Lincolnshire,West Grantham Church of England Secondary Academy,310,95,8,103
Hertfordshire,Garden Fields Junior Mixed and Infant School,567,87,7,94
Surrey,Frimley CofE Junior School,346,53,8,61
Rochdale,Moorhouse Academy,240,37,7,44
Shropshire,Woodlands School,50,1,49,50
Kensington and Chelsea,St Joseph's Catholic Primary School,223,15,3,18
Birmingham,The Rosary Catholic Primary School,406,112,8,120
Birmingham,St Chad's Catholic Primary School,207,24,7,31
Birmingham,St Joseph's Catholic Primary School,198,32,4,36
Barnsley,Milefield Primary School,307,47,10,57
Newcastle upon Tyne,"St Mark's Catholic Primary School, Westerhope",218,29,10,39
Newcastle upon Tyne,"St George's Catholic Primary School, Bells Close",98,20,2,22
Newcastle upon Tyne,"English Martyrs' Catholic Primary School, Fenham",464,51,7,58
Newcastle upon Tyne,"St Bede's Catholic Primary School, Newcastle",212,28,4,32
Newcastle upon Tyne,"St Alban's Catholic Primary School, Walker",227,32,1,33
North Tyneside,"St Cuthbert's Catholic Primary School, North Shields",215,28,2,30
North Tyneside,"St Joseph's Catholic Primary School, North Shields",263,65,6,71
North Tyneside,"St Mary's Catholic Primary School, North Shields",213,21,5,26
North Tyneside,"Star of the Sea Catholic Primary School, Whitley Bay",376,27,11,38
Sunderland,"St Patrick's Catholic Primary School, Ryhope",149,24,2,26
Wokingham,The Emmbrook School,1199,20,40,60
Cambridgeshire,The Icknield Primary School,200,30,6,36
Cheshire West and Chester,Belgrave Primary School,210,23,4,27
Warrington,Statham Primary School,187,18,6,24
Warrington,Ravenbank Primary School,409,27,5,32
Warrington,Oughtrington Primary School,411,52,5,57
Cheshire West and Chester,Leftwich Community Primary School,172,37,5,42
Stockton-on-Tees,Preston Primary School,213,16,10,26
Stockton-on-Tees,"St Cuthbert's Catholic Primary School, Stockton",224,14,6,20
Stockton-on-Tees,"St Patrick's Catholic Primary School, Stockton",284,6,9,15
Derbyshire,St George's CofE Primary School,201,28,2,30
Dorset,Wimborne First School and Nursery,331,28,6,34
County Durham,Annfield Plain Junior School,120,23,5,28
County Durham,Annfield Plain Infant School,75,14,0,14
County Durham,East Stanley School,191,19,2,21
Surrey,St Jude's CofE Infant School,189,19,3,22
Liverpool,Nazene Danielle School of Performing Arts,12,1,0,1
Hertfordshire,Redbourn Park School,12,0,12,12
Salford,Me'or High School,43,6,0,6
Devon,Orchard Manor School,197,0,197,197
Bradford,"St. Clare's Catholic Primary School, A Voluntary Academy",211,39,6,45
Calderdale,St Joseph's Catholic Primary Academy,163,13,3,16
Calderdale,St Joseph's Catholic Primary Academy,230,27,3,30
Kirklees,St Mary's Catholic Primary Academy,296,28,6,34
Kirklees,St Joseph's Catholic Primary Academy,214,21,3,24
Kirklees,St Joseph's Catholic Primary Academy,332,29,6,35
Kirklees,Our Lady of Lourdes Catholic Primary Academy,226,30,6,36
Kirklees,St Paulinus Catholic Primary Academy,384,81,13,94
South Tyneside,"St Bede's Catholic Primary School, South Shields",233,24,5,29
Cheshire East,Haslington Primary Academy,294,16,5,21
Warrington,Thelwall Infant School,112,14,0,14
Cheshire East,Audlem St James' CofE Primary School,194,18,3,21
Devon,Dartington Church of England Academy,270,34,11,45
Hertfordshire,St Joseph's Catholic Primary School B/S,428,32,5,37
Hertfordshire,St Joseph's Catholic Primary School (Wx),205,21,8,29
Hertfordshire,St Joseph's Catholic Primary School (Hertford),218,23,9,32
Hertfordshire,St Augustine's Catholic Primary School,235,27,3,30
Hertfordshire,St Thomas of Canterbury Catholic Primary School,118,12,6,18
Hertfordshire,St Cross Catholic Primary School,209,22,3,25
Cornwall,Fountain Head House School,50,0,50,50
Hertfordshire,Sacred Heart Catholic Primary School,199,28,5,33
Hertfordshire,St Mary's Catholic School,1158,71,10,81
Kent,Chartham Primary School,382,23,18,41
Kent,St Stephen's Infant School,269,26,1,27
Kent,Sandwich Infant School,148,20,1,21
Northumberland,"St Paul's Catholic Primary School, Alnwick",231,28,4,32
Northumberland,"St Aidan's Catholic Primary School, Ashington",237,27,2,29
Shropshire,Clive CofE Primary School,92,9,4,13
Staffordshire,The Richard Clarke First School,120,9,1,10
Staffordshire,Werrington Primary School,464,41,9,50
Staffordshire,Moorside High School,768,108,14,122
Suffolk,Hardwick Primary School,242,28,4,32
Surrey,St Edmund's Catholic Primary School,212,32,5,37
Warwickshire,Studley Infants' School,172,19,9,28
Warwickshire,Tysoe CofE Primary School,136,15,2,17
Warwickshire,Wellesbourne CofE Primary School,468,57,9,66
Warwickshire,Wootton Wawen CofE Primary School,90,10,1,11
Warwickshire,The Ferncumbe CofE Primary School,183,20,7,27
Bath and North East Somerset,St Nicholas Church School,217,54,20,74
Staffordshire,Langdale Primary School,427,44,10,54
Nottinghamshire,Springbank Academy,234,44,5,49
Kent,Fleetdown Primary Academy,648,75,28,103
Birmingham,Turves Green Boys' School,525,44,14,58
St. Helens,Outwood Academy Haydock,829,168,41,209
Wigan,Outwood Academy Hindley,922,176,20,196
Leeds,Oulton Academy,1010,148,10,158
Portsmouth,Corpus Christi Catholic Primary School,298,35,3,38
Somerset,West Huntspill Primary Academy,116,6,5,11
Hartlepool,St Hild's Church of England School,683,157,9,166
Coventry,Charter Academy,351,68,5,73
Knowsley,Saint Edmund Arrowsmith Catholic Academy,685,138,11,149
Sandwell,St John Bosco Catholic Primary School,242,24,5,29
Calderdale,Brearley Hall School,19,0,19,19
Derby,Alvaston Moor Academy,871,133,11,144
Thurrock,Treetops Free School,112,1,111,112
Staffordshire,Anker Valley Primary Academy,53,3,2,5
Suffolk,Castle East School,48,0,48,48
Manchester,Progress Schools - Gorton,1,1,0,1
Essex,Chatten Free School,50,0,50,50
Manchester,Co-op Academy Belle Vue,217,37,10,47
Bradford,Trinity Academy Bradford,881,176,23,199
Leicester,Brook Mead Academy,424,60,8,68
Rotherham,Thrybergh Academy,501,120,19,139
Nottingham,Bluecoat Trent Academy,417,61,3,64
Leicestershire,Ashby School,1623,153,25,178
Somerset,Othery Village School,43,2,0,2
Milton Keynes,Baytul Ilm Secondary School,47,0,0,0
East Sussex,ISP School,27,0,27,27
Birmingham,Prince Albert High School,390,58,6,64
Warwickshire,The Warwickshire Academy,30,1,29,30
Lambeth,Harris Clapham Sixth Form,285,3,4,7
Telford and Wrekin,Rodenhurst School,11,0,11,11
Kent,ISP Polar Restart Centre,4,0,4,4
Luton,Windmill Hill School,79,0,79,79
Leeds,Trinity Academy Leeds,477,65,3,68
Barnsley,Trinity Academy St. Edwards,362,42,11,53
Kensington and Chelsea,Kensington Queensmill School,76,1,75,76
Gloucestershire,The High School Leckhampton,244,39,10,49
Dudley,The King Alfred School,22,0,0,0
Warrington,Birchwood School,13,0,13,13
Blackpool,Tower Learning Centre Independent School,20,3,5,8
West Northamptonshire,Buckton Fields Primary School,104,1,2,3
Oxfordshire,Windrush Church of England Primary School,97,8,1,9
West Northamptonshire,Marie Weller Primary School,64,2,0,2
Norfolk,Bure Park Specialist Academy,50,0,50,50
Newcastle upon Tyne,Callerton Academy,241,28,3,31
Southwark,Lyndhurst Primary School,411,64,13,77
Surrey,Fox Grove School,114,0,114,114
Buckinghamshire,Kingsbrook View Primary Academy,150,17,6,23
Medway,Leigh Academy Rainham,405,95,6,101
Cambridgeshire,The Cavendish School,81,0,81,81
Cornwall,Launceston Primary School,38,9,2,11
Cornwall,Newquay Primary Academy,38,3,0,3
Bexley,Cornerstone School,51,0,51,51
North Northamptonshire,Chelveston Road School,57,0,57,57
Derbyshire,Clover Leys Spencer Academy,45,6,4,10
Derby,Castleward Spencer Academy,54,18,2,20
Worcestershire,Compass Community School Vicarage Park,8,0,8,8
"Kingston upon Hull, City of",Euler Academy,49,0,49,49
Birmingham,"Christ Church, Church of England Secondary Academy",362,99,8,107
"Bournemouth, Christchurch and Poole",Livingstone Academy Bournemouth,375,61,8,69
Brighton and Hove,Brighton International School,7,0,0,0
Newham,Learningsure College,0,0,0,0
Gloucestershire,Great Oldbury Primary Academy,115,6,1,7
Rochdale,Edgar Wood Academy,295,43,5,48
Staffordshire,Demetae Academy,25,0,6,6
Southampton,Yarrow Heights School,68,0,68,68
Hounslow,Eagle Park Independent School,21,0,21,21
Stockton-on-Tees,Bishopton PRU,59,18,5,23
North Yorkshire,Lady Lumley's School,860,98,15,113
Coventry,Alderman's Green Primary School,502,99,31,130
Gateshead,"St Joseph's Catholic Primary School, Gateshead",182,20,1,21
Gateshead,"St Augustine's Catholic Primary School, Gateshead",334,45,4,49
South Tyneside,"SS Peter and Paul Catholic Primary School, South Shields",233,38,5,43
Cumbria,Threlkeld CofE Primary School,50,6,0,6
Derbyshire,Hollingwood Primary School,348,38,7,45
County Durham,"St Patrick's Catholic Primary School, Dipton",157,11,4,15
County Durham,"All Saints' Catholic Primary School, Lanchester",195,17,1,18
North Northamptonshire,Redwell Primary School,627,35,14,49
Greenwich,Hawksmoor School,368,72,10,82
Greenwich,Wingfield Primary School,566,63,12,75
Leeds,Cockburn Laurence Calvert Academy,418,55,8,63
Gateshead,XP Gateshead,101,19,2,21
Norfolk,The Bridge Easton,36,0,36,36
Liverpool,NexGen Academy,28,0,3,3
Torbay,Preston Bridge School,36,0,36,36
Newham,School 360,51,3,1,4
Leicestershire,Ashby Hastings Primary School,47,3,2,5
Oxfordshire,Huckleberry Therapeutic School,8,0,8,8
County Durham,"St Cuthbert's Catholic Primary School, Seaham",206,33,3,36
County Durham,"Our Lady and St Thomas Catholic Primary School, Willington",121,16,3,19
County Durham,"St Charles' Catholic Primary School, Tudhoe",240,26,4,30
County Durham,"St Joseph's Catholic Primary School, Coundon",120,23,5,28
Devon,The Copper Academy,10,2,8,10
Surrey,Fernways School,34,0,34,34
Kent,MEPA ACADEMY,17,6,0,6
Birmingham,BOA Stage and Screen Production Academy,200,37,4,41
"Herefordshire, County of",The Beacon College,43,0,43,43
North Somerset,Chestnut Park Primary,76,11,2,13
Derby,Chellaston Academy,1785,186,35,221
Central Bedfordshire,Meppershall Church of England Academy,159,15,8,23
Cheshire East,Adelaide Heath Academy,63,5,58,63
Dudley,Priory Park Community School,29,8,21,29
Wolverhampton,Progress Schools - Wolverhampton,0,0,0,0
Birmingham,Myles Academy,9,0,9,9
Blackpool,BFC School,20,16,3,19
Gateshead,Cumbric,0,0,0,0
Barnet,Ateres Beis Yaakov,35,5,0,5
Birmingham,Leycroft Academy,173,0,173,173
Leeds,Green Meadows Academy,217,3,214,217
Liverpool,Dixons Fazakerley Academy,852,155,26,181
Calderdale,St Mary's Catholic Primary Academy,302,37,14,51
Calderdale,St Patrick's Catholic Primary Academy,110,17,5,22
Kirklees,St Patrick's Catholic Primary Academy,417,30,6,36
Cheshire East,Bosley St Mary's CofE Primary School,49,5,6,11
Gloucestershire,Aurora Severnside School,31,0,31,31
Norfolk,Great Dunham Primary School,52,12,1,13
Buckinghamshire,St Peter's Catholic Primary School,129,14,6,20
Buckinghamshire,St Edward's Catholic Junior School,256,24,11,35
Buckinghamshire,St Joseph's Catholic Primary School,428,46,5,51
Buckinghamshire,St Joseph's Catholic Infant School,229,13,4,17
Buckinghamshire,Our Lady's Catholic Primary School,215,19,7,26
Buckinghamshire,St Louis Catholic Primary School,456,27,8,35
Nottinghamshire,Hawthorne Primary and Nursery School,230,22,6,28
Warwickshire,Brailes Church of England Primary School,99,15,3,18
Wiltshire,Winterslow Church of England Primary School,191,31,3,34
Wiltshire,Pitton Church of England Primary School,62,11,2,13
"Bristol, City of",St Werburgh's Primary School,388,56,6,62
Wiltshire,Greentrees Primary School,430,41,27,68
Tower Hamlets,Cyril Jackson Primary School,461,50,34,84
Croydon,Kenley Primary School,196,33,2,35
Birmingham,King Edward VI Northfield School for Girls,749,105,16,121
Dudley,Rufford Primary School,173,46,4,50
Doncaster,New Pastures Primary School,287,33,3,36
Sheffield,Woodthorpe Primary School,443,93,9,102
Luton,Stopsley High School,1048,135,23,158
Cheshire East,Middlewich High School,713,129,34,163
Redcar and Cleveland,Archway Academy,68,28,4,32
Cornwall,St Dominic CofE  Primary School,85,28,0,28
Cornwall,St Mellion Church of England Primary School,32,11,0,11
Cumbria,"Dean Gibson Catholic Primary School, Kendal",173,17,5,22
Cumbria,"St Cuthberts Catholic Primary School, Windermere",44,10,4,14
Cumbria,"Sacred Heart Catholic Primary School, Barrow",210,32,12,44
Cumbria,"St Cuthberts  Catholic Primary School, Carlisle",137,14,4,18
Cumbria,"St Margaret Mary Catholic Primary School, Carlisle",215,35,5,40
Cumbria,"St Bernards Catholic High School, Barrow",690,115,33,148
Cumbria,"St Josephs Catholic High School, Workington",565,86,15,101
County Durham,"St Joseph's Catholic Primary School, Gilesgate",112,18,4,22
County Durham,"St Thomas More Primary School, Belmont",89,7,1,8
County Durham,Bishop Barrington Academy,675,96,19,115
East Sussex,Roselands Infants' School,254,25,1,26
Essex,Wells Park School,55,0,55,55
Portsmouth,Cottage Grove Primary School and Nursery,447,91,14,105
Hertfordshire,Dundale Primary School and Nursery,208,35,11,46
Kent,Mundella Primary School,173,32,4,36
Kent,The North School,1267,59,56,115
Lincolnshire,Horncastle Primary School,450,76,23,99
North Yorkshire,Malton Primary Academy,223,25,4,29
Nottinghamshire,Mount CofE Primary School,205,37,2,39
Telford and Wrekin,St Peter's Bratton Church of England Academy,411,61,3,64
Staffordshire,Highfields Primary Academy,204,10,0,10
West Sussex,Whytemead Primary School,239,32,8,40
Staffordshire,Alsagers Bank Primary Academy,151,20,3,23
Birmingham,Lea Hall Academy,81,0,81,81
East Sussex,Stafford Junior School,355,46,0,46
Cheshire East,Christ The King Catholic and Church of England Primary School,89,20,7,27
Redcar and Cleveland,Rye Hills Academy,860,103,18,121
Redcar and Cleveland,Invested Education,4,0,4,4
Warwickshire,The Emscote School,48,10,13,23
Cambridgeshire,Hope Tree School,5,0,5,5
Staffordshire,Longridge School,6,0,6,6
Surrey,Burstow Park School,43,0,43,43
Dorset,The Purbeck School,1064,194,35,229
Manchester,"Mount Carmel RC Primary School, a Voluntary Academy",457,49,13,62
Leeds,"St Francis of Assisi Catholic Primary School, a Voluntary Academy",228,55,2,57
East Sussex,Hurst Green Church of England Primary School and Nursery,132,12,0,12
East Sussex,Northiam Church of England Primary School and Nursery,140,18,3,21
Devon,Morchard Bishop Church of England Primary School,130,8,2,10
Hampshire,Woodcot Primary School,189,36,4,40
Lancashire,St John With St Michael Church of England Primary School,114,13,2,15
Lincolnshire,Gedney Church End Primary Academy,69,20,4,24
Lincolnshire,Lutton St Nicholas Primary Academy,99,11,4,15
Staffordshire,St Michael's CofE (C) Primary School,425,35,4,39
Staffordshire,St Chad's CofE Primary School,220,23,9,32
Suffolk,Whitehouse Community Primary School,610,71,15,86
Suffolk,Elmsett Church of England Primary School,58,9,2,11
Suffolk,Bedfield Church of England Primary School,33,8,6,14
West Sussex,St Paul's Catholic College,1128,152,26,178
Portsmouth,Milton Park Primary School,386,95,21,116
North Northamptonshire,Refocus,14,1,4,5
St. Helens,This Is My Education - TIME,10,1,9,10
Leeds,Core Training and Development,30,14,1,15
Torbay,Phoenix Bay School,9,0,9,9
Northumberland,NCEA James Knott CofE Primary School,217,61,3,64
Northumberland,NCEA William Leech CofE Primary School,147,47,8,55
Northumberland,NCEA Grace Darling CofE Primary School,449,178,16,194
Northumberland,NCEA Thomas Bewick C of E Primary School,246,97,3,100
East Riding of Yorkshire,The Becklands School,7,0,7,7
Croydon,Chaffinch Brook School,94,1,93,94
Lancashire,"St Josephs Catholic Primary School, Lancaster",172,45,5,50
Wakefield,Evolve Academy,46,33,2,35
Croydon,Beckmead College,72,8,64,72
Hillingdon,Field End Junior School,352,61,9,70
Hillingdon,Hermitage Primary School,456,32,5,37
Sutton,Bandon Hill Primary School,458,46,13,59
Doncaster,Scawthorpe Castle Hills Primary Academy,280,57,4,61
South Tyneside,"St James' Catholic Primary School, Hebburn",201,33,2,35
South Tyneside,"St Bede's Catholic Primary School, Jarrow",203,15,4,19
Sunderland,Springwell Village Primary School,206,32,0,32
Sunderland,"St Mary's Catholic Primary School, Sunderland",464,69,3,72
Sunderland,"St John Bosco Catholic Primary School, Town End Farm, Sunderland",205,23,3,26
North Somerset,Sandford Primary School,150,8,5,13
North Somerset,Winscombe Primary School,212,9,1,10
Windsor and Maidenhead,Oakfield First School,286,30,6,36
Derbyshire,Riddings Junior School,229,55,6,61
County Durham,"Our Lady of Lourdes Catholic Primary School, Shotton",154,33,4,37
County Durham,"St Joseph's Catholic Primary School, Blackhall",71,15,6,21
Rochdale,Kingsway Park High School,1341,168,37,205
Liverpool,Dixons Broadgreen Academy,1237,174,39,213
Leeds,John Smeaton Academy,638,116,22,138
Cumbria,Cairn Education CIC,6,0,6,6
St. Helens,Ash Meadow School,19,0,19,19
Kingston upon Thames,Fern Hill Primary School,646,77,9,86
Surrey,Thames Ditton Junior School,366,34,28,62
Wokingham,Whiteknights Primary School,460,65,5,70
Liverpool,Assess North West,17,0,4,4
Redcar and Cleveland,Progress Schools - Tees Valley,6,5,1,6
Devon,On Track Education - West Yarner,26,0,26,26
Nottinghamshire,Redwood Montessori School,0,0,0,0
Ealing,Blooming Tree Pre Prep School,30,2,28,30
Suffolk,Compass Community School Aylward Park,1,0,1,1
Gateshead,"St Joseph's Catholic Infant School, Birtley",77,13,2,15
Gateshead,"St Philip Neri Catholic Primary School, Dunston",164,27,4,31
Newcastle upon Tyne,"St Oswald's Catholic Primary School, Gosforth",210,4,4,8
Newcastle upon Tyne,"St Joseph's Catholic Primary School, Benwell",221,31,6,37
Newcastle upon Tyne,"St Teresa's Catholic Primary School, Heaton",209,23,3,26
North Tyneside,"St Aidan's Catholic Primary School, Wallsend",214,25,7,32
North Tyneside,"St Bernadettes Catholic Primary, Wallsend",310,33,9,42
North Tyneside,"St Columba's Catholic Primary School, Wallsend",209,26,3,29
Hartlepool,"St John Vianney Catholic Primary School, Hartlepool",250,28,4,32
Derbyshire,Sale and Davys Church of England Primary School,99,14,1,15
County Durham,"St Pius Xth Catholic Primary School, Consett",88,16,8,24
County Durham,"Our Lady and St Joseph Brooms Catholic Primary School, Leadgate",86,24,2,26
Norfolk,Brancaster CofE Primary Academy,39,7,5,12
Norfolk,Docking Church of England Primary Academy and Nursery,110,6,4,10
York,Bishopthorpe Infant School,126,3,3,6
Suffolk,Snape Primary School,79,14,1,15
Southend-on-Sea,Edwards Hall Primary School,395,36,7,43
Norfolk,King Edward VII Academy,1194,118,16,134
Lincolnshire,Compass Community School Lincolnshire,3,1,2,3
Warwickshire,The Haven School Wolston,9,0,9,9
Stoke-on-Trent,Want2Achieve The Academy,15,3,6,9
Somerset,Buckler's Mead School,734,114,9,123
Shropshire,The Fitzroy Academy,7,0,7,7
Milton Keynes,Stantonbury School,1489,93,28,121
Lancashire,Poplar House School,6,0,6,6
Derby,Jasmine Hall School,12,0,12,12
Knowsley,A.R.T.S. Education,14,0,14,14
"Bristol, City of",Willow Park CofE Primary School,147,15,3,18
South Gloucestershire,Neptune School,17,0,17,17
Gateshead,"St Joseph's Catholic Junior School, Birtley",97,17,1,18
County Durham,"St Mary's Catholic Primary School, South Moor",98,14,2,16
Suffolk,Kersey Church of England Primary School,30,5,2,7
Rochdale,Oulder Hill Leadership Academy,1208,124,22,146
Oldham,Littlemoor Primary School,294,52,10,62
Kirklees,Holy Spirit Catholic Primary Academy,210,31,8,39
Bracknell Forest,Sandhurst School,1094,146,25,171
Buckinghamshire,The Mandeville School,989,175,30,205
County Durham,Howden-le-Wear Primary School,167,46,4,50
County Durham,Evenwood Church of England Primary School,92,17,2,19
County Durham,St Michael's Church of England Primary School,124,23,2,25
North Yorkshire,St John Fisher Catholic Academy,1398,117,18,135
Nottinghamshire,Blidworth Oaks Primary School,383,46,1,47
Nottinghamshire,Heathlands Primary School,170,23,1,24
County Durham,Brandon Primary Academy,294,63,6,69
Norfolk,Duke of Lancaster School,75,2,73,75
Kent,Life Skills Manor,29,0,29,29
Kent,Maple Tree Primary School,1,0,1,1
Kirklees,St Patrick's Catholic Primary Academy,252,29,2,31
Dudley,Church of the Ascension CofE Primary School,309,19,5,24
Bury,Bury Church of England High School,829,98,28,126
Bury,Peel Brow School,153,20,3,23
Sheffield,Malin Bridge Primary School,603,86,6,92
Bradford,Clayton Village Primary School,200,25,6,31
Cumbria,Ellenborough Academy,59,13,1,14
Devon,Ermington Primary School,115,17,3,20
Devon,"Manor Primary School, Ivybridge",252,40,20,60
Devon,Ugborough Primary School,119,14,2,16
County Durham,Langley Park Primary School,194,30,7,37
Hertfordshire,Skyswood Primary & Nursery School,243,13,2,15
Kent,Halstead Community Primary School,54,4,3,7
North Yorkshire,"St Joseph's Catholic Primary School, a Voluntary Academy",123,20,3,23
Nottinghamshire,Cotgrave Church of England Primary School,112,10,5,15
Surrey,Shawley Community Primary Academy,259,52,6,58
Surrey,Folly Hill Infant Academy,73,8,1,9
Swindon,Wroughton Infant School,216,25,1,26
Swindon,Wroughton Junior School,344,36,10,46
Cheshire East,Oakfield Lodge School,58,13,11,24
Birmingham,Birches Green Junior School,210,53,1,54
East Sussex,VTSS,1,0,0,0
Calderdale,Endeavour House School,3,0,2,2
Newham,Rokeby School,765,56,5,61
Newham,Lister Community School,1582,115,62,177
Lancashire,St Matthew's Church of England Primary Academy,456,52,16,68
Leicester,St Peter's CofE Primary School,202,32,3,35
Walsall,Brownhills West Primary School,185,38,3,41
Gateshead,"Corpus Christi Catholic Primary School, Gateshead",218,42,5,47
Gateshead,"St Peter's Catholic Primary School, Low Fell",209,11,2,13
Gateshead,"St Joseph's Catholic Primary School, Blaydon",208,28,6,34
South Tyneside,"St Oswald's Catholic Primary School, South Shields",226,31,1,32
Sunderland,"St Joseph's Catholic Primary School, Sunderland",247,13,1,14
Sunderland,"English Martyrs' Catholic Primary School, Sunderland",196,33,0,33
County Durham,"St Patrick's Catholic Primary School, Consett",407,52,3,55
County Durham,"St Wilfrid's Catholic Primary School, Bishop Auckland",207,40,1,41
County Durham,"Blessed John Duckett Catholic Primary School, Tow Law",68,12,0,12
East Sussex,Ditchling St Margaret's Church of England Primary School,187,20,0,20
Kent,Shears Green Infant School,342,20,5,25
Lancashire,Accrington Huncoat Primary School,209,22,4,26
Lancashire,Oswaldtwistle West End Primary School,206,25,2,27
Lancashire,Rhyddings,612,86,6,92
Lancashire,The Hollins,808,78,17,95
West Sussex,Albourne Church of England Primary School,177,25,2,27
Swindon,Greenmeadow Primary School,219,31,9,40
"Bournemouth, Christchurch and Poole",Hillbourne Primary School,227,30,6,36
East Sussex,Telscombe Cliffs Academy,619,80,11,91
Birmingham,New Horizon Academy,0,0,0,0
Surrey,Aurora Poppyfield School,17,0,17,17
Sefton,Educ8 Liverpool,22,4,7,11
Barking and Dagenham,Elutec Academy,160,41,1,42
Essex,"Octavia House Schools, Essex",14,0,14,14
Stockton-on-Tees,Kiora Hall,23,0,23,23
Tameside,Samuel Laycock School,211,0,211,211
Dudley,Pedmore CE Primary School,222,27,5,32
North Somerset,St Andrew's CofE Primary School,193,9,5,14
North Somerset,Corpus Christi Catholic Primary School,194,19,3,22
"Bristol, City of",St Bernard's Catholic Primary School,201,28,1,29
Derbyshire,William Rhodes Primary and Nursery School,174,39,4,43
East Sussex,Uplands Academy,809,101,16,117
Gloucestershire,English Bicknor Church of England Primary School,43,5,3,8
Leicestershire,Orchard Community Primary School,329,34,0,34
Somerset,St Joseph and St Teresa Catholic Primary School,146,13,3,16
Somerset,"St Joseph's Catholic Primary School, Bridgwater",205,16,7,23
Somerset,St Joseph's Catholic Primary and Nursery School,271,11,4,15
Somerset,St Gildas Catholic Primary School,203,22,4,26
Somerset,Our Lady of Mount Carmel Catholic Primary,139,16,3,19
Surrey,Holland Junior School,188,34,12,46
Warwickshire,Camp Hill Primary School,459,107,7,114
West Berkshire,The Mile House Therapeutic School,8,0,8,8
East Sussex,Peacehaven Heights Academy,379,54,7,61
North Somerset,St Francis Catholic Primary School,153,19,5,24
Manchester,Dixons Brooklands Academy,1030,166,22,188
County Durham,Moorside Primary Academy,131,38,3,41
County Durham,New Brancepeth Primary Academy,135,21,2,23
Croydon,Orchard Way Primary School,198,33,7,40
Newham,St Winefride's RC Primary School,272,48,1,49
Birmingham,St Mark's Catholic Primary School,211,21,4,25
Doncaster,St Alban's Catholic Primary and Nursery School,229,78,2,80
Newcastle upon Tyne,"St John Vianney Catholic Primary School, West Denton",459,45,9,54
Newcastle upon Tyne,"St Cuthberts Catholic Primary School, Kenton",228,32,6,38
Newcastle upon Tyne,"St Vincents Catholic Primary School, Newcastle",210,40,8,48
North Tyneside,"St Marys Catholic Primary School, Forest Hall",200,26,5,31
North Tyneside,"St Stephen's Catholic Primary School, Newcastle",226,18,9,27
Bedford,St James' CofE Academy,200,16,3,19
Cambridgeshire,Spaldwick Primary School,88,11,8,19
Cheshire West and Chester,Westminster Community Primary School,127,32,13,45
Cheshire East,Elworth Hall Primary School,209,28,13,41
Hartlepool,St Helen's Primary School,265,61,1,62
Devon,Lifton Community Academy,177,32,3,35
Hertfordshire,Peartree Primary School,194,41,8,49
Hertfordshire,"St John Fisher Catholic Primary School, a Voluntary Academy",162,13,7,20
Kent,East Stour Primary School,438,49,14,63
Kent,Palm Bay Primary School,424,36,14,50
Lancashire,"St Mary Magdalene Catholic Primary School, a Voluntary Academy",205,41,9,50
Norfolk,Alburgh With Denton Church of England Primary Academy,102,24,0,24
Norfolk,Tacolneston Church of England Primary Academy,105,15,4,19
Norfolk,Morley Church of England Primary Academy,134,18,8,26
North Yorkshire,Willow Tree Community Primary School,481,63,13,76
Northumberland,"St Cuthberts Catholic First School, Berwick",81,6,1,7
Northumberland,"St Roberts Catholic First School, Morpeth",175,15,4,19
Staffordshire,Redhill Primary School,204,46,8,54
Staffordshire,Moorhill Primary School,317,62,11,73
Staffordshire,Greenhall,31,4,27,31
Surrey,St Martins Church of England Junior School,359,33,8,41
Surrey,St Martins Church of England Infant School,268,21,6,27
West Sussex,St Nicolas & St Mary CofE Primary School,388,43,13,56
Stockton-on-Tees,Oakdene Primary Academy,280,54,6,60
Redcar and Cleveland,Handale Primary School,204,40,3,43
Medway,Will Adams Academy,39,6,0,6
Plymouth,High View School,359,106,5,111
Bradford,Hanson Academy,1638,78,71,149
Blackpool,Lancashire Alternative Provision,39,0,1,1
Tower Hamlets,Brick Lane School,18,0,18,18
Wiltshire,Coombe House School,36,0,36,36
Rochdale,Willow View School,11,0,11,11
Torbay,TLG Torbay,6,5,1,6
Staffordshire,Kaleidoscope School,20,0,20,20
Leeds,Micklefield Church of England Primary Academy,81,19,0,19
Wiltshire,Meadow Bridge School,12,0,12,12
Cambridgeshire,"Cardiff Sixth Form College, Cambridge",20,0,0,0
Hampshire,Bere Clinic School,9,1,0,1
Sefton,Holy Spirit Catholic Academy,181,72,1,73
Hartlepool,Rossmere Academy,433,89,5,94
St. Helens,St Augustine of Canterbury Catholic Academy,541,96,17,113
Halton,St Chads Catholic and Church of England Academy,417,86,8,94
Hillingdon,The Skills Hub,55,17,0,17
South Tyneside,"St Gregory's Catholic Primary School, South Shields",210,26,2,28
South Tyneside,"St Matthew's Catholic Primary School, Jarrow",204,32,0,32
Sunderland,"St Cuthbert's Catholic Primary School, Sunderland",237,35,2,37
Surrey,Busbridge Infant School,162,20,2,22
Swindon,Abbey Farm Educate Together Primary,47,5,0,5
Kent,Barton Manor School,149,20,7,27
Leicestershire,Foxbridge Primary School,6,1,1,2
Devon,The Promise School,34,0,34,34
Birmingham,BOA Digital Technologies Academy,121,29,2,31
Kirklees,Kaye's Academy,191,39,0,39
Sefton,Sacred Heart Catholic College,981,101,8,109
Bexley,St Peter Chanel Catholic Primary School,240,33,9,42
Birmingham,Birches Green Infant School,196,38,5,43
Bury,Springside Primary School,241,28,7,35
Gateshead,"St Agnes' Catholic Primary School, Crawcrook",191,10,0,10
Gateshead,"St Mary & St Thomas Aquinas Catholic Primary School, Blaydon",239,12,1,13
Gateshead,"St Mary's Catholic Primary School, Whickham",207,10,3,13
Gateshead,"St Wilfrid's Catholic Primary School, Gateshead",144,16,3,19
Devon,Burlescombe Church of England Primary School,44,4,1,5
Devon,Webber's Church of England Primary School,84,14,0,14
County Durham,"St Cuthbert's Catholic Primary School, Crook",158,19,1,20
County Durham,"St Mary's Catholic Primary School, Barnard Castle",100,28,0,28
County Durham,"St Mary's Catholic Primary School, Newton Aycliffe",179,24,8,32
County Durham,"St Patrick's Catholic Primary School, Langley Moor",80,15,0,15
West Northamptonshire,Deanshanger Primary School,334,25,5,30
Solihull,Daylesford Academy,11,7,4,11
Salford,Toras Moshe,18,0,0,0
Gloucestershire,Brookthorpe Hall School,10,0,10,10
Essex,St Luke's Park Primary School,45,12,0,12
Suffolk,Grace Cook Primary School,24,0,0,0
Nottinghamshire,Bingham Primary School,85,8,0,8
Medway,Rochester Riverside Church of England Primary School,26,7,0,7
Kent,King's Reach Education,8,0,8,8
Somerset,Dovecote School,35,0,35,35
Suffolk,Woodbridge Road Academy,19,0,19,19
Gloucestershire,Brook Academy,32,0,32,32
North Northamptonshire,Stanton Cross Primary School,27,5,1,6
Medway,Maritime Academy,142,30,1,31
Cheshire West and Chester,Frodsham Primary Academy,102,17,9,26
Hertfordshire,Avanti Grange Secondary School,107,15,4,19
Staffordshire,Bramshall Meadows First School,14,0,0,0
Stockport,Woodford Primary School,54,4,1,5
Staffordshire,Fradley Park Primary and Nursery School,53,2,0,2
Gloucestershire,William Morris School,15,0,15,15
Tower Hamlets,Mulberry Wood Wharf Primary School,30,0,1,1
Shropshire,The Keystone Academy,38,0,38,38
Sheffield,Discovery Academy,61,0,61,61
Cheshire West and Chester,Whitley Village School,76,20,0,20
Devon,Beaford Community Primary & Nursery School,116,11,4,15
Worcestershire,Pitcheroak School,153,0,153,153
Cheshire West and Chester,The Acorns Primary and Nursery School,354,75,9,84
Bradford,Baildon Glen Primary School,176,70,5,75
Bury,"Craig Ormerod Associates, School Provision",13,0,12,12
Buckinghamshire,Ivingswood Academy,186,39,1,40
Buckinghamshire,Waterside Primary Academy,200,32,9,41
Cambridgeshire,Marleigh Primary Academy,60,8,2,10
Lancashire,Lancaster University School of Mathematics,38,4,0,4
Enfield,Salmons Brook School,32,0,32,32
Redcar and Cleveland,River Tees Academy Grangetown,27,0,27,27
Buckinghamshire,The Kingsbrook School,181,29,16,45
Peterborough,Manor Drive Primary Academy,49,2,0,2
Peterborough,Manor Drive Secondary Academy,119,19,4,23
Nottinghamshire,Millside Spencer Academy,54,5,0,5
Milton Keynes,Glebe Farm School,233,20,2,22
Central Bedfordshire,Houstone School,285,31,11,42
Suffolk,Sir Peter Hall School,35,5,30,35
Middlesbrough,Hopefields Education CiC,33,9,24,33
Southend-on-Sea,Compass Community School Boleyn Park,5,0,5,5
Croydon,The Minster Junior School,395,74,15,89
Croydon,The Minster Nursery and Infants Church of England Academy,263,39,1,40
Surrey,Great Bookham School,217,35,9,44
Buckinghamshire,Manor Farm Junior School,232,40,4,44
Wiltshire,Westwood-with-Iford Primary School,61,9,1,10
Rotherham,Highfield Farm Primary School,95,22,6,28
Sheffield,Stocksbridge Nursery Infant School,256,24,6,30
Bradford,All Saints CofE Primary School,662,97,8,105
"Bristol, City of",Cabot Primary School,190,36,4,40
County Durham,Burnhope Primary School,98,20,3,23
Kent,Sedley's Church of England Primary School,99,5,1,6
Lancashire,"Christ The King Roman Catholic Primary School, a Voluntary Academy",211,31,3,34
Lancashire,"Sacred Heart Roman Catholic Primary School, a Voluntary Academy",220,11,7,18
North Northamptonshire,"Park Junior School, Wellingborough",241,33,1,34
Staffordshire,Ridgeway Primary Academy,406,51,9,60
West Sussex,St Wilfrid's CofE Primary School,402,64,7,71
Swindon,Robert Le Kyng Primary School,418,27,23,50
Birmingham,Kings Norton Junior and Infant School,409,70,6,76
Liverpool,St Nicholas Catholic Academy,194,30,4,34
Liverpool,St Ambrose Catholic Academy,226,42,5,47
Liverpool,The Trinity Catholic Academy,315,42,4,46
Cornwall,Sky Primary and Eden Project Nursery,23,2,0,2
Nottinghamshire,Rivendell Flying High Academy,107,17,1,18
Oldham,The Brian Clarke Church of England Academy,241,38,5,43
East Sussex,Summerdown School,67,0,67,67
Hampshire,Inclusion School,25,0,25,25
Gloucestershire,Watermoor Church of England Primary School,213,46,8,54
Dorset,Portesham Church of England Primary School,70,9,0,9
Leicestershire,Bishop Ellis Catholic Voluntary Academy,256,39,3,42
Harrow,Pathways School,8,0,8,8
Kent,Haven Nook,8,0,8,8
Newham,UK Community College (UKCC),0,0,0,0
North Somerset,Lime Hills Academy,22,0,22,22
Wigan,CEWE School,6,0,6,6
Suffolk,Sunrise Academy,41,0,41,41
Doncaster,Field Gate School,13,0,13,13
Birmingham,King Solomon International Business School,549,86,5,91
Sandwell,Elm Tree Primary Academy,15,0,15,15
Bexley,ADO River Valley,5,0,5,5
Camden,City Junior School,144,5,0,5
Peterborough,St John Henry Newman Catholic VA Primary School,88,14,0,14
Bradford,Baildon Church of England Primary School,451,56,8,64
Kirklees,"Whitcliffe Mount, A Share Academy",1237,57,20,77
Dorset,St Nicholas and St Laurence Church of England Primary School,209,33,6,39
County Durham,"St Mary Magdalen's Catholic Primary School, Seaham",304,22,9,31
Staffordshire,Manor Primary Academy,80,8,2,10
Warwickshire,Kineton Church of England Primary School,195,16,4,20
Devon,Bolham Community Primary School,110,10,1,11
Lambeth,JUS Education,0,0,0,0
Cambridgeshire,Aurora Fairway School,20,0,20,20
Rotherham,Elements Academy,131,3,128,131
Stockport,Bridge House School,6,0,6,6
Wigan,Holy Family Catholic Academy,197,34,3,37
Devon,Whitchurch Community Primary School,210,23,4,27
Plymouth,St Budeaux Foundation CofE (Aided) Junior School,138,29,4,33
Swindon,Bridlewood Primary School,227,29,7,36
Shropshire,Bettws Lifehouse Independent Special School,51,2,49,51
Shropshire,The Gables Learning Centre,0,0,0,0
Norfolk,The Harleston Sancroft Academy (a 3-16 Church of England School),924,146,35,181
Rotherham,Foljambe Primary School,112,36,5,41
Leicestershire,Compass Community School Mountfields House,4,0,4,4
Manchester,The Greens ENS,13,0,13,13
Kent,ALP Sittingbourne,11,0,11,11
Buckinghamshire,Pioneer Secondary Academy,522,43,9,52
North Yorkshire,Filey School,440,79,22,101
Hertfordshire,Round Diamond Primary School,470,44,16,60
Wiltshire,Old Sarum Primary School,331,57,6,63
Nottinghamshire,Brierley Forest Primary and Nursery School,323,53,5,58
Calderdale,St Augustine's CofE School,158,20,6,26
Essex,Luxborough Court School,7,0,7,7
Trafford,Changing Lives,4,0,4,4
West Sussex,Red Balloon Worthing Learner Centre,11,1,10,11
Kent,The T3 School,0,0,0,0
Somerset,Chilton Bridge School,21,0,21,21
Dudley,Sledmere Primary School,638,105,18,123
Torbay,Cockington Primary School,492,68,17,85
County Durham,Sedgefield Hardwick Primary Academy,260,49,9,58
North Yorkshire,Oakridge Community Primary School,39,5,0,5
Wolverhampton,Penn Hall School,116,0,116,116
Bradford,Bowling Park Primary School,673,166,11,177
Bradford,Miriam Lord Primary School,404,12,25,37
Sunderland,Hetton Academy,634,84,16,100
Hartlepool,Springwell School,93,0,93,93
Cumbria,Vickerstown School,189,14,16,30
Cumbria,"Our Lady and St Patrick's Catholic Primary School, Maryport",212,26,10,36
Cumbria,"St Gregory's Catholic Primary School, Workington",206,29,10,39
Devon,King Edward VI Community College,922,111,39,150
County Durham,Durham Academy,361,74,18,92
East Sussex,Chyngton School,375,53,6,59
Essex,William Read Primary and Nursery Academy,284,30,18,48
Gloucestershire,Cold Aston Church of England Primary School,63,9,0,9
Gloucestershire,Longborough Church of England Primary School,83,16,1,17
Gloucestershire,Swell Church of England Primary School,29,6,2,8
Gloucestershire,St James and Ebrington Church of England Primary School,159,28,3,31
"Herefordshire, County of",St Peter's Primary School,219,38,2,40
East Riding of Yorkshire,Bilton Community Primary School,236,29,8,37
East Riding of Yorkshire,Howden Junior School,216,30,5,35
Kent,St Augustine's Catholic Primary School,203,15,0,15
Blackpool,St Kentigern's Catholic Primary School,210,24,5,29
Lancashire,St Wulstan's and St Edmund's Catholic Academy,224,47,5,52
Lancashire,"St Mary's Catholic Primary School, Great Eccleston",53,7,1,8
Lancashire,"Sacred Heart Catholic Primary School, Thornton Cleveleys",190,28,2,30
Blackpool,St Teresa's Catholic Primary School,223,37,3,40
Leicestershire,Desford Community Primary School,401,31,10,41
Shropshire,Harlescott House School,1,0,1,1
Leicestershire,Donisthorpe Primary School,204,34,0,34
Leicestershire,Dove Bank Primary School,139,15,4,19
Leicestershire,Iveshead School,943,144,34,178
Lincolnshire,Leadenham Church of England Academy,50,9,0,9
North Yorkshire,Grewelthorpe Church of England Primary School,83,10,0,10
North Yorkshire,Holy Trinity Church of England Junior School,241,49,5,54
North Yorkshire,Roecliffe CofE Primary School,84,15,1,16
North Yorkshire,Holy Trinity Church of England Infant and Nursery,174,26,1,27
North Yorkshire,Dacre Braithwaite Church of England Primary School,80,3,2,5
North Yorkshire,Fountains Church of England Primary School,74,11,1,12
West Northamptonshire,Cogenhoe Primary School,211,29,0,29
West Northamptonshire,Paulerspury Church of England Primary School,75,16,0,16
West Northamptonshire,Rothersthorpe Church of England Primary School,84,6,1,7
Staffordshire,Moat Hall Primary Academy,362,51,7,58
Suffolk,St Benedict's Catholic School,950,110,21,131
Surrey,St Ignatius Catholic Primary School,414,47,9,56
Surrey,Our Lady of the Rosary Primary School,238,24,5,29
Surrey,St Michael Catholic Primary School,468,48,7,55
Surrey,St Paul's Catholic College,1304,134,22,156
Warwickshire,Harbury CofE Primary School,217,25,5,30
West Sussex,St Wilfrids Catholic Primary School,179,18,3,21
West Sussex,St Peter's Catholic Primary School,193,35,6,41
West Sussex,Our Lady Queen of Heaven Catholic Primary School,418,41,8,49
Cumbria,Ormsgill Nursery and Primary School,197,54,19,73
"Bristol, City of",Bridge Farm Primary School,629,112,18,130
Richmond upon Thames,St Richard Reynolds Catholic High School,1086,72,34,106
Richmond upon Thames,St Richard Reynolds Catholic Primary School,210,12,1,13
Bradford,"The Holy Family Catholic School, a Voluntary Academy",862,144,34,178
Warwickshire,English Martyrs Catholic Primary School,208,30,5,35
Worcestershire,Far Forest Lea Memorial CofE Primary School,104,16,0,16
Warwickshire,Newbold and Tredington CofE Primary School,74,17,3,20
Lancashire,"Our Lady and St Edward's Catholic Primary School, Preston",214,8,7,15
Warwickshire,Our Lady and St Teresa's Catholic Primary School,146,12,4,16
Telford and Wrekin,Lantern Academy,128,27,0,27
Warwickshire,St Augustine's Catholic Primary School,197,20,3,23
Lancashire,"St Augustine's Catholic Primary School, Preston",275,50,5,55
Lancashire,"St Bernard's Catholic Primary School, Preston",239,21,4,25
Lancashire,"St Clare's Catholic Primary School, Preston",280,4,3,7
Lancashire,"St Joseph's Catholic Primary School, Preston",355,45,7,52
Warwickshire,St Marie's Catholic Primary School,422,34,5,39
Warwickshire,St Mary's Catholic Primary School,224,20,5,25
Lancashire,"St Teresa's Catholic Primary School, Preston",188,15,4,19
Kent,Aylesford School,873,168,10,178
South Tyneside,Ashley Academy,422,112,4,116
Oxfordshire,Bishopswood School,70,0,70,70
"Herefordshire, County of",Bredenbury Primary School,39,15,3,18
Central Bedfordshire,Dovery Academy,165,20,2,22
Cornwall,Jacobstow Community Academy,126,12,0,12
Staffordshire,King Edward VI High School,655,108,7,115
Kirklees,Manorfield Infant and Nursery School,282,81,4,85
Hertfordshire,Martins Wood Primary School,661,72,6,78
Wakefield,Outwood Primary Academy Greenhill,235,22,6,28
Hertfordshire,Watchlytes Primary School,220,40,5,45
Essex,The Hawthorns School,14,0,14,14
Wiltshire,Compass Community School Athelstan Park,9,0,9,9
Derbyshire,Ellern Mede Derby School,5,4,1,5
Southwark,St Joseph's Roman Catholic Primary School,330,22,4,26
Croydon,Coloma Convent Girls' School,1072,146,11,157
Doncaster,St Peter's Catholic Primary School,206,17,4,21
Tameside,Buckton Vale Primary School,252,63,6,69
Doncaster,Our Lady of Mount Carmel Catholic Primary School,206,8,1,9
Cumbria,Newton Village Academy,83,20,3,23
Wokingham,All Saints Church of England Primary School,293,51,10,61
Surrey,Egham Park School Ltd,9,0,9,9
Essex,Cambian Great Dunmow School,8,0,8,8
Sutton,Wood Field Primary School,771,77,57,134
Bolton,Bolton School Infant and Nursery School,303,49,1,50
Blackburn with Darwen,Rawdhatul Ilm Wal Huda,94,0,0,0
North Yorkshire,Carleton Endowed CofE Primary School,168,34,5,39
Derbyshire,Aldercar High School,681,78,48,126
Bracknell Forest,King's Academy Easthampstead Park,937,151,32,183
Birmingham,Heath Mount Primary School,358,50,7,57
Southwark,Notre Dame Roman Catholic Girls' School,521,76,19,95
Leicestershire,Ravenhurst Primary School,428,46,12,58
Essex,St John Fisher Catholic Primary School,287,46,4,50
Bexley,St Thomas More Catholic Primary School,419,45,14,59
Liverpool,SENDSCOPE,1,0,1,1
Somerset,Lydeard St Lawrence Community Primary School,47,2,3,5
Derbyshire,William Allitt Academy,588,105,15,120
Nottinghamshire,Easthorpe School,2,0,2,2
Middlesbrough,Reintegreat Education Solutions,8,4,2,6
Bracknell Forest,Sandy Lane Primary School,475,70,14,84
Surrey,Scott-Broadwood CofE Infant School,62,6,2,8
Gloucestershire,Peak Academy,60,0,60,60
Cornwall,Wendron Church of England Primary School,102,13,3,16
Leeds,Armley Grange School,1,0,1,1
North Lincolnshire,Robert Holme Academy,1,0,1,1
Devon,St Sidwell's Church of England Primary School & Nursery,218,21,11,32
Milton Keynes,Milton Keynes Primary Pupil Referral Unit,6,2,2,4
Oxfordshire,St Laurence Church of England School,94,11,2,13
Liverpool,Faith Primary Academy,205,55,6,61
Sandwell,Moat Farm Junior School,480,58,17,75
Windsor and Maidenhead,Woodlands Park Primary School,176,34,7,41
Cumbria,Petteril Bank School,170,11,11,22
Torbay,Furzeham Primary School,278,35,6,41
Dorset,Gillingham Primary School,269,34,24,58
Lancashire,"The Blessed Sacrament Catholic Primary School, Preston",382,67,8,75
Norfolk,Lyng Church of England Primary Academy,100,13,3,16
Nottinghamshire,Selston Church of England Infant and Nursery School,85,12,0,12
Nottinghamshire,Huthwaite All Saints Church of England Infant and Nursery School,118,24,1,25
Staffordshire,Whittington Primary and Nursery School,307,40,9,49
Staffordshire,Holly Grove Primary Academy,277,37,4,41
Suffolk,Thorndon Church of England Primary School,54,16,2,18
Coventry,Corley Academy,138,0,138,138
Hampshire,Ashford Hill Primary School,111,24,4,28
Surrey,The Mead Infant and Nursery School,322,44,5,49
Sheffield,Kenwood Academy,128,8,120,128
Nottinghamshire,Outwood Academy Kirkby,487,148,14,162
Nottinghamshire,Fountaindale School,73,0,73,73
Newham,Harris Science Academy East London,554,60,12,72
West Northamptonshire,The CE Academy,86,79,7,86
North Northamptonshire,Huxlow Academy,879,94,16,110
Cornwall,Crowan Primary School,99,16,2,18
West Berkshire,Park House School,1074,140,21,161
Lincolnshire,Cowley Academy,614,160,24,184
Worcestershire,Ridgeway Academy,316,51,4,55
Suffolk,Cambian Dunbroch School,0,0,0,0
Lambeth,Evolve Academy,59,13,24,37
Havering,Ardleigh Green Junior School (Ardleigh Green Learning Federation),361,25,8,33
Havering,Ardleigh Green Infant School (Ardleigh Green Learning Federation),266,13,8,21
Manchester,"St Kentigern's RC Primary School, a Voluntary Academy",455,56,5,61
Oldham,Holy Family RC Primary School,209,42,8,50
Dorset,Durweston Church of England Primary School,136,12,5,17
Lancashire,"St Augustine's Roman Catholic High School, a Voluntary Academy",1107,53,34,87
Milton Keynes,Priory Rise School,666,83,10,93
Slough,Langley Hall Arts Academy,11,0,0,0
Wiltshire,Amesbury Church of England Voluntary Controlled Primary School,261,48,7,55
Worcestershire,Rushwick CofE Primary School,163,18,5,23
Birmingham,Highters Heath Community School,177,32,5,37
Dorset,Manor Park Church of England First School,414,48,7,55
Sefton,The Salesian Academy of St John Bosco,495,82,7,89
Somerset,Christ Church CofE First School,108,25,11,36
Wirral,Gayton Primary School,215,18,6,24
North Somerset,Wrington Church of England Primary School,209,16,0,16
North Somerset,Burrington Church of England Primary School,93,9,1,10
Cornwall,St Mark's CofE Academy,72,12,0,12
Cumbria,"St Pius X Catholic Primary School, Barrow",220,18,14,32
County Durham,Witton-le-Wear Primary School,101,4,0,4
Lincolnshire,Old Leake Primary Academy,188,47,3,50
Norfolk,Scole Church of England Primary Academy,61,13,0,13
County Durham,Middlestone Moor Academy,264,38,7,45
Hartlepool,Greatham CofE Primary School,104,19,1,20
Cumbria,"Our Lady of the Rosary Catholic Primary School, Dalton-In-Furness",91,9,6,15
Worcestershire,Leigh and Bransford Primary School,191,22,3,25
Redbridge,Downshall Primary School,588,50,9,59
Wokingham,Rivermead Primary School,426,33,7,40
Sunderland,Northern Saints Church of England Academy,517,119,10,129
Liverpool,Dixons Croxteth Academy,344,79,3,82
Calderdale,The Brooksbank School,1632,113,45,158
Cornwall,Grampound-With-Creed CofE Primary School,63,7,0,7
Bromley,Downe Primary School,66,14,4,18
Windsor and Maidenhead,All Saints Church of England Junior School,220,19,4,23
Wirral,Greasby Junior School,246,27,5,32
Cumbria,"St Mary's Catholic Primary School, Ulvertson",133,13,4,17
Calderdale,Lee Mount Primary School,333,64,10,74
Wokingham,St Cecilia's CofE Primary School,12,1,0,1
Wiltshire,St Thomas à Becket Church of England Aided Primary School,41,2,3,5
Kensington and Chelsea,Holland Park School,1291,136,58,194
Cornwall,Landewednack Community Primary School,86,7,0,7
Wolverhampton,Smestow Academy,654,30,10,40
Norfolk,Diamond Academy,186,76,8,84
